Player,Years,Seasons,Pos,G,MP,FG,FGA,FG%,3P,3PA,3P%,2P,2PA,2P%,eFG%,FT,FTA,FT%,ORB,DRB,TRB,AST,STL,BLK,TOV,PF,PTS
A.C. Green,16.0,1986 - 2001,PF,1431,40671,4999,10160,49.202755905511815,136,537,25.32588454376164,4863,9623,50.53517614049673,49.87204724409449,3512,4782,73.44207444583856,3744,6813,10557,1530,1133,592,1580,2776,13646
A.J. Bramlett,1.0,2000 - 2000,C,8,61,4,21,19.047619047619047,0,0,,4,21,19.047619047619047,19.047619047619047,0,0,,12,10,22,0,1,0,3,13,8
A.J. English,2.0,1991 - 1992,SG,151,3108,617,1418,43.51198871650212,9,65,13.846153846153847,608,1353,44.93717664449372,43.829337094499294,259,333,77.77777777777779,140,175,315,320,57,24,203,287,1502
A.J. Guyton,3.0,2001 - 2003,PG,80,1246,166,440,37.72727272727273,73,193,37.82383419689119,93,247,37.65182186234818,46.02272727272727,37,45,82.22222222222221,22,58,80,147,20,12,62,58,442
A.J. Hammons,1.0,2017 - 2017,C,22,163,17,42,40.476190476190474,5,10,50.0,12,32,37.5,46.42857142857143,9,20,45.0,8,28,36,4,1,13,10,21,48
A.J. Price,6.0,2010 - 2015,PG,270,4016,563,1481,38.014854827819036,225,706,31.869688385269125,338,775,43.612903225806456,45.611073598919646,216,289,74.74048442906575,71,315,386,574,128,9,236,242,1567
A.J. Wynder,1.0,1991 - 1991,PG,6,39,3,12,25.0,0,1,0.0,3,11,27.27272727272727,25.0,6,8,75.0,1,2,3,8,1,0,4,1,12
Aaron Brooks,10.0,2008 - 2018,PG,685,14142,2384,5774,41.28853481122272,857,2330,36.78111587982833,1527,3444,44.33797909407666,48.709733287149284,970,1166,83.19039451114922,264,883,1147,1995,368,92,1048,1276,6595
Aaron Gordon,5.0,2015 - 2019,PF,341,9500,1605,3563,45.04630928992422,368,1146,32.11169284467714,1237,2417,51.179147703765,50.210496772382825,671,949,70.70600632244468,532,1580,2112,736,261,218,462,691,4249
Aaron Gray,7.0,2008 - 2014,C,326,3947,449,879,51.080773606370876,0,3,0.0,449,876,51.25570776255708,51.080773606370876,189,339,55.75221238938053,434,778,1212,209,96,89,271,691,1087
Aaron Harrison,3.0,2016 - 2018,SG,37,350,24,92,26.08695652173913,12,55,21.818181818181817,12,37,32.432432432432435,32.608695652173914,19,31,61.29032258064516,8,35,43,16,15,2,7,40,79
Aaron Holiday,1.0,2019 - 2019,PG,50,646,105,262,40.0763358778626,43,127,33.85826771653544,62,135,45.925925925925924,48.282442748091604,41,50,82.0,5,62,67,87,21,13,40,71,294
Aaron Jackson,1.0,2018 - 2018,PG,8,52,5,13,38.46153846153847,1,6,16.666666666666664,4,7,57.14285714285714,42.30769230769231,2,4,50.0,4,3,7,3,0,0,3,6,13
Aaron McKie,13.0,1995 - 2007,SG,868,21295,2534,5792,43.75,443,1252,35.38338658146965,2091,4540,46.05726872246696,47.574240331491715,1070,1370,78.1021897810219,527,2333,2860,2363,993,175,1160,1779,6581
Aaron Miles,1.0,2006 - 2006,PG,19,118,6,18,33.33333333333333,0,0,,6,18,33.33333333333333,33.33333333333333,4,4,100.0,0,14,14,24,4,1,11,13,16
Aaron Swinson,1.0,1995 - 1995,SF,9,51,10,18,55.55555555555556,0,0,,10,18,55.55555555555556,55.55555555555556,4,5,80.0,3,5,8,3,1,0,5,8,24
Aaron Williams,14.0,1994 - 2008,PF,768,12912,1686,3428,49.183197199533254,1,17,5.88235294117647,1685,3411,49.39900322486074,49.1977829638273,1044,1407,74.20042643923242,1081,1889,2970,523,296,580,715,1923,4417
Abdel Nader,2.0,2018 - 2019,SF,120,1249,146,379,38.522427440633244,55,169,32.544378698224854,91,210,43.333333333333336,45.77836411609499,52,79,65.82278481012658,28,162,190,49,36,23,62,115,399
Acie Earl,4.0,1994 - 1997,C,194,2522,362,899,40.266963292547274,0,9,0.0,362,890,40.67415730337079,40.266963292547274,258,389,66.32390745501286,191,328,519,61,63,127,170,355,982
Acie Law,4.0,2008 - 2011,PG,201,2474,272,654,41.59021406727829,28,118,23.728813559322035,244,536,45.52238805970149,43.730886850152906,182,232,78.44827586206897,34,165,199,323,85,4,154,201,754
Adam Harrington,1.0,2003 - 2003,SG,19,111,11,37,29.72972972972973,5,14,35.714285714285715,6,23,26.08695652173913,36.486486486486484,3,4,75.0,1,7,8,12,2,1,2,8,30
Adam Keefe,9.0,1993 - 2001,PF,681,11010,1193,2364,50.465313028764804,2,16,12.5,1191,2348,50.724020442930154,50.50761421319797,909,1279,71.0711493354183,1046,1660,2706,446,327,182,573,1197,3297
Adam Morrison,3.0,2007 - 2010,SF,163,3291,471,1261,37.351308485329106,124,377,32.891246684350136,347,884,39.25339366515837,42.2680412371134,142,200,71.0,84,263,347,223,40,12,172,275,1208
Adonal Foyle,12.0,1998 - 2009,C,741,13081,1320,2771,47.63623240707326,0,2,0.0,1320,2769,47.670639219935,47.63623240707326,353,707,49.929278642149924,1301,2166,3467,344,264,1193,600,1577,2993
Adonis Jordan,2.0,1994 - 1999,PG,10,97,8,27,29.629629629629626,3,12,25.0,5,15,33.33333333333333,35.18518518518518,2,4,50.0,3,3,6,22,3,1,8,6,21
Adonis Thomas,1.0,2014 - 2014,SF,6,37,6,14,42.857142857142854,1,5,20.0,5,9,55.55555555555556,46.42857142857143,1,1,100.0,0,3,3,3,0,0,1,6,14
Adreian Payne,4.0,2015 - 2018,PF,107,1403,174,429,40.55944055944056,15,59,25.423728813559322,159,370,42.972972972972975,42.30769230769231,66,97,68.04123711340206,79,236,315,66,45,27,90,203,429
Adrian Branch,4.0,1987 - 1990,SF,142,1476,335,751,44.607190412782955,9,40,22.5,326,711,45.85091420534459,45.206391478029296,171,233,73.39055793991416,117,147,264,103,85,17,130,203,850
Adrian Caldwell,6.0,1990 - 1998,PF,199,1607,165,339,48.67256637168141,0,3,0.0,165,336,49.107142857142854,48.67256637168141,62,137,45.25547445255474,180,317,497,33,56,41,126,270,392
Adrian Griffin,9.0,2000 - 2008,SG,525,8629,859,1946,44.14182939362796,51,185,27.56756756756757,808,1761,45.88302101078933,45.452209660842755,312,409,76.28361858190709,560,1097,1657,698,463,62,357,966,2081
Al Harrington,16.0,1999 - 2014,PF,1036,29133,5176,11714,44.186443571794435,1009,2879,35.04689128169503,4167,8835,47.164685908319186,48.49325593307154,2276,3149,72.27691330581136,1564,4150,5714,1686,901,266,1898,3228,13637
Al Horford,12.0,2008 - 2019,C,897,29634,5306,10137,52.3429022393213,421,1128,37.322695035460995,4885,9009,54.223554223554224,54.41945348722502,1587,2095,75.75178997613365,1915,5577,7492,2928,727,1083,1443,2080,12620
Al Jefferson,14.0,2005 - 2018,C,936,26850,6282,12589,49.90070696639924,8,67,11.940298507462686,6274,12522,50.103817281584405,49.93248073715148,2036,2867,71.01499825601674,2098,5742,7840,1369,642,1112,1227,2392,14608
Al Thornton,4.0,2008 - 2011,SF,296,8274,1368,3029,45.16342027071641,78,266,29.32330827067669,1290,2763,46.68838219326818,46.450973918785074,713,954,74.73794549266248,392,841,1233,353,185,152,424,771,3527
Al Wood,6.0,1982 - 1987,SG,422,10096,2006,4310,46.54292343387471,40,191,20.94240837696335,1966,4119,47.73003156105851,47.00696055684455,910,1155,78.78787878787878,466,830,1296,752,311,160,576,960,4962
Al-Farouq Aminu,9.0,2011 - 2019,SF,694,17650,2002,4704,42.55952380952381,581,1689,34.399052693901716,1421,3015,47.131011608623545,48.735119047619044,919,1231,74.65475223395613,990,3286,4276,862,666,404,860,1309,5504
Alaa Abdelnaby,5.0,1991 - 1995,PF,273,3306,638,1276,50.0,0,3,0.0,638,1273,50.11783189316576,50.0,227,325,69.84615384615384,286,580,866,88,71,70,258,495,1503
Alan Anderson,8.0,2006 - 2017,SF,348,7196,893,2187,40.83219021490627,350,1010,34.65346534653465,543,1177,46.13423959218352,48.83401920438957,422,522,80.84291187739464,163,604,767,393,196,32,308,643,2558
Alan Hardy,2.0,1981 - 1982,SG,60,421,84,195,43.07692307692308,0,5,0.0,84,190,44.21052631578947,43.07692307692308,25,39,64.1025641025641,22,31,53,23,10,13,31,45,193
Alan Henderson,12.0,1996 - 2007,PF,688,14292,2046,4343,47.1102924245913,5,27,18.51851851851852,2041,4316,47.28915662650602,47.167856320515774,1177,1834,64.17666303162486,1476,1874,3350,408,371,307,741,1512,5274
Alan Ogg,3.0,1991 - 1993,C,83,672,76,155,49.03225806451613,0,2,0.0,76,153,49.673202614379086,49.03225806451613,26,46,56.52173913043478,48,86,134,13,13,61,30,135,178
Alan Williams,4.0,2016 - 2019,PF,67,872,163,322,50.621118012422365,0,2,0.0,163,320,50.9375,50.621118012422365,87,139,62.589928057553955,115,256,371,39,37,38,51,155,413
Alando Tucker,3.0,2008 - 2010,SF,51,426,77,182,42.30769230769231,10,34,29.411764705882355,67,148,45.27027027027027,45.05494505494506,47,60,78.33333333333333,29,20,49,16,5,2,19,22,211
Albert King,9.0,1982 - 1992,SF,555,13460,2844,6173,46.0716021383444,59,218,27.06422018348624,2785,5955,46.76742233417296,46.549489713267455,1050,1333,78.76969242310578,804,1568,2372,1220,478,204,1198,1693,6797
Alec Burks,8.0,2012 - 2019,SG,442,9235,1452,3438,42.23385689354276,298,835,35.688622754491014,1154,2603,44.333461390703036,46.567771960442116,995,1287,77.31157731157731,261,1078,1339,749,266,76,548,752,4197
Alec Kessler,4.0,1991 - 1994,PF,212,2949,425,1000,42.5,10,24,41.66666666666667,415,976,42.52049180327869,43.0,226,303,74.58745874587459,258,494,752,81,39,71,193,452,1086
Alec Peters,1.0,2018 - 2018,PF,20,225,28,74,37.83783783783784,18,58,31.03448275862069,10,16,62.5,50.0,8,10,80.0,8,29,37,12,2,2,4,13,82
Aleksandar Djordjevic,1.0,1997 - 1997,SG,8,61,8,16,50.0,5,7,71.42857142857143,3,9,33.33333333333333,65.625,4,5,80.0,1,4,5,5,0,0,5,3,25
Aleksandar Radojevic,2.0,2000 - 2005,C,15,152,8,26,30.76923076923077,0,0,,8,26,30.76923076923077,30.76923076923077,10,16,62.5,11,25,36,7,2,3,20,37,26
Alex Abrines,3.0,2017 - 2019,SG,185,2967,321,832,38.581730769230774,230,625,36.8,91,207,43.96135265700483,52.40384615384615,100,114,87.71929824561403,54,219,273,94,97,24,73,310,972
Alex Acker,2.0,2006 - 2009,SG,30,234,34,92,36.95652173913043,8,25,32.0,26,67,38.80597014925373,41.30434782608695,5,10,50.0,9,20,29,16,6,4,11,13,81
Alex Blackwell,1.0,1993 - 1993,SF,27,109,14,42,33.33333333333333,0,3,0.0,14,39,35.8974358974359,33.33333333333333,6,8,75.0,10,13,23,7,4,2,5,14,34
Alex Bradley,1.0,1982 - 1982,SF,39,331,54,103,52.42718446601942,0,1,0.0,54,102,52.94117647058824,52.42718446601942,29,48,60.416666666666664,31,34,65,11,12,5,28,37,137
Alex Caruso,2.0,2018 - 2019,PG,62,1093,127,289,43.944636678200695,37,93,39.784946236559136,90,196,45.91836734693878,50.34602076124568,72,94,76.59574468085107,35,97,132,152,47,19,84,106,363
Alex Garcia,2.0,2004 - 2005,SG,10,159,19,59,32.20338983050847,5,18,27.77777777777778,14,41,34.146341463414636,36.440677966101696,4,6,66.66666666666666,7,8,15,18,6,1,9,15,47
Alex Kirk,1.0,2015 - 2015,C,5,14,1,4,25.0,0,0,,1,4,25.0,25.0,2,2,100.0,1,0,1,1,0,0,0,1,4
Alex Len,6.0,2014 - 2019,C,412,8200,1240,2544,48.742138364779876,80,229,34.93449781659388,1160,2315,50.10799136069114,50.314465408805034,715,1029,69.48493683187561,848,1751,2599,345,168,413,522,1111,3275
Alex Poythress,3.0,2017 - 2019,PF,52,566,76,161,47.20496894409938,19,53,35.84905660377358,57,108,52.77777777777778,53.105590062111794,26,39,66.66666666666666,47,75,122,24,10,13,18,77,197
Alex Scales,1.0,2006 - 2006,SG,1,0,0,0,,0,0,,0,0,,,0,0,,0,0,0,0,0,0,0,0,0
Alex Stepheson,1.0,2016 - 2016,PF,8,73,9,27,33.33333333333333,0,0,,9,27,33.33333333333333,33.33333333333333,4,12,33.33333333333333,19,9,28,2,1,5,0,12,22
Alex Stivrins,2.0,1986 - 1993,PF-SF,22,90,20,43,46.51162790697674,0,2,0.0,20,41,48.78048780487805,46.51162790697674,4,8,50.0,10,12,22,4,2,2,10,13,44
Alexander Johnson,2.0,2007 - 2008,PF,102,1302,152,294,51.70068027210885,0,0,,152,294,51.70068027210885,51.70068027210885,135,201,67.16417910447761,82,193,275,30,38,45,89,217,439
Alexander Volkov,2.0,1990 - 1992,C,149,2453,388,853,45.48651817116061,48,144,33.33333333333333,340,709,47.95486600846262,48.30011723329425,195,318,61.32075471698113,155,229,384,333,102,52,154,344,1019
Alexey Shved,3.0,2013 - 2015,SG,182,3271,445,1207,36.868268434134215,162,529,30.623818525519848,283,678,41.740412979351035,43.579121789560894,297,390,76.15384615384615,85,270,355,460,110,49,243,201,1349
Alexis Ajinca,7.0,2009 - 2017,C,296,3915,649,1287,50.427350427350426,12,42,28.57142857142857,637,1245,51.16465863453815,50.893550893550895,251,315,79.68253968253968,346,805,1151,144,103,181,249,663,1561
Alfonzo McKinnie,2.0,2018 - 2019,SF,86,1056,142,290,48.96551724137931,45,127,35.43307086614173,97,163,59.50920245398773,56.72413793103448,29,51,56.86274509803921,82,172,254,32,19,16,33,142,358
Alfredrick Hughes,1.0,1986 - 1986,SG,71,884,156,381,40.94488188976378,3,17,17.647058823529413,153,364,42.032967032967036,41.338582677165356,49,84,58.333333333333336,49,64,113,62,27,5,64,82,364
Alize Johnson,1.0,2019 - 2019,PF,14,64,4,16,25.0,1,2,50.0,3,14,21.428571428571427,28.125,4,8,50.0,4,15,19,1,1,3,0,7,13
Allan Houston,12.0,1994 - 2005,SG,902,30836,5772,12987,44.44444444444444,1381,3428,40.28588098016336,4391,9559,45.935767339679884,49.76129976129976,2840,3282,86.53260207190738,372,2246,2618,2129,609,149,1923,2213,15765
Allan Ray,1.0,2007 - 2007,SG,47,710,100,259,38.61003861003861,48,116,41.37931034482759,52,143,36.36363636363637,47.87644787644788,42,55,76.36363636363637,18,51,69,43,20,3,42,85,290
Allen Crabbe,6.0,2014 - 2019,SG,361,8905,1214,2813,43.156772129399215,601,1527,39.35821872953504,613,1286,47.66718506998445,53.83931745467473,389,470,82.76595744680851,103,940,1043,419,218,102,276,750,3418
Allen Iverson,14.0,1997 - 2010,SG,985,40787,9222,21788,42.32605103726822,1182,3759,31.444533120510776,8040,18029,44.59481945754063,45.038553332109416,6853,8794,77.92813281783035,804,2863,3667,6049,2130,178,3483,1934,26479
Allonzo Trier,1.0,2019 - 2019,SG,64,1459,232,518,44.78764478764479,52,132,39.39393939393939,180,386,46.63212435233161,49.80694980694981,179,223,80.26905829596413,31,166,197,119,28,14,116,117,695
Alonzo Gee,8.0,2010 - 2017,SF,418,9074,1001,2309,43.35210047639671,186,572,32.51748251748251,815,1737,46.91997697179045,47.379818103074925,566,751,75.36617842876166,389,972,1361,442,379,101,447,792,2754
Alonzo Mourning,15.0,1993 - 2008,C,933,28572,5557,10562,52.61314145048286,29,108,26.851851851851855,5528,10454,52.879280658121296,52.75042605567128,4459,6481,68.80111093966981,2363,5439,7802,1027,459,2571,2435,3140,15602
Alphonso Ford,2.0,1994 - 1995,PG,11,114,16,52,30.76923076923077,1,10,10.0,15,42,35.714285714285715,31.73076923076923,2,4,50.0,8,12,20,10,3,0,9,7,35
Alton Ford,3.0,2002 - 2004,PF,73,524,70,138,50.72463768115942,0,0,,70,138,50.72463768115942,50.72463768115942,46,66,69.6969696969697,35,89,124,11,6,8,37,115,186
Alton Lister,16.0,1982 - 1998,C,1040,20762,2755,5384,51.17013372956909,1,11,9.090909090909092,2754,5373,51.256281407035175,51.17942050520059,1404,2337,60.07702182284981,2023,4479,6502,984,390,1615,1576,3498,6915
Alvin Heggs,1.0,1996 - 1996,SF,4,14,3,5,60.0,0,0,,3,5,60.0,60.0,2,3,66.66666666666666,1,1,2,0,0,0,0,0,8
Alvin Jones,1.0,2002 - 2002,C,25,131,8,20,40.0,0,0,,8,20,40.0,40.0,10,20,50.0,13,24,37,3,3,9,12,35,26
Alvin Robertson,10.0,1985 - 1996,SG,792,25159,4514,9443,47.80260510431007,242,817,29.620563035495717,4272,8626,49.524692789241826,49.08397754950757,1874,2520,74.36507936507937,1648,2487,4135,4010,2148,325,2155,2691,11144
Alvin Sims,1.0,1999 - 1999,SG,4,25,4,10,40.0,1,1,100.0,3,9,33.33333333333333,45.0,2,5,40.0,3,1,4,5,2,0,6,2,11
Alvin Williams,9.0,1998 - 2007,PG,478,13293,1757,4185,41.98327359617682,221,706,31.303116147308778,1536,3479,44.15061799367634,44.623655913978496,651,858,75.87412587412588,260,939,1199,1955,570,119,647,943,4386
Amal McCaskill,4.0,1997 - 2004,C,116,975,83,218,38.07339449541284,0,3,0.0,83,215,38.604651162790695,38.07339449541284,43,72,59.72222222222222,75,141,216,37,24,36,52,133,209
Amar'e Stoudemire,14.0,2003 - 2016,PF,924,28652,6433,12028,53.483538410375786,34,143,23.776223776223777,6399,11885,53.84097602019352,53.624875290987696,4555,5995,75.97998331943286,2229,4977,7206,1114,699,1158,2135,2949,17455
Amile Jefferson,1.0,2019 - 2019,PF,12,68,10,16,62.5,0,0,,10,16,62.5,62.5,7,8,87.5,6,15,21,3,3,3,1,8,27
Amir Johnson,14.0,2006 - 2019,PF,920,19052,2670,4668,57.19794344473008,108,331,32.62839879154079,2562,4337,59.0730919990777,58.354755784061695,913,1359,67.18175128771155,1792,3082,4874,1101,535,865,972,2680,6361
Anderson Varejao,13.0,2005 - 2017,C,715,16744,1969,3872,50.85227272727273,1,47,2.127659574468085,1968,3825,51.450980392156865,50.86518595041323,1062,1687,62.951985773562534,1663,3274,4937,785,606,446,656,1867,5001
Andrae Patterson,2.0,1999 - 2000,PF,42,311,46,101,45.54455445544555,0,5,0.0,46,96,47.91666666666667,45.54455445544555,28,36,77.77777777777779,32,39,71,18,20,7,24,67,120
Andray Blatche,9.0,2006 - 2014,PF,591,12886,2395,5124,46.740827478532395,52,222,23.423423423423422,2343,4902,47.796817625459,47.24824355971897,1044,1440,72.5,1088,2057,3145,812,502,469,935,1435,5886
Andre Barrett,4.0,2005 - 2008,PG,67,819,89,241,36.92946058091287,17,69,24.637681159420293,72,172,41.86046511627907,40.45643153526971,24,33,72.72727272727273,21,50,71,135,29,1,47,69,219
Andre Brown,3.0,2007 - 2009,PF,75,598,82,159,51.57232704402516,0,1,0.0,82,158,51.89873417721519,51.57232704402516,33,66,50.0,70,108,178,11,14,8,48,73,197
Andre Dawkins,1.0,2015 - 2015,SG,4,22,1,6,16.666666666666664,1,6,16.666666666666664,0,0,,25.0,0,0,,0,2,2,1,0,0,1,3,3
Andre Drummond,7.0,2013 - 2019,C,546,16842,3271,6030,54.24543946932007,10,69,14.492753623188406,3261,5961,54.705586311021634,54.328358208955216,1176,2634,44.64692482915717,2620,4840,7460,626,727,851,973,1714,7728
Andre Emmett,2.0,2005 - 2012,SG,14,73,6,13,46.15384615384615,0,1,0.0,6,12,50.0,46.15384615384615,8,13,61.53846153846154,2,6,8,1,2,1,3,6,20
Andre Iguodala,15.0,2005 - 2019,SF,1232,41129,5326,11470,46.43417611159546,1125,3350,33.582089552238806,4201,8120,51.73645320197045,51.33827375762859,3029,4329,69.96996996996997,1168,5075,6243,5308,1835,600,2303,2255,14806
Andre Ingram,2.0,2018 - 2019,SG,6,79,8,23,34.78260869565217,5,12,41.66666666666667,3,11,27.27272727272727,45.65217391304348,3,3,100.0,2,6,8,7,4,3,4,3,24
Andre McCarter,1.0,1981 - 1981,PG,43,448,51,135,37.77777777777778,2,8,25.0,49,127,38.582677165354326,38.51851851851852,18,24,75.0,16,23,39,73,14,0,24,36,122
Andre Miller,17.0,2000 - 2016,PG,1372,42196,6363,13840,45.975433526011564,216,948,22.78481012658228,6147,12892,47.68073223704623,46.755780346820806,4194,5208,80.52995391705069,1460,3576,5036,8804,1604,232,3265,3033,17136
Andre Moore,1.0,1988 - 1988,PF-SF,10,50,9,27,33.33333333333333,0,0,,9,27,33.33333333333333,33.33333333333333,6,8,75.0,6,8,14,6,2,1,4,6,24
Andre Owens,2.0,2006 - 2008,PG,54,602,67,181,37.01657458563536,21,56,37.5,46,125,36.8,42.81767955801105,37,52,71.15384615384616,24,44,68,55,18,3,37,62,192
Andre Roberson,5.0,2014 - 2018,SG,320,7316,627,1303,48.119723714504985,127,475,26.736842105263158,500,828,60.38647342995169,52.993092862624714,133,302,44.03973509933775,391,931,1322,280,299,231,199,701,1514
Andre Spencer,2.0,1993 - 1994,SF,48,771,125,281,44.48398576512456,0,2,0.0,125,279,44.80286738351255,44.48398576512456,96,131,73.2824427480916,68,86,154,46,36,14,47,107,346
Andre Turner,6.0,1987 - 1992,PG,178,2712,328,775,42.32258064516129,17,68,25.0,311,707,43.988684582743986,43.41935483870968,152,198,76.76767676767676,64,212,276,570,148,3,220,217,825
Andrea Bargnani,10.0,2007 - 2016,PF,561,16091,2967,6761,43.88404082236356,638,1804,35.36585365853659,2329,4957,46.98406294129514,48.602277769560715,1399,1698,82.39104829210837,534,2038,2572,661,216,476,860,1369,7971
Andreas Glyniadakis,1.0,2007 - 2007,C,13,81,8,17,47.05882352941176,0,0,,8,17,47.05882352941176,47.05882352941176,1,2,50.0,2,6,8,1,0,0,9,19,17
Andrei Kirilenko,13.0,2002 - 2015,SF,852,25407,3315,7017,47.24241128687473,377,1233,30.57583130575831,2938,5784,50.79529737206086,49.92874447769702,2904,3847,75.48739277358982,1475,3089,4564,2274,1162,1548,1591,1738,9911
Andres Guibert,2.0,1994 - 1995,PF,22,200,22,67,32.83582089552239,0,4,0.0,22,63,34.92063492063492,32.83582089552239,16,25,64.0,26,35,61,12,8,2,18,35,60
Andres Nocioni,8.0,2005 - 2012,SF,537,12652,2037,4718,43.17507418397626,616,1653,37.26557773744707,1421,3065,46.362153344208814,49.70326409495549,1024,1282,79.87519500780031,370,2064,2434,645,223,241,763,1461,5714
Andrew Bogut,14.0,2006 - 2019,C,764,21166,3135,5850,53.58974358974359,3,28,10.714285714285714,3132,5822,53.79594641016833,53.61538461538462,854,1553,54.9903412749517,1890,4662,6552,1651,476,1178,1279,2387,7127
Andrew Bynum,8.0,2006 - 2014,C,492,12479,2193,3996,54.87987987987988,1,9,11.11111111111111,2192,3987,54.97868071231502,54.892392392392395,1141,1645,69.36170212765957,1189,2529,3718,538,157,767,722,1227,5528
Andrew DeClercq,10.0,1996 - 2005,C,600,10014,1138,2241,50.78090138331102,0,2,0.0,1138,2239,50.826261723983926,50.78090138331102,587,947,61.98521647307286,1040,1487,2527,342,394,308,562,1834,2863
Andrew Gaze,2.0,1994 - 1999,SG,26,128,16,42,38.095238095238095,9,24,37.5,7,18,38.88888888888889,48.80952380952381,2,2,100.0,3,9,12,11,4,2,7,16,43
Andrew Goudelock,3.0,2012 - 2016,SG,58,576,98,241,40.66390041493776,32,96,33.33333333333333,66,145,45.51724137931035,47.30290456431535,16,18,88.88888888888889,8,34,42,27,15,2,35,44,244
Andrew Harrison,3.0,2017 - 2019,PG,151,3106,327,871,37.54305396096441,100,336,29.761904761904763,227,535,42.429906542056074,43.28358208955223,297,380,78.15789473684211,56,242,298,412,98,50,181,380,1051
Andrew Lang,12.0,1989 - 2000,C,779,16027,1848,3938,46.927374301675975,5,21,23.809523809523807,1843,3917,47.051314781720706,46.99085830370747,923,1238,74.55573505654282,1232,2414,3646,436,347,1149,736,2149,4624
Andrew Nicholson,5.0,2013 - 2017,PF,285,4080,708,1517,46.671061305207644,87,271,32.10332103321033,621,1246,49.83948635634029,49.5385629531971,197,255,77.25490196078432,188,669,857,126,74,95,212,458,1700
Andrew Toney,8.0,1981 - 1988,SG,540,14754,3344,6733,49.66582504084361,150,454,33.03964757709251,3194,6279,50.86797260710304,50.77974157136492,1874,2356,79.54159592529712,291,886,1177,2288,427,123,1651,1606,8712
Andrew White,1.0,2018 - 2018,SF,15,209,25,73,34.24657534246575,18,49,36.734693877551024,7,24,29.166666666666668,46.57534246575342,1,4,25.0,4,30,34,6,3,1,8,12,69
Andrew Wiggins,5.0,2015 - 2019,SF,405,14548,2897,6578,44.040741866828824,436,1312,33.23170731707317,2461,5266,46.73376376756552,47.35481909394953,1617,2203,73.39990921470722,511,1218,1729,877,409,227,831,868,7847
Andris Biedrins,10.0,2005 - 2014,C,530,11430,1459,2446,59.64840556009812,0,2,0.0,1459,2444,59.69721767594108,59.64840556009812,399,796,50.12562814070351,1211,2496,3707,473,339,599,489,1661,3317
Andy Panko,1.0,2001 - 2001,SF,1,1,0,0,,0,0,,0,0,,,0,0,,0,0,0,0,0,0,0,0,0
Andy Rautins,1.0,2011 - 2011,SG,5,24,3,7,42.857142857142854,1,4,25.0,2,3,66.66666666666666,50.0,1,2,50.0,0,1,1,3,1,0,7,0,8
Andy Toolson,2.0,1991 - 1996,SF,62,527,58,148,39.189189189189186,15,45,33.33333333333333,43,103,41.74757281553398,44.25675675675676,28,37,75.67567567567568,32,41,73,33,15,2,26,70,159
Anfernee Hardaway,14.0,1994 - 2008,SG,768,26351,4451,9749,45.65596471432967,604,1857,32.525578890683896,3847,7892,48.7455651292448,48.753718330085135,2482,3221,77.05681465383421,1076,2373,3449,3919,1244,360,1974,1759,11988
Anfernee Simons,1.0,2019 - 2019,SG,20,141,28,63,44.44444444444444,10,29,34.48275862068966,18,34,52.94117647058824,52.38095238095239,9,16,56.25,3,10,13,13,1,0,11,9,75
Angel Delgado,1.0,2019 - 2019,C,2,15,1,5,20.0,0,0,,1,5,20.0,20.0,1,2,50.0,2,2,4,0,1,0,0,2,3
Ansu Sesay,4.0,2002 - 2005,SF,131,1361,164,379,43.27176781002638,8,29,27.586206896551722,156,350,44.57142857142857,44.327176781002635,72,112,64.28571428571429,104,133,237,66,38,34,60,170,408
Antawn Jamison,16.0,1999 - 2014,PF,1129,39244,7982,17701,45.09349754251172,1223,3541,34.53826602654617,6759,14160,47.733050847457626,48.54810462685724,3646,5037,72.38435576732182,2646,5841,8487,1819,1084,454,1784,2719,20833
Ante Zizic,2.0,2018 - 2019,C,99,1319,237,408,58.08823529411765,0,0,,237,408,58.08823529411765,58.08823529411765,117,167,70.05988023952095,133,253,386,59,15,36,74,145,591
Anthony Avent,6.0,1993 - 2000,PF,361,6809,823,2039,40.36292300147131,0,3,0.0,823,2036,40.422396856581535,40.36292300147131,340,493,68.96551724137932,572,1031,1603,279,166,212,419,837,1986
Anthony Bennett,4.0,2014 - 2017,PF,151,1905,251,641,39.15756630265211,36,138,26.08695652173913,215,503,42.74353876739563,41.96567862714509,120,179,67.0391061452514,132,340,472,77,58,27,99,206,658
Anthony Bonner,6.0,1991 - 1996,PF,341,7544,898,1917,46.84402712571727,2,17,11.76470588235294,896,1900,47.1578947368421,46.8961919666145,446,758,58.839050131926115,729,1035,1764,447,352,85,466,815,2244
Anthony Bowie,8.0,1989 - 1998,SG,501,8659,1283,2703,47.46577876433592,72,218,33.02752293577982,1211,2485,48.732394366197184,48.79763226045135,396,479,82.6722338204593,306,744,1050,873,293,109,492,758,3034
Anthony Brown,3.0,2016 - 2018,SF,41,762,58,177,32.7683615819209,28,98,28.57142857142857,30,79,37.9746835443038,40.67796610169492,17,20,85.0,17,86,103,28,19,6,21,49,161
Anthony Carter,13.0,2000 - 2012,PG,662,12887,1307,3222,40.56486654252017,120,491,24.43991853360489,1187,2731,43.463932625411935,42.427063935443826,449,636,70.59748427672956,267,1132,1399,2489,633,121,1010,1170,3183
Anthony Cook,4.0,1991 - 1996,PF,116,1499,166,378,43.91534391534391,0,6,0.0,166,372,44.623655913978496,43.91534391534391,86,164,52.4390243902439,172,256,428,34,43,91,66,140,418
Anthony Davis,7.0,2013 - 2019,PF,479,16638,4306,8321,51.748587910106956,187,600,31.166666666666664,4119,7721,53.348011915554984,52.87225093137844,2657,3334,79.69406118776244,1241,3830,5071,1005,662,1154,905,1148,11456
Anthony Frederick,3.0,1989 - 1992,SF,147,1640,291,663,43.89140271493213,6,22,27.27272727272727,285,641,44.46177847113885,44.34389140271493,130,186,69.89247311827957,137,143,280,135,76,45,132,200,718
Anthony Goldwire,8.0,1996 - 2006,PG,266,4951,580,1425,40.70175438596491,206,533,38.649155722326455,374,892,41.92825112107623,47.929824561403514,301,380,79.21052631578948,72,287,359,737,167,9,264,388,1667
Anthony Grundy,1.0,2006 - 2006,SG,12,108,19,38,50.0,5,15,33.33333333333333,14,23,60.86956521739131,56.57894736842105,9,14,64.28571428571429,1,16,17,9,7,0,9,14,52
Anthony Johnson,13.0,1998 - 2010,PG,893,17121,1884,4564,41.27957931638913,368,1045,35.21531100478469,1516,3519,43.08042057402671,45.311130587204204,780,1052,74.1444866920152,327,1194,1521,2496,603,102,949,1444,4916
Anthony Jones,3.0,1987 - 1990,SG,165,1707,234,595,39.32773109243698,15,49,30.612244897959183,219,546,40.10989010989011,40.588235294117645,111,150,74.0,87,127,214,119,85,38,96,176,594
Anthony Mason,13.0,1990 - 2003,PF,978,33697,3916,7669,51.06272004172643,2,16,12.5,3914,7653,51.14334248007317,51.07575955144087,2731,3875,70.47741935483872,2134,5781,7915,3177,702,272,1724,2610,10565
Anthony Miller,8.0,1995 - 2005,PF,189,1685,200,396,50.505050505050505,2,8,25.0,198,388,51.03092783505154,50.75757575757576,116,200,57.99999999999999,192,311,503,68,61,27,94,251,518
Anthony Morrow,9.0,2009 - 2017,SG,581,12385,1972,4413,44.686154543394515,812,1951,41.6196822142491,1160,2462,47.1161657189277,53.88624518468163,620,703,88.19345661450924,309,911,1220,497,318,75,384,904,5376
Anthony Parker,9.0,1998 - 2012,SG,516,14519,1737,3919,44.32253125797397,629,1555,40.45016077170418,1108,2364,46.86971235194585,52.34753763715233,614,773,79.43078913324709,249,1413,1662,1159,461,92,517,838,4717
Anthony Peeler,13.0,1993 - 2005,SG,884,21881,3251,7680,42.330729166666664,996,2615,38.087954110898664,2255,5065,44.52122408687068,48.815104166666664,918,1149,79.89556135770235,615,1710,2325,2058,838,148,1080,1787,8416
Anthony Pullard,1.0,1993 - 1993,PF,8,37,8,18,44.44444444444444,0,0,,8,18,44.44444444444444,44.44444444444444,1,3,33.33333333333333,2,6,8,2,2,2,5,5,17
Anthony Randolph,6.0,2009 - 2014,PF,257,3871,686,1505,45.58139534883721,20,83,24.096385542168676,666,1422,46.835443037974684,46.245847176079735,423,572,73.95104895104895,335,749,1084,187,152,224,300,460,1815
Anthony Roberson,3.0,2006 - 2009,PG,66,595,105,259,40.54054054054054,54,148,36.486486486486484,51,111,45.94594594594595,50.965250965250966,9,10,90.0,9,41,50,35,25,1,25,51,273
Anthony Taylor,1.0,1989 - 1989,PG,21,368,60,151,39.735099337748345,0,2,0.0,60,149,40.26845637583892,39.735099337748345,24,32,75.0,11,23,34,43,22,5,20,37,144
Anthony Tolliver,11.0,2009 - 2019,PF,677,13341,1408,3359,41.917237272997916,820,2176,37.68382352941176,588,1183,49.70414201183432,54.123250967549865,632,819,77.16727716727718,513,1756,2269,609,251,204,426,1099,4268
Anthony Tucker,1.0,1995 - 1995,SF,62,982,96,210,45.714285714285715,0,1,0.0,96,209,45.933014354066984,45.714285714285715,51,83,61.44578313253012,44,126,170,68,46,11,56,129,243
Antoine Carr,16.0,1985 - 2000,PF,1094,21612,3964,7872,50.355691056910565,7,49,14.285714285714285,3957,7823,50.581618304998074,50.400152439024396,1972,2537,77.72960189199843,1245,2414,3659,1189,388,1017,1273,3446,9907
Antoine Rigaudeau,1.0,2003 - 2003,SG,11,91,8,35,22.857142857142858,1,5,20.0,7,30,23.333333333333332,24.285714285714285,0,0,,4,4,8,6,3,0,6,11,17
Antoine Walker,12.0,1997 - 2008,PF,957,33992,6483,15690,41.31931166347992,1508,4611,32.70440251572327,4975,11079,44.9047747991696,46.124920331421286,2203,3472,63.45046082949308,1994,5354,7348,3353,1164,497,2674,2728,16677
Antoine Wright,6.0,2006 - 2011,SG,325,6061,656,1582,41.46649810366625,166,537,30.91247672253259,490,1045,46.889952153110045,46.713021491782555,245,358,68.43575418994413,167,551,718,306,147,78,238,642,1723
Antonio Anderson,1.0,2010 - 2010,SF,1,15,1,3,33.33333333333333,0,0,,1,3,33.33333333333333,33.33333333333333,0,0,,1,0,1,0,0,0,1,1,2
Antonio Blakeney,2.0,2018 - 2019,SG,76,1143,219,539,40.63079777365491,51,143,35.66433566433567,168,396,42.42424242424242,45.36178107606679,80,115,69.56521739130434,11,128,139,62,19,10,46,60,569
Antonio Burks,2.0,2005 - 2006,PG,84,805,80,205,39.02439024390244,4,17,23.52941176470588,76,188,40.42553191489361,40.0,25,44,56.81818181818182,5,45,50,107,34,1,48,72,189
Antonio Daniels,13.0,1998 - 2011,PG,952,21528,2500,5608,44.57917261055635,401,1273,31.50039277297722,2099,4335,48.419838523644756,48.15442225392297,1913,2392,79.97491638795987,242,1535,1777,3164,613,95,1004,997,7314
Antonio Davis,13.0,1994 - 2006,PF,996,28731,3498,7770,45.019305019305015,3,24,12.5,3495,7746,45.12006196746708,45.03861003861004,2945,4084,72.11067580803135,2551,4890,7441,1100,487,991,1490,2861,9944
Antonio Harvey,8.0,1994 - 2003,PF,192,1972,230,566,40.63604240282685,1,3,33.33333333333333,229,563,40.67495559502664,40.724381625441694,92,180,51.11111111111111,156,284,440,58,54,130,109,259,553
Antonio Lang,6.0,1995 - 2000,SF,144,1397,121,266,45.48872180451128,0,8,0.0,121,258,46.89922480620155,45.48872180451128,87,121,71.900826446281,80,130,210,50,55,46,89,207,329
Antonio McDyess,15.0,1996 - 2011,PF,1115,30414,5394,10876,49.59543949981611,7,63,11.11111111111111,5387,10813,49.819661518542496,49.62762044869437,2239,3339,67.05600479185385,2704,5614,8318,1390,833,1182,1725,3406,13034
Antonis Fotsis,1.0,2002 - 2002,PF,28,320,42,104,40.38461538461539,7,23,30.434782608695656,35,81,43.20987654320987,43.75,17,20,85.0,25,37,62,10,9,11,21,22,108
Antonius Cleveland,1.0,2018 - 2018,SG,17,123,8,21,38.095238095238095,3,4,75.0,5,17,29.411764705882355,45.23809523809524,4,6,66.66666666666666,3,11,14,2,7,5,7,23,23
Archie Goodwin,4.0,2014 - 2017,SG,165,2396,367,856,42.873831775700936,45,191,23.56020942408377,322,665,48.421052631578945,45.50233644859813,261,373,69.97319034852548,86,245,331,206,69,38,206,192,1040
Arinze Onuaku,3.0,2014 - 2017,C,19,126,15,23,65.21739130434783,0,0,,15,23,65.21739130434783,65.21739130434783,4,10,40.0,11,24,35,9,1,4,5,12,34
Armen Gilliam,13.0,1988 - 2000,PF,963,27113,4949,10145,48.78265155248891,0,18,0.0,4949,10127,48.86935913893552,48.78265155248891,3104,3998,77.63881940970485,2156,4401,6557,1106,690,627,1762,2062,13002
Armon Johnson,2.0,2011 - 2012,PG,49,401,66,144,45.83333333333333,6,15,40.0,60,129,46.51162790697674,47.91666666666667,19,28,67.85714285714286,12,38,50,56,10,1,44,40,157
Arnett Moultrie,2.0,2013 - 2014,PF,59,729,94,172,54.65116279069767,0,0,,94,172,54.65116279069767,54.65116279069767,22,33,66.66666666666666,87,93,180,12,25,14,26,65,210
Aron Baynes,7.0,2013 - 2019,C,472,7053,994,1997,49.774661992989486,36,113,31.858407079646017,958,1884,50.84925690021231,50.67601402103155,459,570,80.52631578947368,712,1346,2058,329,98,220,371,979,2483
Arron Afflalo,11.0,2008 - 2018,SG,797,21473,3064,6824,44.90035169988277,868,2267,38.28848698720776,2196,4557,48.18959842001317,51.260257913247365,1411,1713,82.37011091652072,341,1896,2237,1428,351,147,875,1546,8407
Art Collins,1.0,1981 - 1981,SG,29,395,35,99,35.35353535353536,0,2,0.0,35,97,36.08247422680412,35.35353535353536,24,36,66.66666666666666,19,22,41,25,11,1,32,35,94
Art Long,3.0,2001 - 2003,SF,98,1220,148,323,45.82043343653251,2,3,66.66666666666666,146,320,45.625,46.13003095975232,47,97,48.45360824742268,130,189,319,48,27,42,85,220,345
Arvydas Macijauskas,1.0,2006 - 2006,SG,19,135,14,41,34.146341463414636,3,12,25.0,11,29,37.93103448275862,37.80487804878049,13,15,86.66666666666667,3,7,10,5,7,0,8,10,44
Arvydas Sabonis,7.0,1996 - 2003,C,521,12842,2304,4651,49.53773382068372,151,462,32.683982683982684,2153,4189,51.39651468130819,51.16104063642227,1487,1887,78.80233174350822,806,3008,3814,1061,418,542,919,1465,6246
Ashraf Amaya,2.0,1996 - 1997,PF,85,1248,133,292,45.54794520547945,1,2,50.0,132,290,45.51724137931035,45.71917808219178,112,177,63.2768361581921,133,222,355,36,29,13,67,180,379
Askia Jones,1.0,1995 - 1995,SG,11,139,15,44,34.090909090909086,2,12,16.666666666666664,13,32,40.625,36.36363636363637,13,16,81.25,6,5,11,16,6,0,9,19,45
Audie Norris,3.0,1983 - 1985,C,207,2799,315,609,51.724137931034484,0,3,0.0,315,606,51.98019801980198,51.724137931034484,268,414,64.73429951690821,228,419,647,159,92,77,265,556,898
Austin Croshere,12.0,1998 - 2009,PF,727,12716,1621,4002,40.504747626186905,470,1376,34.156976744186046,1151,2626,43.83092155369383,46.3768115942029,1216,1416,85.87570621468926,777,2118,2895,676,272,240,719,1215,4928
Austin Daye,6.0,2010 - 2015,SF,298,4158,570,1420,40.140845070422536,188,536,35.07462686567165,382,884,43.21266968325792,46.76056338028169,201,258,77.90697674418605,143,623,766,212,116,118,205,482,1529
Austin Rivers,7.0,2013 - 2019,SG,507,12407,1743,4176,41.73850574712644,537,1552,34.600515463917525,1206,2624,45.96036585365854,48.168103448275865,637,998,63.827655310621246,174,862,1036,1188,350,95,593,1131,4660
Avery Bradley,9.0,2011 - 2019,SG,561,16207,2720,6259,43.457421313308835,734,2039,35.9980382540461,1986,4220,47.06161137440758,49.320977791979544,590,758,77.83641160949868,369,1308,1677,1010,584,122,811,1230,6764
Avery Johnson,16.0,1989 - 2004,PG,1144,29422,4020,8383,47.95419300966241,28,202,13.861386138613863,3992,8181,48.79599071018213,48.121197661934865,1698,2420,70.16528925619835,421,1516,1937,6408,1109,165,1919,1833,9766
Awvee Storey,3.0,2005 - 2008,SG,60,407,58,140,41.42857142857143,4,16,25.0,54,124,43.54838709677419,42.857142857142854,23,45,51.11111111111111,43,38,81,21,10,2,15,66,143
Axel Toupane,2.0,2016 - 2017,SF,25,352,30,79,37.9746835443038,14,44,31.818181818181817,16,35,45.714285714285715,46.835443037974684,13,17,76.47058823529412,8,24,32,15,8,7,6,46,87
B.J. Armstrong,11.0,1990 - 2000,PG,852,20154,3164,6648,47.59326113116727,487,1139,42.756804214223,2677,5509,48.593211109094206,51.256016847172084,1333,1562,85.3393085787452,216,1256,1472,2731,615,50,968,1299,8148
B.J. Johnson,1.0,2019 - 2019,SF,7,49,9,18,50.0,3,7,42.857142857142854,6,11,54.54545454545454,58.333333333333336,2,2,100.0,2,6,8,0,2,0,2,4,23
B.J. Tyler,1.0,1995 - 1995,PG,55,809,72,189,38.095238095238095,16,51,31.372549019607842,56,138,40.57971014492754,42.32804232804233,35,50,70.0,13,49,62,174,36,2,97,58,195
Bam Adebayo,2.0,2018 - 2019,C,156,3358,461,841,54.81569560047562,3,23,13.043478260869565,458,818,55.99022004889975,54.99405469678954,298,419,71.1217183770883,292,706,998,285,103,108,189,349,1223
Baron Davis,13.0,2000 - 2012,PG,885,30443,5217,12696,41.09168241965973,1431,4442,32.21521837010356,3786,8254,45.86866973588563,46.7273156899811,2524,3553,71.03855896425556,811,2585,3396,6336,1644,384,2439,2538,14389
Barry Stevens,1.0,1993 - 1993,SF,2,6,1,2,50.0,0,0,,1,2,50.0,50.0,0,0,,2,0,2,0,0,0,0,1,2
Barry Sumpter,1.0,1989 - 1989,PF,1,1,0,1,0.0,0,0,,0,1,0.0,0.0,0,0,,0,0,0,0,0,0,0,0,0
Bart Kofoed,5.0,1988 - 1993,SG,121,811,67,173,38.72832369942196,4,21,19.047619047619047,63,152,41.44736842105263,39.884393063583815,45,72,62.5,19,51,70,119,20,4,65,113,183
Ben Bentil,1.0,2017 - 2017,PF,3,10,0,3,0.0,0,1,0.0,0,2,0.0,0.0,0,0,,0,2,2,0,0,0,1,1,0
Ben Coleman,5.0,1987 - 1994,PF,230,3635,589,1137,51.80299032541777,0,5,0.0,589,1132,52.03180212014134,51.80299032541777,330,434,76.036866359447,307,626,933,128,95,99,303,621,1508
Ben Davis,4.0,1997 - 2000,PF,40,154,21,59,35.59322033898305,0,0,,21,59,35.59322033898305,35.59322033898305,12,26,46.15384615384615,30,23,53,5,6,2,7,25,54
Ben Gillery,1.0,1989 - 1989,C,24,84,6,19,31.57894736842105,0,0,,6,19,31.57894736842105,31.57894736842105,13,23,56.52173913043478,7,16,23,2,2,4,5,29,25
Ben Gordon,11.0,2005 - 2015,SG,773,21463,4117,9553,43.09640950486758,1234,3085,40.0,2883,6468,44.573283858998145,49.555113576886846,2203,2575,85.55339805825243,356,1589,1945,1960,531,118,1623,1806,11671
Ben Handlogten,2.0,2004 - 2005,C,38,469,68,130,52.307692307692314,0,1,0.0,68,129,52.71317829457365,52.307692307692314,27,44,61.36363636363637,45,75,120,19,10,9,28,87,163
Ben Hansbrough,1.0,2013 - 2013,PG,34,222,15,50,30.0,6,26,23.076923076923077,9,24,37.5,36.0,21,27,77.77777777777779,3,18,21,24,7,3,20,25,57
Ben McDonald,4.0,1986 - 1989,PF,186,3777,466,1010,46.13861386138614,10,49,20.408163265306122,456,961,47.45057232049948,46.633663366336634,127,176,72.1590909090909,221,361,582,246,82,18,153,502,1069
Ben McLemore,6.0,2014 - 2019,SG,368,8725,1175,2821,41.65189649060616,439,1243,35.31777956556718,736,1578,46.64131812420786,49.43282523927685,450,575,78.26086956521739,174,735,909,407,247,71,461,829,3239
Ben Moore,1.0,2018 - 2018,PF,2,9,0,0,,0,0,,0,0,,,0,0,,0,1,1,1,0,0,0,4,0
Ben Simmons,2.0,2018 - 2019,PG,170,5801,1145,2083,54.96879500720115,0,18,0.0,1145,2065,55.44794188861986,54.96879500720115,489,827,59.12938331318017,333,1117,1450,1348,269,139,596,454,2779
Ben Uzoh,2.0,2011 - 2012,PG,60,808,96,243,39.50617283950617,3,9,33.33333333333333,93,234,39.743589743589745,40.123456790123456,44,75,58.666666666666664,49,79,128,130,30,11,44,60,239
Ben Wallace,16.0,1997 - 2012,C,1218,36609,2933,6176,47.490284974093264,7,61,11.475409836065573,2926,6115,47.84955028618152,47.546955958549226,1320,3184,41.45728643216081,3907,8029,11936,1610,1568,2387,1197,2374,7193
Beno Udrih,13.0,2005 - 2017,PG,884,18783,2830,6154,45.98635034124147,484,1407,34.39943141435678,2346,4747,49.42068674952601,49.91875203119922,1044,1255,83.18725099601593,320,1446,1766,2922,593,72,1218,1332,7188
Benoit Benjamin,15.0,1986 - 2000,C,825,22343,3638,7323,49.67909326778643,1,22,4.545454545454546,3637,7301,49.815093822764005,49.685921070599484,2091,2895,72.2279792746114,1481,4682,6163,1077,532,1615,1871,2345,9368
Bernard James,3.0,2013 - 2015,C,95,771,76,153,49.673202614379086,0,3,0.0,76,150,50.66666666666667,49.673202614379086,51,75,68.0,86,127,213,13,18,61,34,105,203
Bernard Robinson,3.0,2005 - 2007,SG,129,1915,212,509,41.650294695481335,5,31,16.129032258064516,207,478,43.30543933054393,42.14145383104126,147,187,78.6096256684492,86,230,316,128,110,16,111,217,576
Bernard Thompson,5.0,1985 - 1989,SF,206,2945,410,939,43.66347177848775,0,17,0.0,410,922,44.46854663774403,43.66347177848775,260,329,79.0273556231003,165,190,355,268,127,28,181,392,1080
Bill Curley,5.0,1995 - 2001,PF,149,1621,157,354,44.35028248587571,2,9,22.22222222222222,155,345,44.927536231884055,44.632768361581924,78,105,74.28571428571429,124,166,290,60,61,44,75,345,394
Bill Edwards,1.0,1994 - 1994,PF,3,44,2,18,11.11111111111111,0,5,0.0,2,13,15.384615384615385,11.11111111111111,2,5,40.0,5,9,14,4,3,1,4,6,6
Bill Garnett,4.0,1983 - 1986,PF,308,5334,587,1197,49.03926482873851,1,10,10.0,586,1187,49.3681550126369,49.08103592314119,501,694,72.19020172910663,478,842,1320,397,159,175,333,842,1676
Bill Hanzlik,10.0,1981 - 1990,SF,810,16861,1990,4586,43.39293501962494,51,242,21.074380165289256,1939,4344,44.63627992633518,43.948975141735716,1823,2336,78.03938356164383,755,1485,2240,2225,776,234,1170,2431,5854
Bill Jones,1.0,1989 - 1989,PF,37,307,50,102,49.01960784313725,0,1,0.0,50,101,49.504950495049506,49.01960784313725,29,43,67.44186046511628,20,27,47,20,17,6,18,38,129
Bill Laimbeer,14.0,1981 - 1994,C,1181,37691,6123,12372,49.49078564500485,246,756,32.53968253968254,5877,11616,50.59400826446281,50.484966052376336,2652,3175,83.5275590551181,3076,8421,11497,2379,794,1048,1737,4041,15144
Bill Martin,3.0,1986 - 1988,SF,84,860,168,374,44.919786096256686,0,9,0.0,168,365,46.02739726027397,44.919786096256686,61,75,81.33333333333333,53,83,136,58,30,9,74,129,397
Bill Mayfield,1.0,1981 - 1981,SF,7,54,8,18,44.44444444444444,0,0,,8,18,44.44444444444444,44.44444444444444,1,2,50.0,7,2,9,1,0,1,3,8,17
Bill Wennington,13.0,1986 - 2000,C,790,10312,1458,3178,45.877910635619884,6,38,15.789473684210526,1452,3140,46.24203821656051,45.972309628697296,557,712,78.23033707865169,729,1520,2249,465,240,259,468,1802,3479
Billy Donovan,1.0,1988 - 1988,PG,44,364,44,109,40.36697247706422,0,7,0.0,44,102,43.13725490196079,40.36697247706422,17,21,80.95238095238095,5,20,25,87,16,1,42,33,105
Billy Garrett,1.0,2019 - 2019,SG,4,63,11,27,40.74074074074074,0,8,0.0,11,19,57.89473684210527,40.74074074074074,4,4,100.0,0,3,3,7,1,1,2,3,26
Billy Owens,10.0,1992 - 2001,SF,611,18034,2943,6110,48.16693944353519,82,287,28.57142857142857,2861,5823,49.13274944186845,48.837970540098205,1227,1949,62.955361723961,1479,2626,4105,1744,585,326,1334,1803,7195
Billy Reid,1.0,1981 - 1981,SG,59,597,84,185,45.40540540540541,0,5,0.0,84,180,46.666666666666664,45.40540540540541,22,39,56.41025641025641,27,33,60,71,33,5,78,111,190
Billy Thomas,3.0,2005 - 2008,SF,61,553,52,161,32.298136645962735,32,108,29.629629629629626,20,53,37.735849056603776,42.2360248447205,13,17,76.47058823529412,12,42,54,27,26,2,19,55,149
Billy Thompson,6.0,1987 - 1992,SF,303,6724,1080,2139,50.49088359046283,2,13,15.384615384615385,1078,2126,50.70555032925682,50.53763440860215,418,619,67.52827140549273,673,948,1621,516,162,272,529,819,2580
Bimbo Coles,14.0,1991 - 2004,PG,863,20513,2581,6052,42.64705882352941,254,950,26.736842105263158,2327,5102,45.60956487651901,44.74553866490417,1304,1609,81.04412678682411,473,1369,1842,3338,745,135,1283,1845,6720
Bismack Biyombo,8.0,2012 - 2019,C,606,12389,1124,2163,51.96486361534905,0,2,0.0,1124,2161,52.01295696436835,51.96486361534905,763,1335,57.15355805243446,1193,2665,3858,297,157,832,550,1344,3011
Bison Dele,8.0,1992 - 1999,C,452,10795,1973,3737,52.7963607171528,2,14,14.285714285714285,1971,3723,52.94117647058824,52.82312014985282,892,1300,68.61538461538461,934,1840,2774,465,346,377,870,1436,4840
Blair Rasmussen,8.0,1986 - 1993,C,561,12041,2388,5083,46.98012984457997,9,35,25.71428571428571,2379,5048,47.127575277337556,47.06866024001574,679,882,76.98412698412699,981,2205,3186,492,220,511,481,1707,5464
Blake Ahearn,3.0,2008 - 2012,PG,22,234,23,80,28.749999999999996,15,48,31.25,8,32,25.0,38.125,32,33,96.96969696969697,1,21,22,24,7,0,22,27,93
Blake Griffin,9.0,2011 - 2019,PF,655,22971,5376,10728,50.11185682326622,387,1135,34.096916299559474,4989,9593,52.00667153132492,51.91554809843401,3134,4511,69.47461760141876,1438,4415,5853,2891,602,360,1706,1923,14273
Blue Edwards,10.0,1990 - 1999,SF,738,19131,3128,6588,47.4802671523983,309,924,33.44155844155844,2819,5664,49.7704802259887,49.82544019429265,1285,1650,77.87878787878788,736,1743,2479,1453,768,303,1242,2024,7850
Bo Kimble,3.0,1991 - 1993,SG,108,1341,217,563,38.54351687388988,25,86,29.069767441860467,192,477,40.25157232704403,40.763765541740675,115,158,72.78481012658227,58,104,162,99,41,14,99,207,574
Bo Outlaw,15.0,1994 - 2008,PF,936,21156,2034,3599,56.51569880522367,3,39,7.6923076923076925,2031,3560,57.050561797752806,56.557377049180324,972,1879,51.72964342735498,1712,2813,4525,1468,866,1212,1083,2221,5043
Bob Hansen,9.0,1984 - 1992,SG,624,12183,1802,3848,46.82952182952183,203,587,34.582623509369675,1599,3261,49.03403863845446,49.46725571725572,560,838,66.82577565632458,448,957,1405,1028,378,54,620,1320,4367
Bob Martin,2.0,1994 - 1995,C,54,549,41,93,44.086021505376344,0,0,,41,93,44.086021505376344,44.086021505376344,31,51,60.78431372549019,38,81,119,18,8,34,29,108,113
Bob McCann,5.0,1990 - 1998,SF,179,2398,299,624,47.91666666666667,1,5,20.0,298,619,48.1421647819063,47.996794871794876,146,253,57.70750988142292,155,315,470,104,80,80,136,351,745
Bob Miller,1.0,1984 - 1984,PF,2,8,2,3,66.66666666666666,0,0,,2,3,66.66666666666666,66.66666666666666,0,0,,2,3,5,1,0,1,0,5,4
Bob Sura,10.0,1996 - 2005,SG,670,15828,1941,4682,41.45664246048697,430,1318,32.62518968133536,1511,3364,44.916765755053504,46.048697137975225,1405,2039,68.90632663070132,592,1679,2271,2495,650,142,1248,1500,5717
Bob Thornton,8.0,1986 - 1996,PF,299,3507,329,743,44.27994616419919,2,9,22.22222222222222,327,734,44.550408719346045,44.414535666218036,210,376,55.85106382978723,282,454,736,104,76,36,213,603,870
Boban Marjanovic,4.0,2016 - 2019,C,193,1861,424,726,58.40220385674931,4,10,40.0,420,716,58.659217877094974,58.67768595041323,317,409,77.50611246943765,258,489,747,109,44,75,137,230,1169
Bobby Brown,4.0,2009 - 2018,PG,163,1710,281,735,38.23129251700681,101,314,32.1656050955414,180,421,42.75534441805225,45.102040816326536,50,62,80.64516129032258,23,82,105,231,41,4,123,149,713
Bobby Cattage,2.0,1982 - 1986,PF,78,522,88,218,40.36697247706422,1,7,14.285714285714285,87,211,41.23222748815166,40.596330275229356,65,85,76.47058823529412,37,70,107,11,13,0,31,81,242
Bobby Hurley,5.0,1994 - 1998,PG,270,4172,361,1023,35.28836754643206,64,235,27.23404255319149,297,788,37.690355329949234,38.41642228739003,246,320,76.875,53,230,283,880,120,7,385,360,1032
Bobby Jackson,12.0,1998 - 2009,PG,813,18051,2952,7087,41.653732185692114,732,2106,34.75783475783476,2220,4981,44.56936358161012,46.81811768025963,1241,1563,79.39859245041588,660,1852,2512,2064,747,74,1080,1473,7877
Bobby Phills,9.0,1992 - 2000,SG,493,14026,2028,4594,44.14453635176317,354,914,38.7308533916849,1674,3680,45.48913043478261,47.99738789725729,921,1255,73.38645418326693,430,1108,1538,1294,616,142,746,1154,5331
Bobby Portis,4.0,2016 - 2019,PF,255,5165,1047,2283,45.860709592641264,209,575,36.347826086956516,838,1708,49.06323185011709,50.43802014892685,284,378,75.13227513227513,471,1099,1570,289,129,79,274,479,2587
Bobby Simmons,10.0,2002 - 2012,SF,475,11704,1570,3603,43.57479877879545,384,971,39.54685890834192,1186,2632,45.06079027355623,48.903691368304194,709,862,82.25058004640371,563,1247,1810,720,405,84,529,1171,4233
Bogdan Bogdanovic,2.0,2018 - 2019,SG,148,4122,705,1635,43.11926605504588,263,701,37.51783166904422,442,934,47.32334047109208,51.162079510703364,234,281,83.27402135231317,71,395,466,525,144,31,242,314,1907
Bojan Bogdanovic,5.0,2015 - 2019,SF,425,11797,1978,4300,46.0,727,1881,38.64965443912812,1251,2419,51.71558495245969,54.45348837209303,876,1040,84.23076923076923,200,1251,1451,590,237,33,593,688,5559
Boniface N'Dong,1.0,2006 - 2006,C,23,152,22,53,41.509433962264154,0,1,0.0,22,52,42.30769230769231,41.509433962264154,6,9,66.66666666666666,15,22,37,7,2,5,6,23,50
Bonzi Wells,10.0,1999 - 2008,SG,639,16233,3012,6546,46.012832263978005,239,741,32.25371120107962,2773,5805,47.76916451335056,47.83837457989612,1403,2022,69.38674579624134,861,2090,2951,1324,812,203,1297,1660,7666
Bonzie Colson,1.0,2019 - 2019,SF,8,98,13,39,33.33333333333333,5,21,23.809523809523807,8,18,44.44444444444444,39.743589743589745,8,9,88.88888888888889,8,22,30,3,5,1,3,3,39
Boris Diaw,14.0,2004 - 2017,PF,1183,31912,4253,8600,49.45348837209303,523,1556,33.61182519280206,3730,7044,52.95286768881318,52.49418604651163,1207,1678,71.93087008343267,1403,3751,5154,4066,720,562,2078,2530,10236
Bostjan Nachbar,6.0,2003 - 2008,SF,335,5951,788,1938,40.66047471620227,344,918,37.47276688453159,444,1020,43.529411764705884,49.53560371517028,465,587,79.21635434412265,132,745,877,303,143,85,300,737,2385
Bracey Wright,2.0,2006 - 2007,SG,26,325,45,111,40.54054054054054,12,37,32.432432432432435,33,74,44.5945945945946,45.94594594594595,27,34,79.41176470588235,10,29,39,20,10,1,14,14,129
Brad Branson,2.0,1982 - 1983,PF,72,856,152,360,42.22222222222222,0,1,0.0,152,359,42.33983286908078,42.22222222222222,87,120,72.5,87,119,206,52,32,30,58,98,391
Brad Daugherty,8.0,1987 - 1994,C,589,21629,4098,7719,53.08977846871357,2,16,12.5,4096,7703,53.174088017655464,53.102733514703985,2973,3977,74.75484033190848,1296,4350,5646,2165,449,437,1609,1579,11171
Brad Lohaus,11.0,1988 - 1998,PF,676,10602,1571,3575,43.94405594405594,401,1112,36.061151079136685,1170,2463,47.503045066991476,49.55244755244755,379,518,73.16602316602317,492,1419,1911,721,316,513,568,1327,3922
Brad Miller,14.0,1999 - 2012,C,918,25864,3619,7536,48.02282377919321,208,637,32.6530612244898,3411,6899,49.44194810842151,49.402866242038215,2752,3436,80.09313154831199,1798,4710,6508,2577,667,623,1456,2555,10198
Brad Sellers,6.0,1987 - 1993,PF,426,7556,1071,2392,44.774247491638796,6,30,20.0,1065,2362,45.088907705334464,44.89966555183946,481,603,79.76782752902156,455,668,1123,463,142,258,347,725,2629
Brad Wanamaker,1.0,2019 - 2019,PG,36,343,50,105,47.61904761904761,16,39,41.02564102564102,34,66,51.515151515151516,55.23809523809524,24,28,85.71428571428571,3,38,41,56,12,2,19,34,140
Brad Wright,2.0,1987 - 1988,PF,16,145,21,51,41.17647058823529,0,1,0.0,21,50,42.0,41.17647058823529,12,28,42.857142857142854,25,29,54,1,3,6,15,23,54
Bradley Beal,7.0,2013 - 2019,SG,528,18376,3896,8645,45.066512434933486,1166,3049,38.24204657264677,2730,5596,48.78484631879914,51.81029496818971,1633,2041,80.00979911807937,444,1657,2101,1972,613,215,1138,1181,10591
Brandan Wright,10.0,2008 - 2018,PF,440,7078,1290,2123,60.76307112576542,0,12,0.0,1290,2111,61.108479393652296,60.76307112576542,438,652,67.17791411042946,594,985,1579,207,201,434,208,586,3018
Branden Dawson,1.0,2016 - 2016,PF,6,29,2,5,40.0,0,0,,2,5,40.0,40.0,1,1,100.0,2,2,4,0,0,1,0,2,5
Brandin Knight,1.0,2005 - 2005,PG,1,3,0,1,0.0,0,0,,0,1,0.0,0.0,0,0,,0,0,0,1,0,0,0,0,0
Brandon Armstrong,3.0,2002 - 2004,SG,116,731,104,299,34.78260869565217,25,76,32.89473684210527,79,223,35.42600896860987,38.96321070234114,12,20,60.0,23,42,65,27,23,4,37,87,245
Brandon Bass,12.0,2006 - 2017,PF,817,17818,2734,5499,49.71813056919439,12,59,20.33898305084746,2722,5440,50.036764705882355,49.82724131660302,1593,1904,83.66596638655463,1224,2486,3710,652,326,505,756,1489,7073
Brandon Davies,2.0,2014 - 2015,PF,78,998,109,265,41.132075471698116,10,44,22.727272727272727,99,221,44.79638009049774,43.0188679245283,58,90,64.44444444444444,76,116,192,58,42,15,64,151,286
Brandon Goodwin,1.0,2019 - 2019,PG,16,57,6,23,26.08695652173913,2,6,33.33333333333333,4,17,23.52941176470588,30.434782608695656,9,11,81.81818181818183,1,2,3,14,0,0,3,7,23
Brandon Hunter,2.0,2004 - 2005,PF,70,640,91,190,47.89473684210526,0,3,0.0,91,187,48.663101604278076,47.89473684210526,40,82,48.78048780487805,77,113,190,23,17,9,45,84,222
Brandon Ingram,3.0,2017 - 2019,SF,190,6014,996,2176,45.77205882352941,127,386,32.90155440414508,869,1790,48.547486033519554,48.690257352941174,520,785,66.2420382165605,158,739,897,550,123,110,394,470,2639
Brandon Jennings,9.0,2010 - 2018,PG,580,17409,2830,7314,38.692917692097346,934,2732,34.18740849194729,1896,4582,41.37931034482759,45.07793273174733,1430,1797,79.57707289927657,340,1368,1708,3216,698,103,1231,1034,8024
Brandon Knight,7.0,2012 - 2019,PG,421,12675,2191,5307,41.28509515733936,666,1881,35.406698564593306,1525,3426,44.512551079976646,47.55982664405502,1038,1279,81.15715402658327,232,1104,1336,1700,375,72,1048,844,6086
Brandon Paul,1.0,2018 - 2018,SG,65,579,55,127,43.30708661417323,15,54,27.77777777777778,40,73,54.794520547945204,49.21259842519685,22,43,51.162790697674424,6,63,69,38,25,7,29,58,147
Brandon Roy,6.0,2007 - 2013,SG,341,12020,2312,5048,45.800316957210775,336,968,34.710743801652896,1976,4080,48.431372549019606,49.128367670364504,1421,1775,80.05633802816902,357,1080,1437,1556,344,83,615,665,6381
Brandon Rush,9.0,2009 - 2017,SG,503,10736,1236,2900,42.62068965517241,530,1318,40.21244309559939,706,1582,44.62705436156764,51.758620689655174,290,412,70.3883495145631,188,1258,1446,474,225,265,403,636,3292
Brandon Sampson,1.0,2019 - 2019,SG,14,214,28,60,46.666666666666664,11,29,37.93103448275862,17,31,54.83870967741935,55.833333333333336,4,6,66.66666666666666,3,13,16,10,8,3,12,19,71
Brandon Williams,3.0,1998 - 2003,SG,18,163,17,57,29.82456140350877,3,10,30.0,14,47,29.78723404255319,32.45614035087719,4,8,50.0,7,11,18,3,8,3,12,22,41
Brant Weidner,1.0,1984 - 1984,PF,8,38,2,9,22.22222222222222,0,0,,2,9,22.22222222222222,22.22222222222222,4,4,100.0,4,7,11,0,0,2,2,5,8
Brendan Haywood,13.0,2002 - 2015,C,870,19820,2229,4211,52.93279506055569,0,4,0.0,2229,4207,52.98312336581888,52.93279506055569,1419,2415,58.75776397515528,2198,2940,5138,471,351,1179,893,2207,5877
Brent Barry,14.0,1996 - 2009,SG,1000,25374,3067,6684,45.885697187312985,1497,3687,40.60211554109031,1570,2997,52.38571905238572,57.08408138839018,1370,1667,82.18356328734254,482,2476,2958,3038,1001,271,1369,1911,9001
Brent Price,9.0,1993 - 2002,PG,427,7180,835,1957,42.6673479816045,373,965,38.652849740932645,462,992,46.57258064516129,52.197240674501785,490,594,82.49158249158249,179,522,701,1256,321,17,638,776,2533
Brent Scott,1.0,1997 - 1997,PF,16,55,8,17,47.05882352941176,0,0,,8,17,47.05882352941176,47.05882352941176,3,6,50.0,3,6,9,3,1,1,4,14,19
Brett Szabo,1.0,1997 - 1997,C,70,662,54,121,44.62809917355372,0,1,0.0,54,120,45.0,44.62809917355372,45,61,73.77049180327869,56,109,165,17,16,32,41,119,153
Brett Vroman,1.0,1981 - 1981,C,11,93,10,27,37.03703703703704,0,1,0.0,10,26,38.46153846153847,37.03703703703704,14,19,73.68421052631578,7,18,25,9,5,5,9,26,34
Brevin Knight,12.0,1998 - 2009,PG,743,18426,2031,4944,41.08009708737864,16,119,13.445378151260504,2015,4825,41.76165803108808,41.24190938511327,1303,1653,78.82637628554144,285,1528,1813,4524,1254,89,1385,1888,5381
Brian Cardinal,12.0,2001 - 2012,PF,474,6623,678,1659,40.86799276672694,248,664,37.34939759036144,430,995,43.21608040201005,48.342374924653406,546,637,85.71428571428571,289,783,1072,470,300,69,334,911,2150
Brian Cook,9.0,2004 - 2012,PF,452,5856,948,2177,43.54616444648599,271,713,38.008415147265076,677,1464,46.2431693989071,49.77032613688562,229,290,78.96551724137932,327,840,1167,264,139,136,264,828,2396
Brian Davis,1.0,1994 - 1994,SF,68,374,40,126,31.746031746031743,1,3,33.33333333333333,39,123,31.70731707317073,32.142857142857146,50,68,73.52941176470588,21,34,55,22,16,4,19,34,131
Brian Evans,3.0,1997 - 1999,SF,107,1108,145,379,38.258575197889186,37,108,34.25925925925926,108,271,39.85239852398524,43.13984168865435,50,61,81.9672131147541,56,109,165,79,36,18,42,115,377
Brian Grant,12.0,1995 - 2006,PF,814,22973,3283,6719,48.86143771394553,6,29,20.689655172413794,3277,6690,48.98355754857997,48.90608721535943,1835,2479,74.02178297700685,1983,4051,6034,966,484,606,1315,2612,8407
Brian Howard,2.0,1992 - 1993,SF,95,1613,237,518,45.75289575289575,2,9,22.22222222222222,235,509,46.16895874263262,45.94594594594595,94,125,75.2,83,180,263,81,66,42,83,272,570
Brian Martin,1.0,1986 - 1986,SF-PF,8,21,3,7,42.857142857142854,0,0,,3,7,42.857142857142854,42.857142857142854,0,2,0.0,1,3,4,0,0,1,2,7,6
Brian Oliver,4.0,1991 - 1998,SG,122,1197,157,406,38.669950738916256,5,22,22.727272727272727,152,384,39.58333333333333,39.285714285714285,76,107,71.02803738317756,31,92,123,115,46,6,78,125,395
Brian Quinnett,3.0,1990 - 1992,SG,144,1582,207,497,41.649899396378274,30,90,33.33333333333333,177,407,43.48894348894349,44.668008048289735,44,65,67.6923076923077,95,138,233,81,42,25,75,163,488
Brian Roberts,5.0,2013 - 2017,PG,324,5243,755,1840,41.03260869565217,217,614,35.34201954397394,538,1226,43.882544861337685,46.92934782608696,340,376,90.42553191489363,59,364,423,724,132,19,273,373,2067
Brian Rowsom,3.0,1988 - 1990,PF,82,1092,158,347,45.53314121037464,2,3,66.66666666666666,156,344,45.348837209302324,45.821325648414984,139,170,81.76470588235294,101,172,273,47,29,23,44,130,457
Brian Scalabrine,11.0,2002 - 2012,PF,559,7187,628,1599,39.27454659161976,199,564,35.28368794326241,429,1035,41.449275362318836,45.49718574108818,245,313,78.27476038338658,293,793,1086,451,163,129,356,886,1700
Brian Shaw,14.0,1989 - 2003,PG,1070,24108,2865,7118,40.25007024445068,508,1658,30.639324487334136,2357,5460,43.16849816849817,43.81848833942119,1033,1330,77.66917293233084,839,2703,3542,4293,813,275,1818,2213,7271
Brian Skinner,14.0,1999 - 2012,PF,629,11110,1212,2458,49.308380797396254,2,7,28.57142857142857,1210,2451,49.36760505915952,49.34906427990236,499,882,56.575963718820866,936,1947,2883,290,259,543,533,1293,2925
Briante Weber,3.0,2016 - 2018,PG,47,617,58,143,40.55944055944056,5,26,19.230769230769234,53,117,45.2991452991453,42.30769230769231,22,30,73.33333333333333,24,62,86,65,40,9,32,57,143
Brice Johnson,2.0,2017 - 2018,PF,21,107,22,49,44.89795918367347,0,1,0.0,22,48,45.83333333333333,44.89795918367347,3,5,60.0,10,24,34,3,11,7,6,13,47
Britton Johnsen,2.0,2004 - 2005,SF,26,377,23,81,28.39506172839506,1,16,6.25,22,65,33.84615384615385,29.01234567901235,7,16,43.75,20,35,55,16,8,1,17,38,54
Brook Lopez,11.0,2009 - 2019,C,730,22672,4869,9787,49.74966792684173,437,1256,34.79299363057325,4432,8531,51.95170554448482,51.98222131398794,2514,3170,79.30599369085174,1642,3159,4801,1106,419,1283,1357,1995,12689
Brook Steppe,5.0,1983 - 1989,SG,242,2878,445,952,46.7436974789916,9,30,30.0,436,922,47.288503253796094,47.21638655462185,406,496,81.85483870967742,128,220,348,282,105,17,250,337,1305
Brooks Thompson,4.0,1995 - 1998,PG,176,1773,291,704,41.33522727272727,153,406,37.68472906403941,138,298,46.308724832214764,52.20170454545454,63,96,65.625,34,131,165,291,87,7,165,237,798
Bruce Bowen,13.0,1997 - 2009,SF,1008,28243,2231,5487,40.659741206488064,986,2480,39.75806451612903,1245,3007,41.40339208513469,49.644614543466375,650,1136,57.21830985915493,529,2265,2794,1266,820,400,730,2293,6098
Bruce Brown,1.0,2019 - 2019,SG,74,1449,125,314,39.80891719745223,24,93,25.806451612903224,101,221,45.70135746606335,43.63057324840764,45,60,75.0,48,137,185,91,40,36,46,178,319
Bruce Douglas,1.0,1987 - 1987,SG,8,98,7,24,29.166666666666668,0,1,0.0,7,23,30.434782608695656,29.166666666666668,0,4,0.0,5,9,14,17,9,0,9,9,14
Bruce Flowers,1.0,1983 - 1983,PF,53,699,110,206,53.398058252427184,0,2,0.0,110,204,53.92156862745098,53.398058252427184,41,53,77.35849056603774,71,109,180,47,19,12,43,99,261
Bruce Kuczenski,1.0,1984 - 1984,PF,15,119,10,37,27.027027027027028,0,0,,10,37,27.027027027027028,27.027027027027028,8,12,66.66666666666666,7,16,23,8,1,1,15,18,28
Bruno Caboclo,5.0,2015 - 2019,SF,69,1013,116,296,39.189189189189186,56,163,34.355828220858896,60,133,45.11278195488722,48.64864864864865,47,56,83.92857142857143,56,138,194,59,21,40,52,98,335
Bruno Sundov,7.0,1999 - 2005,C,103,526,80,223,35.874439461883405,5,24,20.833333333333336,75,199,37.68844221105528,36.99551569506727,10,19,52.63157894736842,32,75,107,18,15,14,30,106,175
Bryan Warrick,4.0,1983 - 1986,PG,169,2379,262,592,44.25675675675676,5,24,20.833333333333336,257,568,45.24647887323944,44.67905405405405,148,198,74.74747474747475,40,178,218,437,80,19,214,304,677
Bryant Reeves,6.0,1996 - 2001,C,395,12071,1999,4208,47.504752851711025,2,27,7.4074074074074066,1997,4181,47.76369289643626,47.52851711026616,945,1345,70.26022304832715,856,1889,2745,623,200,302,744,1365,4945
Bryant Stith,10.0,1993 - 2002,SG,601,16915,2081,4901,42.46072230157111,307,938,32.72921108742004,1774,3963,44.76406762553621,45.59273617629056,1663,1979,84.03233956543708,631,1417,2048,1211,606,133,790,1122,6132
Bryce Cotton,2.0,2015 - 2016,PG,23,198,33,79,41.77215189873418,7,23,30.434782608695656,26,56,46.42857142857143,46.20253164556962,15,18,83.33333333333334,3,15,18,18,7,0,17,8,88
Bryce Dejean-Jones,1.0,2016 - 2016,SG,14,279,28,69,40.57971014492754,12,32,37.5,16,37,43.24324324324324,49.275362318840585,11,21,52.38095238095239,8,40,48,15,10,2,11,17,79
Bryce Drew,6.0,1999 - 2004,PG,246,3979,421,1098,38.342440801457194,150,404,37.12871287128713,271,694,39.048991354466864,45.173041894353375,93,114,81.57894736842105,57,241,298,528,123,10,209,292,1085
Bryn Forbes,3.0,2017 - 2019,SG,208,4222,617,1425,43.29824561403509,286,712,40.168539325842694,331,713,46.423562412342214,53.333333333333336,133,169,78.69822485207101,33,348,381,283,74,7,130,295,1653
Bryon Russell,13.0,1994 - 2006,SF,946,22886,2629,6078,43.25435998683778,811,2201,36.8468877782826,1818,3877,46.89192674748517,49.925962487660414,1632,2172,75.13812154696133,841,2517,3358,1220,984,231,920,2233,7701
Bubba Wells,1.0,1998 - 1998,SG,39,395,48,116,41.37931034482759,1,6,16.666666666666664,47,110,42.72727272727273,41.810344827586206,31,43,72.09302325581395,22,46,68,34,15,4,31,40,128
Buck Johnson,7.0,1987 - 1993,SF,525,12231,1975,4067,48.561593312023604,7,64,10.9375,1968,4003,49.163127654259306,48.647651831817065,790,1071,73.76283846872083,644,1165,1809,886,416,257,685,1449,4747
Buck Williams,17.0,1982 - 1998,PF,1415,46174,6840,12500,54.72,6,32,18.75,6834,12468,54.81231953801733,54.74400000000001,4309,6482,66.47639617402037,4877,9081,13958,1759,1170,1170,2974,4653,17995
Buddy Hield,3.0,2017 - 2019,SG,244,6527,1366,3060,44.640522875817,602,1438,41.863699582753824,764,1622,47.1023427866831,54.47712418300653,306,350,87.42857142857143,196,792,988,481,181,64,371,465,3640
Butch Carter,6.0,1981 - 1986,SG,361,6814,1290,2717,47.47883695252116,54,176,30.681818181818183,1236,2541,48.642266824085006,48.47258005152742,503,638,78.84012539184953,234,312,546,683,321,43,479,792,3137
Butch Graves,1.0,1985 - 1985,SG,4,11,2,6,33.33333333333333,0,1,0.0,2,5,40.0,33.33333333333333,1,5,20.0,0,2,2,1,1,0,1,4,5
Byron Dinkins,2.0,1990 - 1991,PG,45,511,58,143,40.55944055944056,1,9,11.11111111111111,57,134,42.53731343283582,40.909090909090914,34,39,87.17948717948718,13,39,52,94,21,2,50,45,151
Byron Houston,4.0,1993 - 1996,PF,218,2721,313,682,45.894428152492665,10,39,25.64102564102564,303,643,47.12286158631415,46.62756598240469,214,317,67.50788643533123,239,414,653,117,104,88,173,552,850
Byron Irvin,3.0,1990 - 1993,SG,91,896,170,372,45.69892473118279,7,20,35.0,163,352,46.30681818181818,46.63978494623656,119,164,72.5609756097561,60,71,131,78,46,3,62,84,466
Byron Mullens,5.0,2010 - 2014,PF,190,3450,557,1368,40.716374269005854,111,348,31.896551724137932,446,1020,43.72549019607843,44.7733918128655,174,247,70.44534412955466,200,590,790,153,74,98,187,335,1399
Byron Scott,14.0,1984 - 1997,SG,1256,35517,6852,14205,48.236536430834214,909,2432,37.37664473684211,5943,11773,50.4799116622781,51.436114044350575,2935,3533,83.07387489385792,813,2710,3523,3119,1450,306,1863,2496,17548
C.J. Miles,14.0,2006 - 2019,SF,882,17946,2975,7230,41.14799446749654,1284,3595,35.71627260083449,1691,3635,46.51994497936726,50.02766251728907,1133,1396,81.16045845272207,381,1711,2092,944,611,262,758,1877,8367
C.J. Watson,10.0,2008 - 2017,PG,648,12896,1610,3876,41.53766769865841,498,1349,36.91623424759081,1112,2527,44.00474871388999,47.961816305469554,888,1103,80.50770625566636,229,1011,1240,1580,593,69,689,964,4606
C.J. Wilcox,3.0,2015 - 2017,SG,68,383,50,136,36.76470588235294,19,57,33.33333333333333,31,79,39.24050632911392,43.75,13,16,81.25,6,26,32,31,15,4,18,31,132
C.J. Williams,2.0,2018 - 2019,SG,53,835,104,232,44.827586206896555,27,94,28.723404255319153,77,138,55.79710144927537,50.646551724137936,13,17,76.47058823529412,13,51,64,55,37,13,25,79,248
CJ McCollum,6.0,2014 - 2019,SG,441,13250,2993,6595,45.38286580742987,876,2185,40.091533180778036,2117,4410,48.00453514739229,52.02426080363912,971,1159,83.77911993097497,259,1124,1383,1252,383,147,759,929,7833
Cal Bowdler,3.0,2000 - 2002,SF,142,1383,163,403,40.44665012406948,2,11,18.181818181818183,161,392,41.07142857142857,40.69478908188586,96,125,76.8,90,182,272,29,42,45,43,155,424
Calbert Cheaney,13.0,1994 - 2006,SG,833,22249,3394,7295,46.52501713502399,204,686,29.737609329446062,3190,6609,48.26751399606597,47.92323509252913,901,1304,69.09509202453987,741,1887,2628,1410,664,201,1006,2099,7893
Caleb Swanigan,2.0,2018 - 2019,PF,49,375,42,115,36.52173913043478,2,16,12.5,40,99,40.4040404040404,37.391304347826086,21,31,67.74193548387096,32,88,120,26,11,4,37,66,107
Calvin Booth,10.0,2000 - 2009,C,377,4632,489,1087,44.98620055197792,2,9,22.22222222222222,487,1078,45.17625231910946,45.07819687212511,252,335,75.22388059701493,334,708,1042,154,109,364,185,710,1232
Calvin Garrett,4.0,1981 - 1984,SF,180,3126,384,842,45.605700712589076,6,21,28.57142857142857,378,821,46.041412911084045,45.96199524940617,106,137,77.37226277372264,142,309,451,248,99,19,171,337,880
Cameron Bairstow,2.0,2015 - 2016,PF,36,167,16,54,29.629629629629626,1,5,20.0,15,49,30.612244897959183,30.555555555555557,11,13,84.61538461538461,10,26,36,7,4,4,7,27,44
Cameron Payne,4.0,2016 - 2019,PG,164,2522,369,937,39.38100320170758,126,383,32.89817232375979,243,554,43.86281588447653,46.10458911419424,71,93,76.34408602150538,43,236,279,390,106,30,163,247,935
Cameron Reynolds,1.0,2019 - 2019,SG,19,259,33,78,42.30769230769231,21,51,41.17647058823529,12,27,44.44444444444444,55.769230769230774,8,9,88.88888888888889,4,27,31,13,6,2,5,26,95
Carey Scurry,3.0,1986 - 1988,SF,188,2487,338,708,47.740112994350284,9,36,25.0,329,672,48.95833333333333,48.37570621468927,203,308,65.9090909090909,241,313,554,195,187,152,199,398,888
Caris LeVert,3.0,2017 - 2019,SF,168,4164,698,1598,43.67959949937422,192,583,32.933104631217844,506,1015,49.85221674876848,49.68710888610764,285,403,70.71960297766749,111,488,599,565,173,44,281,327,1873
Carl Bailey,1.0,1982 - 1982,C,1,7,1,1,100.0,0,0,,1,1,100.0,100.0,0,0,,0,0,0,0,0,0,2,2,2
Carl Henry,1.0,1986 - 1986,SG,29,151,32,68,47.05882352941176,5,11,45.45454545454545,27,57,47.368421052631575,50.73529411764706,12,17,70.58823529411765,8,11,19,4,5,0,9,11,81
Carl Herrera,8.0,1992 - 1999,PF,506,8544,1094,2305,47.46203904555315,2,16,12.5,1092,2289,47.706422018348626,47.50542299349241,428,662,64.6525679758308,609,1179,1788,274,247,210,469,1019,2618
Carl Landry,9.0,2008 - 2016,PF,550,12329,2219,4162,53.31571359923114,9,32,28.125,2210,4130,53.510895883777245,53.42383469485824,1462,1869,78.22364901016586,1058,1646,2704,381,238,216,650,1297,5909
Carl Nicks,3.0,1981 - 1983,SG,156,2579,450,973,46.24871531346352,0,10,0.0,450,963,46.728971962616825,46.24871531346352,167,293,56.996587030716725,112,185,297,249,132,7,228,342,1067
Carl Thomas,3.0,1992 - 1998,SG,64,545,70,177,39.548022598870055,23,73,31.506849315068493,47,104,45.19230769230769,46.04519774011299,20,31,64.51612903225806,14,47,61,28,24,8,25,51,183
Carldell Johnson,1.0,2012 - 2012,PG,15,119,11,35,31.428571428571427,4,15,26.666666666666668,7,20,35.0,37.142857142857146,1,3,33.33333333333333,1,8,9,22,8,0,7,11,27
Carlos Arroyo,9.0,2002 - 2011,PG,603,11013,1469,3367,43.62934362934363,137,410,33.41463414634146,1332,2957,45.04565437943862,45.66379566379567,788,978,80.57259713701431,217,776,993,1826,298,28,697,912,3863
Carlos Boozer,13.0,2003 - 2015,PF,944,29843,6430,12429,51.73384825810604,1,16,6.25,6429,12413,51.7924756303875,51.73787110789283,2535,3508,72.26339794754846,2271,6841,9112,2122,825,372,2037,2885,15396
Carlos Clark,2.0,1984 - 1985,SG,104,720,90,219,41.0958904109589,0,7,0.0,90,212,42.45283018867924,41.0958904109589,60,75,80.0,39,50,89,69,45,5,55,84,240
Carlos Delfino,8.0,2005 - 2013,SG,548,12214,1544,3862,39.97928534438115,712,1957,36.382217680122636,832,1905,43.6745406824147,49.19730709476955,515,676,76.18343195266272,302,1602,1904,936,479,92,542,882,4315
Carlos Rogers,8.0,1995 - 2002,PF,298,5654,888,1658,53.55850422195416,32,124,25.806451612903224,856,1534,55.80182529335072,54.523522316043426,388,690,56.231884057971016,503,769,1272,182,128,235,297,515,2196
Carlos Terry,3.0,1981 - 1983,SG,97,1083,122,281,43.41637010676156,0,11,0.0,122,270,45.18518518518518,43.41637010676156,41,61,67.21311475409836,75,153,228,124,54,27,82,162,285
Carlton McKinney,2.0,1990 - 1992,SG,9,113,10,41,24.390243902439025,0,1,0.0,10,40,25.0,24.390243902439025,2,4,50.0,4,9,13,7,6,1,7,16,22
Carmelo Anthony,16.0,2004 - 2019,SF,1136,40902,9753,21847,44.642284981919715,1441,4181,34.465438890217655,8312,17666,47.05083210687196,47.940220625257474,6368,7840,81.22448979591836,1968,5483,7451,3350,1174,553,3030,3325,27315
Caron Butler,14.0,2003 - 2016,SF,946,30377,4870,11278,43.181415144529176,796,2319,34.32514014661492,4074,8959,45.47382520370577,46.71040964710055,2652,3133,84.64730290456431,1166,3567,4733,2110,1236,239,1695,2306,13188
Carrick Felix,1.0,2014 - 2014,SG,7,38,7,14,50.0,2,5,40.0,5,9,55.55555555555556,57.14285714285714,3,4,75.0,1,5,6,4,0,0,4,4,19
Cartier Martin,7.0,2009 - 2015,SF,246,3366,432,1101,39.23705722070845,218,586,37.20136518771331,214,515,41.55339805825243,49.137148047229786,151,207,72.94685990338165,89,377,466,121,99,27,129,319,1233
Casey Jacobsen,4.0,2003 - 2008,SF,293,5359,478,1220,39.18032786885246,211,599,35.2253756260434,267,621,42.99516908212561,47.82786885245901,327,427,76.5807962529274,119,400,519,306,124,24,211,376,1494
Casey Shaw,1.0,1999 - 1999,C,9,14,1,8,12.5,0,0,,1,8,12.5,12.5,0,0,,3,0,3,0,0,0,2,2,2
Casper Ware,1.0,2014 - 2014,PG,9,116,18,42,42.857142857142854,7,21,33.33333333333333,11,21,52.38095238095239,51.19047619047619,5,6,83.33333333333334,0,9,9,10,8,0,5,11,48
Cedi Osman,2.0,2018 - 2019,SF,151,3178,456,1048,43.51145038167939,163,468,34.82905982905983,293,580,50.51724137931034,51.288167938931295,168,231,72.72727272727273,65,419,484,239,85,14,146,278,1243
Cedric Ball,1.0,1991 - 1991,PF,7,26,3,8,37.5,0,0,,3,8,37.5,37.5,2,2,100.0,5,6,11,0,0,2,2,5,8
Cedric Bozeman,1.0,2007 - 2007,SG,23,199,11,39,28.205128205128204,2,13,15.384615384615385,9,26,34.61538461538461,30.76923076923077,2,6,33.33333333333333,3,20,23,9,5,2,9,32,26
Cedric Ceballos,11.0,1991 - 2001,SF,668,15925,3639,7307,49.80156014780348,261,840,31.071428571428573,3378,6467,52.23442090613886,51.58751881757219,1731,2301,75.22816166883963,1338,2183,3521,785,491,209,1057,1154,9270
Cedric Henderson,6.0,1987 - 2002,SF,272,6355,798,1833,43.53518821603928,6,44,13.636363636363635,792,1789,44.27054220234768,43.69885433715221,324,454,71.36563876651982,177,603,780,430,234,111,418,594,1926
Cedric Hunter,1.0,1992 - 1992,PG,1,1,0,0,,0,0,,0,0,,,0,0,,0,0,0,0,0,0,0,0,0
Cedric Jackson,1.0,2010 - 2010,PG,12,74,6,20,30.0,1,6,16.666666666666664,5,14,35.714285714285715,32.5,7,12,58.333333333333336,2,6,8,14,3,2,11,7,20
Cedric Lewis,1.0,1996 - 1996,C,3,4,2,3,66.66666666666666,0,0,,2,3,66.66666666666666,66.66666666666666,0,0,,2,0,2,0,1,0,0,0,4
Cedric Simmons,3.0,2007 - 2009,PF,75,705,70,171,40.93567251461988,0,0,,70,171,40.93567251461988,40.93567251461988,23,59,38.983050847457626,55,86,141,14,11,32,30,91,163
Cedrick Hordges,2.0,1981 - 1982,PF,148,3016,433,913,47.426067907995616,3,17,17.647058823529413,430,896,47.99107142857143,47.59036144578313,249,389,64.01028277634961,241,625,866,171,60,38,235,460,1118
Cezary Trybanski,2.0,2003 - 2004,C,22,101,5,24,20.833333333333336,0,0,,5,24,20.833333333333336,20.833333333333336,5,12,41.66666666666667,6,9,15,1,1,7,10,16,15
Chad Gallagher,1.0,1994 - 1994,C,2,3,3,3,100.0,0,0,,3,3,100.0,100.0,0,0,,0,0,0,0,0,0,0,2,6
Chad Kinch,1.0,1981 - 1981,SG,41,353,52,141,36.87943262411347,0,0,,52,141,36.87943262411347,36.87943262411347,14,18,77.77777777777779,7,26,33,45,11,6,30,33,118
Chandler Hutchison,1.0,2019 - 2019,SF,44,895,96,209,45.933014354066984,14,50,28.000000000000004,82,159,51.57232704402516,49.282296650717704,23,38,60.526315789473685,31,154,185,34,23,6,25,59,229
Chandler Parsons,8.0,2012 - 2019,SF,448,13717,2217,4806,46.12983770287141,712,1910,37.27748691099477,1505,2896,51.96823204419889,53.53724511027882,646,907,71.22381477398015,368,1683,2051,1236,413,155,678,901,5792
Channing Frye,13.0,2006 - 2019,PF,939,20634,3051,6916,44.11509543088491,1125,2877,39.10323253388947,1926,4039,47.68507056202031,52.24840948525159,904,1097,82.40656335460346,783,3375,4158,898,478,562,802,2358,8131
Charles Barkley,16.0,1985 - 2000,PF,1196,44179,9444,17570,53.75071143995447,602,2271,26.50814619110524,8842,15299,57.79462709981045,55.46385885031303,7100,9691,73.26385305953977,4770,9358,14128,4697,1841,996,3729,3695,26590
Charles Bradley,3.0,1982 - 1984,SG,119,932,129,313,41.21405750798722,0,4,0.0,129,309,41.74757281553398,41.21405750798722,93,161,57.7639751552795,43,81,124,56,47,34,91,157,351
Charles Claxton,1.0,1996 - 1996,C,3,7,1,2,50.0,0,0,,1,2,50.0,50.0,0,2,0.0,2,0,2,0,0,1,1,4,2
Charles Cooke,1.0,2018 - 2018,SG,13,38,2,14,14.285714285714285,1,8,12.5,1,6,16.666666666666664,17.857142857142858,1,2,50.0,0,2,2,1,1,0,1,0,6
Charles Davis,8.0,1982 - 1990,SF,464,5526,1034,2313,44.70384781668829,20,123,16.260162601626014,1014,2190,46.3013698630137,45.13618677042802,285,381,74.80314960629921,414,683,1097,328,136,76,372,704,2373
Charles Jenkins,2.0,2012 - 2013,PG,110,1334,179,412,43.44660194174757,4,22,18.181818181818183,175,390,44.871794871794876,43.932038834951456,46,61,75.40983606557377,16,84,100,214,48,8,81,107,408
Charles Jones,17.0,1984 - 2000,C,902,16722,1022,2215,46.13995485327314,58,190,30.526315789473685,964,2025,47.604938271604944,47.44920993227991,566,912,62.06140350877193,1242,2433,3675,873,526,1157,679,2312,2668
Charles O'Bannon,2.0,1998 - 1999,SG,52,408,52,128,40.625,0,4,0.0,52,124,41.935483870967744,40.625,20,23,86.95652173913044,33,35,68,30,11,4,20,37,124
Charles Oakley,19.0,1986 - 2004,PF,1426,45388,5419,11535,46.9787602947551,83,310,26.7741935483871,5336,11225,47.53674832962138,47.33853489380147,3046,4008,75.99800399201597,4443,9207,13650,3500,1529,426,3093,4924,13967
Charles Pittman,4.0,1983 - 1986,PF,255,3628,421,768,54.817708333333336,0,6,0.0,421,762,55.249343832021005,54.817708333333336,332,471,70.48832271762208,309,492,801,225,80,81,335,495,1174
Charles Shackleford,6.0,1989 - 1999,C,303,4614,698,1444,48.337950138504155,0,5,0.0,698,1439,48.50590687977762,48.337950138504155,229,350,65.42857142857143,497,951,1448,170,119,148,276,664,1625
Charles Smith,14.0,1989 - 2006,SG,714,18318,3299,6977,47.283932922459506,88,336,26.190476190476193,3211,6641,48.351151934949556,47.9145764655296,2170,2836,76.51622002820875,1221,2134,3355,945,548,857,1152,2177,8856
Charles Thomas,1.0,1992 - 1992,SG,36,156,18,51,35.294117647058826,2,17,11.76470588235294,16,34,47.05882352941176,37.254901960784316,10,15,66.66666666666666,6,16,22,22,4,1,17,20,48
Charlie Bell,7.0,2002 - 2011,SG,384,9484,1209,2936,41.178474114441414,443,1225,36.16326530612245,766,1711,44.76914085330216,48.72275204359673,389,504,77.18253968253968,182,635,817,864,306,33,366,767,3250
Charlie Sitton,1.0,1985 - 1985,SF,43,304,39,94,41.48936170212766,0,2,0.0,39,92,42.391304347826086,41.48936170212766,13,25,52.0,24,36,60,26,7,6,19,50,91
Charlie Villanueva,11.0,2006 - 2016,PF,665,13641,2666,6134,43.46266710140202,725,2125,34.11764705882353,1941,4009,48.41606385632327,49.37235083143137,790,1023,77.2238514173998,799,2235,3034,553,330,350,651,1465,6847
Charlie Ward,11.0,1995 - 2005,PG,702,15647,1547,3776,40.96927966101695,697,1920,36.302083333333336,850,1856,45.797413793103445,50.19862288135594,552,721,76.56033287101248,275,1556,1831,2803,881,138,1130,1422,4343
Chase Budinger,7.0,2010 - 2016,SF,407,7998,1188,2766,42.950108459869845,413,1172,35.23890784982935,775,1594,48.6198243412798,50.41576283441793,409,513,79.72709551656921,238,1002,1240,473,213,65,310,485,3198
Chasson Randle,2.0,2017 - 2019,PG,75,1042,131,315,41.58730158730159,62,162,38.2716049382716,69,153,45.09803921568628,51.42857142857142,84,105,80.0,16,72,88,131,34,5,62,130,408
Chauncey Billups,17.0,1998 - 2014,PG,1189,38329,5475,13206,41.45842798727851,2097,5454,38.448844884488445,3378,7752,43.575851393188856,49.39800090867787,5281,5921,89.19101503124473,551,2933,3484,6467,1199,191,2460,2542,18328
Cheick Diallo,3.0,2017 - 2019,PF,140,1724,311,535,58.13084112149532,1,4,25.0,310,531,58.3804143126177,58.22429906542056,115,154,74.67532467532467,149,476,625,56,45,62,85,221,738
Cheikh Samb,2.0,2008 - 2009,C,22,114,9,36,25.0,0,3,0.0,9,33,27.27272727272727,25.0,4,9,44.44444444444444,13,18,31,1,4,12,4,15,22
Cherokee Parks,9.0,1996 - 2004,C,479,7514,874,1865,46.86327077747989,8,38,21.052631578947366,866,1827,47.400109469074984,47.07774798927614,312,496,62.903225806451616,567,1152,1719,265,208,308,283,942,2068
Chimezie Metu,1.0,2019 - 2019,PF,29,145,19,58,32.758620689655174,0,2,0.0,19,56,33.92857142857143,32.758620689655174,13,17,76.47058823529412,9,27,36,13,6,2,15,14,51
Chinanu Onuaku,2.0,2017 - 2018,C,7,77,7,12,58.333333333333336,0,0,,7,12,58.333333333333336,58.333333333333336,4,4,100.0,4,11,15,5,4,1,7,11,18
Chris Andersen,15.0,2002 - 2017,C,768,13523,1473,2729,53.97581531696593,15,70,21.428571428571427,1458,2659,54.83264385107183,54.25064126053499,1183,1799,65.75875486381322,1294,2563,3857,363,338,1081,555,1500,4144
Chris Anstey,3.0,1998 - 2000,C,155,2157,303,734,41.28065395095368,4,29,13.793103448275861,299,705,42.4113475177305,41.55313351498637,203,269,75.46468401486989,178,356,534,127,78,65,147,373,813
Chris Babb,1.0,2014 - 2014,SG,14,132,8,30,26.666666666666668,6,27,22.22222222222222,2,3,66.66666666666666,36.666666666666664,0,0,,4,13,17,3,6,0,3,13,22
Chris Bosh,13.0,2004 - 2016,C,982,35067,6724,13669,49.191601433901525,359,1050,34.19047619047619,6365,12619,50.439812980426346,50.504791864803565,4770,5971,79.88611622843744,2099,6158,8257,1914,803,1034,1933,2383,18577
Chris Boucher,2.0,2018 - 2019,PF,29,164,34,77,44.15584415584416,12,38,31.57894736842105,22,39,56.41025641025641,51.94805194805194,13,15,86.66666666666667,16,41,57,2,6,24,7,31,93
Chris Carr,6.0,1996 - 2001,SG,301,4549,739,1769,41.77501413227812,161,475,33.89473684210526,578,1294,44.6676970633694,46.3256076879593,373,462,80.73593073593074,179,488,667,299,95,47,315,508,2012
Chris Childs,9.0,1995 - 2003,PG,614,15570,1468,3648,40.24122807017544,426,1230,34.63414634146341,1042,2418,43.09346567411084,46.08004385964912,864,1059,81.58640226628894,223,1300,1523,2952,552,58,1214,1834,4226
Chris Chiozza,1.0,2019 - 2019,PG,7,33,2,8,25.0,2,5,40.0,0,3,0.0,37.5,0,0,,1,3,4,4,1,1,1,2,6
Chris Copeland,4.0,2013 - 2016,SF,192,2286,390,916,42.5764192139738,171,461,37.093275488069416,219,455,48.13186813186813,51.91048034934498,120,160,75.0,68,218,286,109,40,33,138,259,1071
Chris Corchiani,3.0,1992 - 1994,PG,112,1313,131,311,42.12218649517685,21,78,26.923076923076923,110,233,47.21030042918455,45.4983922829582,133,163,81.59509202453987,27,102,129,243,73,4,120,159,416
Chris Crawford,7.0,1998 - 2004,PF,259,4114,625,1441,43.37265787647467,74,216,34.25925925925926,551,1225,44.97959183673469,45.94031922276197,391,472,82.83898305084746,213,355,568,159,102,82,240,513,1715
Chris Douglas-Roberts,6.0,2009 - 2015,SG,226,4451,585,1325,44.15094339622642,88,263,33.460076045627375,497,1062,46.7984934086629,47.471698113207545,351,422,83.17535545023696,85,395,480,256,128,55,204,298,1609
Chris Dudley,16.0,1988 - 2003,C,945,17146,1435,3488,41.14105504587156,0,5,0.0,1435,3483,41.2001148435257,41.14105504587156,721,1574,45.80686149936468,2322,3372,5694,392,359,1056,768,2499,3591
Chris Duhon,9.0,2005 - 2013,PG,635,16121,1388,3551,39.087580963108984,673,1858,36.22174381054898,715,1693,42.23272297696397,48.56378484933821,615,785,78.343949044586,211,1221,1432,2761,485,39,961,1005,4064
Chris Engler,5.0,1983 - 1988,C,196,1411,139,337,41.246290801186944,0,0,,139,337,41.246290801186944,41.246290801186944,67,99,67.67676767676768,137,251,388,45,32,42,91,276,345
Chris Garner,2.0,1998 - 2001,PG,46,442,30,107,28.037383177570092,4,21,19.047619047619047,26,86,30.23255813953488,29.906542056074763,8,13,61.53846153846154,9,27,36,63,28,5,34,68,72
Chris Gatling,11.0,1992 - 2002,PF,715,14056,2855,5573,51.22914049883366,50,201,24.875621890547265,2805,5372,52.21518987341772,51.677731921765655,1612,2447,65.87658357172047,1281,2539,3820,468,473,388,1085,1914,7372
Chris Herren,2.0,2000 - 2001,PG,70,1005,74,220,33.63636363636363,40,122,32.78688524590164,34,98,34.69387755102041,42.72727272727273,36,52,69.23076923076923,16,57,73,167,29,2,62,117,224
Chris Hunter,1.0,2010 - 2010,C,60,783,109,217,50.23041474654379,0,4,0.0,109,213,51.173708920187785,50.23041474654379,52,69,75.36231884057972,56,111,167,37,13,35,30,132,270
Chris Jefferies,2.0,2003 - 2004,SF,72,861,102,266,38.34586466165413,35,96,36.45833333333333,67,170,39.411764705882355,44.92481203007519,42,63,66.66666666666666,21,67,88,29,23,23,64,92,281
Chris Jent,2.0,1994 - 1997,SF,17,150,20,52,38.46153846153847,9,27,33.33333333333333,11,25,44.0,47.11538461538461,1,2,50.0,6,19,25,15,2,0,8,22,50
Chris Johnson,6.0,2011 - 2016,SF,214,2788,297,700,42.42857142857142,98,321,30.529595015576323,199,379,52.5065963060686,49.42857142857143,138,176,78.4090909090909,113,308,421,104,101,79,115,313,830
Chris Kaman,13.0,2004 - 2016,C,753,20035,3494,7135,48.96986685353889,1,24,4.166666666666666,3493,7111,49.12108001687526,48.97687456201822,1360,1830,74.31693989071039,1515,4177,5692,935,329,940,1586,2021,8349
Chris King,3.0,1994 - 1999,SF,105,2065,271,641,42.27769110764431,46,120,38.333333333333336,225,521,43.186180422264876,45.86583463338533,105,168,62.5,108,203,311,116,75,34,119,184,693
Chris McCray,1.0,2007 - 2007,SG,5,12,0,3,0.0,0,0,,0,3,0.0,0.0,0,0,,0,0,0,0,0,0,2,1,0
Chris McCullough,3.0,2016 - 2018,PF,59,532,78,183,42.62295081967213,15,49,30.612244897959183,63,134,47.01492537313433,46.72131147540984,23,42,54.761904761904766,41,71,112,15,30,19,20,54,194
Chris McNealy,3.0,1986 - 1988,PF,108,1864,181,397,45.5919395465995,0,0,,181,397,45.5919395465995,45.5919395465995,104,158,65.82278481012658,160,334,494,110,90,30,116,274,466
Chris Mihm,8.0,2001 - 2009,C,441,8826,1260,2754,45.751633986928105,3,13,23.076923076923077,1257,2741,45.859175483400215,45.80610021786492,759,1079,70.34291010194625,873,1447,2320,223,132,448,539,1278,3282
Chris Mills,10.0,1994 - 2003,SF,587,17806,2456,5684,43.20900774102744,455,1285,35.40856031128405,2001,4399,45.48761082064105,47.21147079521464,1161,1420,81.7605633802817,797,2093,2890,1092,441,254,746,1590,6528
Chris Morris,11.0,1989 - 1999,SF,816,19890,3317,7525,44.0797342192691,536,1757,30.5065452475811,2781,5768,48.214285714285715,47.64119601328904,1462,1978,73.91304347826086,1588,2180,3768,1235,963,572,1216,1865,8632
Chris Mullin,16.0,1986 - 2001,SF,1057,34220,7106,13983,50.818851462490166,882,2284,38.61646234676007,6224,11699,53.20112830156424,53.97268111277981,3799,4391,86.5178774766568,1072,3199,4271,3598,1604,594,2451,2195,18893
Chris Munk,1.0,1991 - 1991,PF,11,29,3,7,42.857142857142854,0,0,,3,7,42.857142857142854,42.857142857142854,7,12,58.333333333333336,5,9,14,1,1,2,5,5,13
Chris Owens,1.0,2003 - 2003,SF,1,6,2,3,66.66666666666666,0,0,,2,3,66.66666666666666,66.66666666666666,0,0,,1,0,1,0,0,0,1,0,4
Chris Paul,14.0,2006 - 2019,PG,1041,36753,6873,14613,47.03346335454732,1422,3832,37.108559498956154,5451,10781,50.56117243298396,51.89899404639704,4375,5051,86.61651158186497,709,4002,4711,9986,2320,133,2540,2621,19543
Chris Porter,1.0,2001 - 2001,SF,51,1147,173,445,38.87640449438202,0,5,0.0,173,440,39.31818181818182,38.87640449438202,94,141,66.66666666666666,89,100,189,61,45,6,59,111,440
Chris Quinn,6.0,2007 - 2013,PG,246,3327,384,963,39.875389408099686,161,428,37.61682242990654,223,535,41.6822429906542,48.23468328141225,171,211,81.04265402843602,30,237,267,460,104,8,139,250,1100
Chris Richard,2.0,2008 - 2010,PF,72,785,56,116,48.275862068965516,0,0,,56,116,48.275862068965516,48.275862068965516,23,38,60.526315789473685,72,125,197,25,18,16,38,133,135
Chris Robinson,2.0,1997 - 1998,SG,76,1095,134,356,37.640449438202246,58,155,37.41935483870968,76,201,37.81094527363184,45.78651685393258,24,42,57.14285714285714,32,85,117,104,47,13,67,135,350
Chris Singleton,3.0,2012 - 2014,SF,148,2605,233,620,37.58064516129032,58,182,31.868131868131865,175,438,39.95433789954338,42.25806451612903,88,139,63.30935251798561,112,360,472,92,117,57,100,325,612
Chris Smith,4.0,1993 - 2014,SG,226,3958,425,976,43.545081967213115,59,161,36.64596273291926,366,815,44.9079754601227,46.56762295081967,231,324,71.29629629629629,61,230,291,627,118,56,219,346,1140
Chris Taft,1.0,2006 - 2006,C,17,144,23,38,60.526315789473685,0,0,,23,38,60.526315789473685,60.526315789473685,1,6,16.666666666666664,19,17,36,2,2,7,2,25,47
Chris Washburn,2.0,1987 - 1988,C,78,676,96,233,41.201716738197426,0,1,0.0,96,232,41.37931034482759,41.201716738197426,41,88,46.590909090909086,64,113,177,24,11,16,60,82,233
Chris Webber,15.0,1994 - 2008,PF,911,33747,7809,16354,47.7497859850801,278,935,29.732620320855613,7531,15419,48.84233737596472,48.599730952672125,2781,4310,64.52436194895593,2491,6329,8820,3817,1288,1292,2540,2986,18677
Chris Welp,3.0,1988 - 1990,C,112,1195,141,317,44.479495268138805,0,1,0.0,141,316,44.620253164556964,44.479495268138805,79,118,66.94915254237289,88,184,272,43,34,54,67,266,361
Chris Whitney,11.0,1994 - 2004,PG,589,10183,1237,3136,39.44515306122449,558,1541,36.21025308241402,679,1595,42.5705329153605,48.34183673469388,735,840,87.5,100,728,828,1622,353,34,626,1006,3767
Chris Wilcox,11.0,2003 - 2013,PF,630,12480,2101,3884,54.09371781668383,0,18,0.0,2101,3866,54.34557682359027,54.09371781668383,948,1474,64.31478968792402,970,2108,3078,455,322,246,705,1517,5150
Chris Wright,3.0,2012 - 2014,SF,35,316,45,82,54.87804878048781,0,1,0.0,45,81,55.55555555555556,54.87804878048781,30,46,65.21739130434783,29,36,65,9,14,18,14,39,120
Christian Eyenga,2.0,2011 - 2012,SF,54,1058,138,334,41.31736526946108,26,94,27.659574468085108,112,240,46.666666666666664,45.209580838323355,22,37,59.45945945945946,32,107,139,41,38,34,51,88,324
Christian Laettner,13.0,1993 - 2005,PF,913,26918,4208,8803,47.80188572077701,97,381,25.45931758530184,4111,8422,48.81263357872239,48.35283426104737,3080,3759,81.9366852886406,1681,4337,6018,2293,953,696,2004,2902,11593
Christian Wood,3.0,2016 - 2019,PF,51,503,95,193,49.22279792746114,13,42,30.952380952380953,82,151,54.3046357615894,52.59067357512953,65,92,70.65217391304348,44,106,150,13,15,23,26,39,268
Chubby Cox,1.0,1983 - 1983,SG,7,78,13,37,35.13513513513514,0,2,0.0,13,35,37.142857142857146,35.13513513513514,3,6,50.0,7,3,10,6,0,1,9,16,29
Chuck Aleksinas,1.0,1985 - 1985,C,74,1114,161,337,47.774480712166174,0,1,0.0,161,336,47.91666666666667,47.774480712166174,55,75,73.33333333333333,87,183,270,36,15,15,72,171,377
Chuck Hayes,11.0,2006 - 2016,C,675,12331,1078,2161,49.88431281813975,0,19,0.0,1078,2142,50.326797385620914,49.88431281813975,320,517,61.89555125725339,1157,2206,3363,801,506,248,477,1557,2476
Chuck Nevitt,9.0,1983 - 1994,C,171,881,104,242,42.97520661157025,0,0,,104,242,42.97520661157025,42.97520661157025,59,100,59.0,88,167,255,20,22,120,86,224,267
Chuck Person,13.0,1987 - 2000,SF,994,30273,5784,12640,45.75949367088607,1297,3567,36.36108774880852,4487,9073,49.454425217678825,50.89003164556962,1570,2170,72.35023041474655,1185,3762,4947,2731,706,209,2012,2685,14435
Chucky Atkins,11.0,2000 - 2010,PG,732,18149,2586,6308,40.99556119213697,973,2675,36.373831775700936,1613,3633,44.39856867602533,48.70798985415345,1027,1328,77.33433734939759,204,1044,1248,2483,493,37,1064,1365,7172
Chucky Brown,13.0,1990 - 2002,SF,735,12613,1795,3664,48.99017467248908,24,102,23.52941176470588,1771,3562,49.71925884334644,49.31768558951965,729,1042,69.96161228406909,698,1566,2264,568,243,223,558,1251,4343
Clarence Kea,2.0,1981 - 1982,PF,51,447,63,130,48.46153846153846,0,1,0.0,63,129,48.837209302325576,48.46153846153846,72,104,69.23076923076923,54,74,128,19,10,4,32,99,198
Clarence Weatherspoon,13.0,1993 - 2005,PF,933,28041,4061,8628,47.06768660176171,10,51,19.607843137254903,4051,8577,47.230966538416695,47.1256374594344,2451,3308,74.09310761789601,2150,4762,6912,1349,891,798,1441,2063,10583
Clark Kellogg,5.0,1983 - 1987,PF,260,8514,2008,4041,49.69067062608265,23,68,33.82352941176471,1985,3973,49.962245154794864,49.97525365008661,879,1161,75.71059431524549,852,1630,2482,764,381,105,731,858,4918
Claude Gregory,2.0,1986 - 1988,PF,25,315,62,136,45.588235294117645,0,1,0.0,62,135,45.925925925925924,45.588235294117645,12,36,33.33333333333333,39,58,97,16,10,13,24,38,136
Clay Johnson,3.0,1982 - 1984,SG,97,755,95,225,42.22222222222222,1,5,20.0,94,220,42.72727272727273,42.44444444444444,57,78,73.07692307692307,58,43,101,48,36,9,46,111,248
Cleanthony Early,2.0,2015 - 2016,SF,56,801,88,254,34.645669291338585,26,99,26.262626262626267,62,155,40.0,39.76377952755906,39,52,75.0,26,97,123,42,26,15,49,73,241
Cliff Alexander,1.0,2016 - 2016,PF,8,36,5,10,50.0,0,0,,5,10,50.0,50.0,0,0,,2,4,6,0,1,2,1,1,10
Cliff Levingston,11.0,1983 - 1995,PF,912,18009,2453,4763,51.50115473441108,7,37,18.91891891891892,2446,4726,51.756242065171385,51.57463783329834,1287,1905,67.55905511811024,1875,2665,4540,785,561,630,871,2461,6200
Clifford Lett,2.0,1990 - 1991,PG,11,127,16,37,43.24324324324324,0,1,0.0,16,36,44.44444444444444,43.24324324324324,6,9,66.66666666666666,1,6,7,8,2,1,10,17,38
Clifford Robinson,18.0,1990 - 2007,PF,1521,46448,7928,18247,43.44823806653149,1340,3807,35.19831888626215,6588,14440,45.62326869806094,47.12007453279991,3848,5623,68.43322070069358,2037,4823,6860,3344,1543,1522,2732,4671,21044
Clifford Rozier,4.0,1995 - 1998,C,173,2984,350,705,49.645390070921984,2,11,18.181818181818183,348,694,50.14409221902017,49.787234042553195,125,269,46.468401486988846,376,521,897,98,78,113,162,435,827
Clint Capela,5.0,2015 - 2019,C,345,8371,1687,2663,63.34960570784829,0,3,0.0,1687,2660,63.421052631578945,63.34960570784829,555,1057,52.50709555345316,1029,2032,3061,317,224,494,378,826,3929
Clint McDaniel,1.0,1996 - 1996,SG,12,71,8,23,34.78260869565217,2,6,33.33333333333333,6,17,35.294117647058826,39.130434782608695,12,16,75.0,3,7,10,7,5,0,2,10,30
Clinton Smith,2.0,1987 - 1991,SG,46,386,52,121,42.97520661157025,0,2,0.0,52,119,43.69747899159664,42.97520661157025,30,42,71.42857142857143,28,32,60,49,14,1,27,39,134
Clinton Wheeler,2.0,1988 - 1989,PG,87,867,107,219,48.858447488584474,0,1,0.0,107,218,49.08256880733945,48.858447488584474,40,54,74.07407407407408,36,35,71,157,63,2,76,63,254
Clyde Drexler,15.0,1984 - 1998,SG,1231,43109,9411,20081,46.865195956376674,968,3092,31.306597671410092,8443,16989,49.69686267584908,49.27543449031423,5368,6813,78.79054748275355,2974,4705,7679,7016,2485,827,3374,3771,25158
Coby Karl,2.0,2008 - 2010,SG,25,186,20,58,34.48275862068966,6,24,25.0,14,34,41.17647058823529,39.6551724137931,12,16,75.0,7,25,32,25,7,3,15,19,58
Cody Zeller,6.0,2014 - 2019,C,372,8462,1127,2205,51.11111111111111,10,38,26.31578947368421,1117,2167,51.54591601292109,51.337868480725625,772,1043,74.01725790987535,679,1452,2131,499,246,279,386,987,3036
Cole Aldrich,8.0,2011 - 2018,C,350,3491,449,849,52.88574793875147,0,0,,449,849,52.88574793875147,52.88574793875147,185,254,72.83464566929135,347,827,1174,186,143,236,201,523,1083
Collin Sexton,1.0,2019 - 2019,PG,82,2605,519,1206,43.03482587064676,119,296,40.2027027027027,400,910,43.956043956043956,47.96849087893864,214,255,83.92156862745098,57,179,236,243,44,6,185,186,1371
Conner Henry,2.0,1987 - 1988,SG,104,791,116,302,38.41059602649007,34,92,36.95652173913043,82,210,39.04761904761905,44.03973509933775,61,84,72.61904761904762,23,66,89,102,21,6,69,74,327
Corey Beck,3.0,1996 - 1999,PG,94,977,99,218,45.412844036697244,4,7,57.14285714285714,95,211,45.023696682464454,46.330275229357795,54,78,69.23076923076923,37,89,126,123,47,9,90,138,256
Corey Benjamin,4.0,1999 - 2003,PG,153,2191,317,812,39.039408866995075,57,197,28.934010152284262,260,615,42.27642276422765,42.54926108374384,144,221,65.15837104072398,84,175,259,143,71,48,164,316,835
Corey Brewer,12.0,2008 - 2019,SF,861,19679,2822,6660,42.372372372372375,537,1895,28.337730870712402,2285,4765,47.95383001049318,46.4039039039039,1293,1815,71.2396694214876,638,1735,2373,1294,1054,235,982,1874,7474
Corey Crowder,2.0,1992 - 1995,SF,62,369,50,131,38.16793893129771,13,36,36.11111111111111,37,95,38.94736842105263,43.12977099236641,17,25,68.0,18,28,46,19,9,2,17,37,130
Corey Gaines,5.0,1989 - 1995,SG,84,1030,92,221,41.6289592760181,11,49,22.448979591836736,81,172,47.093023255813954,44.11764705882353,53,72,73.61111111111111,12,59,71,249,39,4,72,102,248
Corey Maggette,14.0,2000 - 2013,SF,839,23650,4122,9091,45.34154658453416,471,1455,32.371134020618555,3651,7636,47.81299109481404,47.932020679793204,4666,5666,82.35086480762442,922,3187,4109,1713,597,144,1900,2377,13381
Corey Williams,2.0,1993 - 1994,PG,39,288,36,98,36.734693877551024,1,4,25.0,35,94,37.234042553191486,37.244897959183675,19,23,82.6086956521739,20,17,37,29,6,2,13,30,92
Corie Blount,11.0,1994 - 2004,PF,681,10412,991,2105,47.07838479809976,3,27,11.11111111111111,988,2078,47.54571703561116,47.149643705463184,387,659,58.725341426403645,1145,1686,2831,473,342,278,540,1454,2372
Corliss Williamson,12.0,1996 - 2007,SF,888,19848,3778,7756,48.710675605982466,6,48,12.5,3772,7708,48.93617021276596,48.74935533780299,2081,2897,71.83293061788056,1281,2075,3356,1022,485,272,1397,2413,9643
Corny Thompson,1.0,1983 - 1983,PF,44,520,43,137,31.386861313868614,0,0,,43,137,31.386861313868614,31.386861313868614,36,46,78.26086956521739,41,79,120,34,12,7,31,92,122
Corsley Edwards,1.0,2005 - 2005,C,10,110,10,31,32.25806451612903,0,0,,10,31,32.25806451612903,32.25806451612903,7,12,58.333333333333336,12,13,25,3,3,4,2,19,27
Cory Alexander,7.0,1996 - 2005,PG,316,4917,597,1532,38.9686684073107,238,674,35.311572700296736,359,858,41.84149184149184,46.73629242819843,271,359,75.4874651810585,82,408,490,843,265,37,473,522,1703
Cory Blackwell,1.0,1985 - 1985,SF,60,551,87,237,36.708860759493675,0,2,0.0,87,235,37.02127659574468,36.708860759493675,28,55,50.90909090909091,42,54,96,26,25,3,44,55,202
Cory Carr,1.0,1999 - 1999,SG,42,624,71,216,32.870370370370374,5,30,16.666666666666664,66,186,35.483870967741936,34.02777777777778,24,32,75.0,8,41,49,66,21,7,46,66,171
Cory Higgins,2.0,2012 - 2013,PG,44,455,58,179,32.402234636871505,5,25,20.0,53,154,34.41558441558442,33.798882681564244,43,62,69.35483870967742,8,30,38,41,8,6,39,45,164
Cory Jefferson,2.0,2015 - 2016,PF,58,581,84,189,44.44444444444444,2,16,12.5,82,173,47.398843930635834,44.97354497354497,35,60,58.333333333333336,53,108,161,16,10,22,20,69,205
Cory Joseph,8.0,2012 - 2019,PG,606,12464,1604,3603,44.51845684152095,259,795,32.57861635220126,1345,2808,47.8988603988604,48.11268387454899,598,787,75.98475222363406,287,1196,1483,1617,446,120,575,871,4065
Coty Clarke,1.0,2016 - 2016,SF,3,6,2,4,50.0,2,2,100.0,0,2,0.0,75.0,0,0,,0,1,1,0,0,0,1,0,6
Courtney Alexander,3.0,2001 - 2003,PG,192,4106,662,1568,42.21938775510204,42,122,34.42622950819672,620,1446,42.87690179806362,43.558673469387756,342,421,81.23515439429929,126,287,413,228,113,18,204,383,1708
Courtney Fortson,1.0,2012 - 2012,PG,10,95,11,32,34.375,3,13,23.076923076923077,8,19,42.10526315789473,39.0625,10,15,66.66666666666666,6,9,15,10,3,0,10,5,35
Courtney Lee,11.0,2009 - 2019,SG,837,23030,3090,6855,45.076586433260395,891,2316,38.47150259067357,2199,4539,48.44679444811633,51.57549234135668,1038,1213,85.5729596042869,374,1824,2198,1413,835,215,795,1414,8109
Courtney Sims,2.0,2008 - 2009,C,5,24,3,7,42.857142857142854,0,0,,3,7,42.857142857142854,42.857142857142854,0,0,,3,3,6,1,0,0,1,3,6
Cozell McQueen,1.0,1987 - 1987,PF,3,7,3,3,100.0,0,0,,3,3,100.0,100.0,0,0,,3,5,8,0,0,1,0,1,6
Craig Brackins,2.0,2011 - 2012,PF,17,121,13,49,26.53061224489796,3,14,21.428571428571427,10,35,28.57142857142857,29.591836734693878,1,2,50.0,7,12,19,9,1,1,4,9,30
Craig Dykema,1.0,1982 - 1982,SF,38,115,18,43,41.86046511627907,2,4,50.0,16,39,41.02564102564102,44.18604651162791,7,9,77.77777777777779,3,13,16,16,2,0,8,21,45
Craig Ehlo,14.0,1984 - 1997,SG,949,22914,3211,7151,44.90281079569291,678,1850,36.648648648648646,2533,5301,47.783437087342016,49.64340651657111,1008,1454,69.32599724896836,1053,2308,3361,2678,1066,245,1318,1849,8108
Craig Hodges,10.0,1983 - 1992,SG,796,17133,2655,5798,45.791652293894444,653,1656,39.43236714975845,2002,4142,48.33413809753742,51.42290444981028,709,860,82.44186046511628,345,703,1048,1972,648,34,917,1574,6672
Craig Neal,2.0,1989 - 1991,PG,63,625,59,158,37.34177215189873,13,43,30.23255813953488,46,115,40.0,41.45569620253164,27,45,60.0,9,36,45,155,28,4,73,96,158
Craig Shelton,2.0,1981 - 1982,SF,59,607,102,225,45.33333333333333,0,1,0.0,102,224,45.535714285714285,45.33333333333333,36,60,60.0,60,81,141,27,19,5,61,131,240
Craig Smith,6.0,2007 - 2012,PF,403,6826,1221,2207,55.32396918894427,1,27,3.7037037037037033,1220,2180,55.96330275229357,55.346624376982334,637,963,66.14745586708204,543,1024,1567,322,183,91,413,957,3080
Cristiano Felicio,4.0,2016 - 2019,C,218,3166,399,702,56.837606837606835,0,10,0.0,399,692,57.65895953757225,56.837606837606835,190,284,66.90140845070422,323,567,890,160,61,50,140,330,988
Cuonzo Martin,2.0,1996 - 1997,SG,7,32,3,12,25.0,3,5,60.0,0,7,0.0,37.5,0,2,0.0,2,1,3,3,1,0,2,2,9
Curtis Borchardt,2.0,2004 - 2005,C,83,1117,96,228,42.10526315789473,0,1,0.0,96,227,42.290748898678416,42.10526315789473,66,89,74.15730337078652,99,179,278,64,14,46,70,200,258
Curtis Kitchen,1.0,1987 - 1987,PF,14,54,4,8,50.0,0,1,0.0,4,7,57.14285714285714,50.0,3,8,37.5,6,9,15,1,2,5,0,11,11
Cuttino Mobley,11.0,1999 - 2009,SG,773,28554,4447,10282,43.25034040070025,1113,2950,37.728813559322035,3334,7332,45.47190398254228,48.66271153472087,2290,2741,83.5461510397665,562,2439,3001,2073,897,321,1572,1776,12297
D'Angelo Russell,4.0,2016 - 2019,PG,272,7752,1680,4012,41.874376869391824,589,1667,35.332933413317335,1091,2345,46.524520255863536,49.2148554336989,544,714,76.19047619047619,161,838,999,1381,316,66,772,506,4493
D.J. Augustin,11.0,2009 - 2019,PG,835,19949,2634,6404,41.13054341036852,1069,2809,38.0562477750089,1565,3595,43.5326842837274,49.47688944409744,1772,2055,86.22871046228711,246,1302,1548,3248,499,30,1244,1229,8109
D.J. Kennedy,1.0,2012 - 2012,SF,2,59,5,12,41.66666666666667,2,4,50.0,3,8,37.5,50.0,0,2,0.0,1,6,7,3,2,0,3,7,12
D.J. Stephens,2.0,2014 - 2019,SG,4,22,4,9,44.44444444444444,0,0,,4,9,44.44444444444444,44.44444444444444,1,1,100.0,1,4,5,0,1,0,1,0,9
D.J. Strawberry,1.0,2008 - 2008,SG,34,275,29,96,30.208333333333332,6,26,23.076923076923077,23,70,32.857142857142854,33.33333333333333,9,19,47.368421052631575,9,20,29,30,12,6,11,37,73
D.J. White,6.0,2009 - 2014,PF,139,2114,348,687,50.65502183406113,1,3,33.33333333333333,347,684,50.73099415204678,50.727802037845706,113,157,71.97452229299363,117,322,439,80,39,57,66,199,810
D.J. Wilson,2.0,2018 - 2019,PF,70,953,113,267,42.32209737827715,48,132,36.36363636363637,65,135,48.148148148148145,51.31086142322098,27,49,55.10204081632652,47,185,232,55,21,21,36,92,301
DaJuan Summers,4.0,2010 - 2013,SF,83,820,103,268,38.43283582089552,29,79,36.708860759493675,74,189,39.15343915343915,43.843283582089555,43,67,64.17910447761194,24,58,82,29,18,8,37,104,278
Daequan Cook,6.0,2008 - 2013,SG,374,6494,808,2201,36.71058609722853,476,1340,35.52238805970149,332,861,38.55981416957027,47.523852794184464,162,200,81.0,79,680,759,256,129,48,194,526,2254
Dahntay Jones,13.0,2004 - 2017,SF,698,10424,1281,2913,43.97528321318229,117,359,32.590529247910865,1164,2554,45.57556773688332,45.98352214212152,909,1203,75.56109725685786,278,883,1161,548,281,151,533,1298,3588
Dairis Bertans,1.0,2019 - 2019,SG,12,167,12,47,25.53191489361702,10,34,29.411764705882355,2,13,15.384615384615385,36.17021276595745,0,0,,2,7,9,10,1,0,2,7,34
Dajuan Wagner,4.0,2003 - 2007,SG,103,2202,354,967,36.60806618407445,92,287,32.05574912891986,262,680,38.529411764705884,41.36504653567735,164,213,76.99530516431925,29,113,142,195,69,14,136,212,964
Dakari Johnson,1.0,2018 - 2018,C,33,164,22,39,56.41025641025641,0,0,,22,39,56.41025641025641,56.41025641025641,11,20,55.00000000000001,16,18,34,8,6,8,3,27,55
Dale Davis,16.0,1992 - 2007,C,1231,33268,3958,7466,53.013661934101265,0,10,0.0,3958,7456,53.08476394849786,53.013661934101265,1690,3042,55.55555555555556,3692,6004,9696,1065,770,1396,1243,3286,9606
Dale Ellis,17.0,1984 - 2000,SF,1282,36759,7726,16184,47.73850716757291,1790,4468,40.0626678603402,5936,11716,50.66575623079549,53.26866040533861,2773,3536,78.42194570135746,1643,2831,4474,1838,1025,197,1868,2643,20015
Dale Wilkinson,1.0,1985 - 1985,SF-PF,12,45,4,16,25.0,0,1,0.0,4,15,26.666666666666668,25.0,6,7,85.71428571428571,1,3,4,2,0,0,4,10,14
Dalibor Bagaric,3.0,2001 - 2003,C,95,973,97,269,36.059479553903344,0,2,0.0,97,267,36.329588014981276,36.059479553903344,57,102,55.88235294117647,84,154,238,37,29,43,72,163,251
Dallas Comegys,2.0,1988 - 1989,PF,142,2241,322,704,45.73863636363637,0,3,0.0,322,701,45.93437945791726,45.73863636363637,212,311,68.16720257234726,166,286,452,95,78,133,201,335,856
Damian Jones,3.0,2017 - 2019,C,57,616,76,121,62.8099173553719,0,0,,76,121,62.8099173553719,62.8099173553719,33,57,57.89473684210527,50,71,121,30,16,33,29,99,185
Damian Lillard,7.0,2013 - 2019,PG,584,21324,4552,10550,43.14691943127962,1598,4360,36.65137614678899,2954,6190,47.72213247172859,50.720379146919434,3043,3423,88.89862693543675,380,2068,2448,3675,570,180,1619,1201,13745
Damien Inglis,1.0,2016 - 2016,SF,20,156,13,37,35.13513513513514,3,13,23.076923076923077,10,24,41.66666666666667,39.189189189189186,7,8,87.5,2,29,31,10,6,3,11,11,36
Damien Wilkins,10.0,2005 - 2018,SF,597,11166,1367,3206,42.63880224578915,208,640,32.5,1159,2566,45.167575993764615,45.88271990018715,715,917,77.97164667393675,453,935,1388,800,443,133,534,964,3657
Damion James,4.0,2011 - 2014,SF,39,623,61,147,41.49659863945578,0,6,0.0,61,141,43.262411347517734,41.49659863945578,28,42,66.66666666666666,25,106,131,26,23,20,38,56,150
Damion Lee,2.0,2018 - 2019,SG,47,779,118,279,42.29390681003584,42,128,32.8125,76,151,50.331125827814574,49.82078853046595,41,51,80.3921568627451,19,116,135,42,32,1,25,53,319
Damir Markota,1.0,2007 - 2007,PF,30,170,19,52,36.53846153846153,6,16,37.5,13,36,36.11111111111111,42.30769230769231,7,11,63.63636363636363,11,20,31,6,3,1,15,22,51
Damjan Rudez,3.0,2015 - 2017,SF,146,1638,175,413,42.3728813559322,106,284,37.32394366197183,69,129,53.48837209302325,55.205811138014525,24,31,77.41935483870968,18,74,92,84,31,7,69,143,480
Damon Jones,11.0,1999 - 2009,PG,716,14630,1631,3997,40.80560420315236,1012,2600,38.92307692307692,619,1397,44.3092340730136,53.46509882411809,382,530,72.0754716981132,124,1057,1181,1952,276,20,587,768,4656
Damon Stoudamire,13.0,1996 - 2008,PG,931,30602,4524,11151,40.570352434759215,1285,3590,35.79387186629526,3239,7561,42.83824890887449,46.332167518608195,1963,2355,83.35456475583865,735,2463,3198,5604,985,90,2138,1825,12296
Damone Brown,4.0,2002 - 2005,SF,39,351,43,128,33.59375,4,14,28.57142857142857,39,114,34.21052631578947,35.15625,18,27,66.66666666666666,18,34,52,19,5,7,31,44,108
Damyean Dotson,2.0,2018 - 2019,SG,117,2478,362,859,42.14202561117579,148,410,36.09756097560975,214,449,47.66146993318486,50.756693830034926,89,121,73.55371900826447,43,303,346,166,70,12,88,169,961
Dan Dickau,6.0,2003 - 2008,PG,300,4617,608,1517,40.07910349373764,179,525,34.095238095238095,429,992,43.24596774193548,45.978905735003295,350,421,83.1353919239905,75,330,405,752,164,11,324,514,1745
Dan Gadzuric,10.0,2003 - 2012,C,539,7894,1068,2130,50.140845070422536,0,8,0.0,1068,2122,50.32987747408105,50.140845070422536,369,744,49.596774193548384,922,1433,2355,199,244,454,363,1269,2505
Dan Godfread,2.0,1991 - 1992,C,11,22,5,12,41.66666666666667,0,1,0.0,5,11,45.45454545454545,41.66666666666667,3,4,75.0,0,2,2,0,1,4,0,5,13
Dan Langhi,4.0,2001 - 2004,SF,133,1253,172,440,39.09090909090909,11,38,28.947368421052634,161,402,40.049751243781095,40.340909090909086,38,62,61.29032258064516,54,145,199,39,30,12,35,106,393
Dan Majerle,14.0,1989 - 2002,SG,1078,34445,4458,10393,42.89425574906186,1541,4311,35.7457666434702,2917,6082,47.96119697467938,50.307899547772536,1909,2570,74.28015564202335,1278,3596,4874,3059,1358,412,1244,2212,12366
Dan McClintock,1.0,2001 - 2001,C,6,58,9,18,50.0,0,0,,9,18,50.0,50.0,0,5,0.0,10,7,17,1,0,2,3,11,18
Dan O'Sullivan,4.0,1991 - 1996,C,45,297,27,68,39.705882352941174,0,1,0.0,27,67,40.298507462686565,39.705882352941174,26,35,74.28571428571429,22,43,65,10,4,5,12,45,80
Dana Barros,14.0,1990 - 2004,PG,881,19744,3334,7244,46.024295969077855,1107,2691,41.1371237458194,2227,4553,48.912804744124756,53.66510215350635,1258,1468,85.69482288828338,234,1398,1632,2863,752,46,1230,1094,9033
Dane Suttle,2.0,1984 - 1985,SG,46,493,115,227,50.66079295154186,0,4,0.0,115,223,51.569506726457405,50.66079295154186,42,49,85.71428571428571,21,28,49,48,21,0,33,49,272
Daniel Ewing,2.0,2006 - 2007,SG,133,1688,163,417,39.08872901678657,36,122,29.508196721311474,127,295,43.050847457627114,43.4052757793765,71,91,78.02197802197803,32,126,158,174,69,10,107,148,433
Daniel Gibson,7.0,2007 - 2013,PG,447,10197,1165,2887,40.35330793210946,635,1559,40.731237973059656,530,1328,39.90963855421687,51.35088326983027,468,592,79.05405405405406,156,697,853,830,263,95,406,884,3433
Daniel Hamilton,2.0,2018 - 2019,SG,25,232,28,71,39.436619718309856,10,28,35.714285714285715,18,43,41.86046511627907,46.478873239436616,3,6,50.0,10,42,52,30,7,1,18,21,69
Daniel Ochefu,1.0,2017 - 2017,C,23,80,12,28,42.857142857142854,0,0,,12,28,42.857142857142854,42.857142857142854,0,2,0.0,5,18,23,3,2,0,4,18,24
Daniel Orton,3.0,2012 - 2014,C,55,551,50,103,48.54368932038835,0,1,0.0,50,102,49.01960784313725,48.54368932038835,47,76,61.8421052631579,48,80,128,24,18,28,29,84,147
Daniel Santiago,4.0,2001 - 2005,C,124,1431,154,328,46.95121951219512,0,0,,154,328,46.95121951219512,46.95121951219512,111,162,68.51851851851852,77,188,265,38,39,49,86,234,419
Daniel Theis,2.0,2018 - 2019,C,129,1844,272,499,54.50901803607214,44,125,35.199999999999996,228,374,60.962566844919785,58.91783567134269,117,157,74.52229299363057,177,322,499,124,51,90,89,318,705
Danilo Gallinari,10.0,2009 - 2019,SF,561,17422,2684,6325,42.434782608695656,1044,2783,37.51347466762486,1640,3542,46.30152456239413,50.687747035573125,2462,2830,86.99646643109541,425,2297,2722,1145,445,239,744,1064,8874
Danny Ainge,14.0,1982 - 1995,SG,1235,32793,5360,11476,46.70616939700244,1174,3084,38.0674448767834,4186,8392,49.88083889418494,51.82119205298014,1972,2337,84.38168592212237,815,2396,3211,4855,1305,151,1823,3082,13866
Danny Ferry,13.0,1991 - 2003,PF,984,19094,2597,5861,44.3098447363931,723,1849,39.10221741481882,1874,4012,46.7098703888335,50.47773417505545,770,919,83.7867247007617,675,2019,2694,1248,400,300,838,2080,6687
Danny Fortson,10.0,1998 - 2007,PF,451,8937,1208,2555,47.279843444227005,2,12,16.666666666666664,1206,2543,47.42430200550531,47.318982387475536,1233,1571,78.48504137492043,1200,2010,3210,301,185,95,668,1595,3651
Danny Granger,10.0,2006 - 2015,SF,621,19386,3473,8010,43.35830212234706,1054,2778,37.94096472282217,2419,5232,46.234709480122326,49.93757802746567,2233,2634,84.77600607441154,704,2325,3029,1153,583,494,1144,1715,10233
Danny Green,10.0,2010 - 2019,SG,720,18273,2282,5367,42.51909819265884,1354,3339,40.55106319257263,928,2028,45.75936883629191,55.133221539034835,501,621,80.67632850241546,414,2078,2492,1113,710,591,725,1267,6419
Danny Manning,15.0,1989 - 2003,PF,926,25393,5273,10328,51.05538342370256,44,211,20.85308056872038,5229,10117,51.68528219828013,51.26839659178931,2405,3291,73.07809176542085,1589,3228,4817,2143,1042,783,1929,3047,12995
Danny Schayes,18.0,1982 - 1999,C,1207,23391,3183,6593,48.27847717275899,4,32,12.5,3179,6561,48.452979728699894,48.308812376763235,2951,3659,80.65045094288057,1927,4075,6002,1375,586,887,1670,3721,9321
Danny Vranes,7.0,1982 - 1988,SF,525,10859,1079,2192,49.22445255474452,2,20,10.0,1077,2172,49.58563535911602,49.27007299270073,504,884,57.01357466063348,789,1271,2060,606,337,277,527,1402,2664
Danny Young,10.0,1985 - 1995,PG,627,10246,1064,2439,43.62443624436244,213,653,32.618683001531394,851,1786,47.64837625979843,47.990979909799094,500,600,83.33333333333334,188,585,773,1793,539,41,509,595,2841
Dante Cunningham,10.0,2010 - 2019,PF,731,15041,1794,3814,47.0372312532774,216,627,34.44976076555024,1578,3187,49.513649199874486,49.868904037755634,381,584,65.23972602739725,819,1899,2718,508,468,342,356,1247,4185
Dante Exum,4.0,2015 - 2019,PG,221,4142,474,1175,40.34042553191489,156,512,30.46875,318,663,47.963800904977376,46.97872340425532,186,240,77.5,83,294,377,481,90,35,288,407,1290
Danuel House,3.0,2017 - 2019,SG,63,1383,174,381,45.66929133858268,89,236,37.71186440677966,85,145,58.620689655172406,57.3490813648294,81,102,79.41176470588235,38,179,217,65,28,17,46,103,518
Darington Hobson,1.0,2012 - 2012,SG,5,39,2,13,15.384615384615385,0,6,0.0,2,7,28.57142857142857,15.384615384615385,0,0,,0,3,3,6,0,0,2,1,4
Dario Saric,3.0,2017 - 2019,PF,250,6791,1147,2653,43.23407463249152,401,1115,35.96412556053812,746,1538,48.50455136540962,50.79155672823219,516,617,83.63047001620745,424,1139,1563,546,163,63,443,532,3211
Darius Johnson-Odom,2.0,2013 - 2014,SG,7,21,0,11,0.0,0,4,0.0,0,7,0.0,0.0,0,2,0.0,1,5,6,2,1,0,2,3,0
Darius Miles,7.0,2001 - 2009,SF,446,11730,1874,3973,47.1683866096149,22,131,16.793893129770993,1852,3842,48.20406038521604,47.44525547445255,737,1250,58.96,575,1615,2190,840,384,495,892,1023,4507
Darius Miller,5.0,2013 - 2019,SF,262,5323,537,1286,41.75738724727838,336,880,38.18181818181819,201,406,49.50738916256158,54.821150855365474,157,188,83.51063829787235,51,392,443,357,115,61,169,520,1567
Darius Morris,4.0,2012 - 2015,PG,141,1582,185,471,39.27813163481954,51,156,32.69230769230769,134,315,42.53968253968254,44.69214437367304,61,94,64.8936170212766,41,90,131,204,47,2,119,134,482
Darius Songaila,8.0,2004 - 2011,PF,516,9556,1495,2999,49.849949983327775,3,21,14.285714285714285,1492,2978,50.10073875083949,49.89996665555185,540,638,84.63949843260188,574,1168,1742,602,330,108,503,1260,3533
Darius Washington,1.0,2008 - 2008,SG,18,146,21,48,43.75,4,12,33.33333333333333,17,36,47.22222222222222,47.91666666666667,7,13,53.84615384615385,4,16,20,15,5,0,14,16,53
Darko Milicic,10.0,2004 - 2013,C,489,8788,1218,2647,46.01435587457499,0,6,0.0,1218,2641,46.11889435819766,46.01435587457499,432,756,57.14285714285714,640,1356,1996,411,208,618,579,1078,2868
Darnell Jackson,3.0,2009 - 2011,PF,143,1064,124,279,44.44444444444444,4,17,23.52941176470588,120,262,45.80152671755725,45.16129032258064,58,92,63.04347826086957,90,118,208,27,24,11,51,164,310
Darnell Mee,2.0,1994 - 1995,SG,43,323,32,99,32.323232323232325,7,31,22.58064516129032,25,68,36.76470588235294,35.858585858585855,12,27,44.44444444444444,17,21,38,20,19,13,21,38,83
Darnell Valentine,9.0,1982 - 1991,PG,646,15102,2107,4808,43.82279534109817,42,159,26.41509433962264,2065,4649,44.418154441815446,44.259567387687184,1457,1839,79.22784121805329,368,1000,1368,3257,950,62,1296,1437,5713
Darrell Allums,1.0,1981 - 1981,PF,22,276,23,67,34.32835820895522,0,1,0.0,23,66,34.84848484848485,34.32835820895522,13,22,59.09090909090909,19,46,65,25,5,8,23,51,59
Darrell Armstrong,14.0,1995 - 2008,PG,891,21035,2776,6791,40.877632160212045,962,2899,33.18385650224215,1814,3892,46.60842754367934,47.96053600353409,1544,1769,87.28094968908988,688,1698,2386,3521,1181,104,1639,1494,8058
Darrell Arthur,9.0,2009 - 2018,PF,531,9321,1445,3248,44.48891625615764,162,461,35.140997830802604,1283,2787,46.0351632579835,46.98275862068966,380,495,76.76767676767676,575,1260,1835,422,318,323,441,1300,3432
Darrell Griffith,10.0,1981 - 1991,SG,802,22441,5458,11809,46.21898551951901,576,1720,33.48837209302326,4882,10089,48.38933491921895,48.65780337031078,1456,2058,70.74829931972789,817,1843,2660,1704,978,253,1709,1749,12948
Darrell Lockhart,1.0,1984 - 1984,C,2,14,2,2,100.0,0,0,,2,2,100.0,100.0,0,0,,0,3,3,0,0,0,2,5,4
Darrell Walker,10.0,1984 - 1993,PG,754,19109,2533,5856,43.25478142076503,6,103,5.825242718446602,2527,5753,43.92490874326438,43.30601092896175,1494,2103,71.0413694721826,1094,2122,3216,3324,1124,231,1512,1885,6566
Darren Collison,10.0,2010 - 2019,PG,744,21610,3390,7211,47.01151019276106,652,1662,39.229843561973524,2738,5549,49.34222382411245,51.5323810844543,1757,2064,85.12596899224806,350,1610,1960,3660,851,109,1423,1249,9189
Darren Daye,5.0,1984 - 1988,SF,362,5580,913,1849,49.37804218496484,2,17,11.76470588235294,911,1832,49.72707423580786,49.43212547322877,566,828,68.35748792270532,341,555,896,700,203,57,459,653,2394
Darren Morningstar,1.0,1994 - 1994,C,23,367,39,82,47.5609756097561,0,0,,39,82,47.5609756097561,47.5609756097561,18,30,60.0,31,50,81,15,14,2,19,70,96
Darren Tillis,2.0,1983 - 1984,C,124,1256,184,435,42.298850574712645,0,3,0.0,184,432,42.592592592592595,42.298850574712645,57,91,62.637362637362635,116,198,314,42,20,90,73,252,425
Darrick Martin,13.0,1995 - 2008,PG,539,9462,1214,3201,37.925648234926584,362,1066,33.95872420262664,852,2135,39.90632318501171,43.58013120899719,830,987,84.09321175278622,108,500,608,1518,345,22,645,925,3620
Darrin Hancock,3.0,1995 - 1997,SF,142,1446,200,381,52.493438320209975,2,7,28.57142857142857,198,374,52.94117647058824,52.75590551181102,73,129,56.58914728682171,62,116,178,91,58,11,101,167,475
Darrun Hilliard,3.0,2016 - 2018,SG,91,859,104,276,37.68115942028986,31,102,30.392156862745097,73,174,41.95402298850575,43.29710144927536,56,75,74.66666666666667,7,78,85,71,22,3,51,74,295
Darryl Johnson,1.0,1996 - 1996,PG,11,28,5,12,41.66666666666667,0,1,0.0,5,11,45.45454545454545,41.66666666666667,2,2,100.0,2,0,2,1,0,0,1,3,12
Darryl Watkins,2.0,2008 - 2012,C,14,169,12,29,41.37931034482759,0,0,,12,29,41.37931034482759,41.37931034482759,11,23,47.82608695652174,13,26,39,3,7,6,15,22,35
Darvin Ham,8.0,1997 - 2005,SF,472,5586,472,907,52.039691289966925,4,18,22.22222222222222,468,889,52.64341957255343,52.260198456449835,265,535,49.532710280373834,510,518,1028,242,144,173,329,840,1213
Darwin Cook,8.0,1981 - 1989,PG,637,14681,2565,5698,45.01579501579502,61,305,20.0,2504,5393,46.43055813091044,45.55107055107055,837,1102,75.95281306715064,444,918,1362,2330,1074,207,1168,1385,6028
Daryl Macon,1.0,2019 - 2019,SG,8,90,10,27,37.03703703703704,5,11,45.45454545454545,5,16,31.25,46.2962962962963,4,7,57.14285714285714,2,10,12,7,1,0,6,8,29
Dave Batton,2.0,1983 - 1984,C,58,589,90,201,44.776119402985074,0,3,0.0,90,198,45.45454545454545,44.776119402985074,8,17,47.05882352941176,46,77,123,32,15,16,32,61,188
Dave Britton,1.0,1981 - 1981,PG,2,9,2,3,66.66666666666666,0,0,,2,3,66.66666666666666,66.66666666666666,0,0,,0,2,2,3,1,0,2,2,4
Dave Feitl,5.0,1987 - 1992,C,282,3012,472,1091,43.26306141154904,0,9,0.0,472,1082,43.622920517560075,43.26306141154904,252,335,75.22388059701493,241,576,817,125,46,46,235,439,1196
Dave Henderson,1.0,1988 - 1988,SG,22,351,47,116,40.51724137931034,0,1,0.0,47,115,40.869565217391305,40.51724137931034,32,47,68.08510638297872,11,24,35,34,12,5,40,41,126
Dave Hoppen,6.0,1988 - 1993,C,172,2410,329,632,52.05696202531646,1,5,20.0,328,627,52.312599681020735,52.13607594936709,184,247,74.49392712550608,220,430,650,100,43,29,138,390,843
Dave Jamerson,3.0,1991 - 1994,SG,92,615,127,324,39.19753086419753,13,48,27.083333333333332,114,276,41.30434782608695,41.2037037037037,55,63,87.3015873015873,32,48,80,65,24,1,46,67,322
Dave Johnson,2.0,1993 - 1994,SG,59,475,74,203,36.45320197044335,3,15,20.0,71,188,37.765957446808514,37.19211822660098,53,80,66.25,27,37,64,17,12,1,37,30,204
Dave Magley,1.0,1983 - 1983,SF,14,56,4,16,25.0,0,1,0.0,4,15,26.666666666666668,25.0,4,8,50.0,2,8,10,2,2,0,2,5,12
Dave Popson,3.0,1989 - 1992,PF,41,196,32,79,40.50632911392405,0,1,0.0,32,78,41.02564102564102,40.50632911392405,12,16,75.0,21,25,46,13,4,6,20,34,76
David Andersen,2.0,2010 - 2011,PF,103,1264,203,461,44.03470715835141,35,101,34.65346534653465,168,360,46.666666666666664,47.83080260303688,60,89,67.41573033707866,74,218,292,57,20,21,59,159,501
David Benoit,7.0,1992 - 2001,SF,549,10551,1493,3432,43.502331002331005,249,758,32.849604221635886,1244,2674,46.522064323111444,47.129953379953385,630,796,79.14572864321609,638,1558,2196,321,235,277,478,1132,3865
David Burns,1.0,1982 - 1982,PG,9,87,7,16,43.75,0,0,,7,16,43.75,43.75,9,15,60.0,1,4,5,15,3,0,13,17,23
David Cooke,1.0,1986 - 1986,PF,6,38,2,11,18.181818181818183,0,0,,2,11,18.181818181818183,18.181818181818183,5,10,50.0,5,5,10,1,4,0,2,5,9
David Harrison,4.0,2005 - 2008,C,195,2717,377,715,52.72727272727272,0,0,,377,715,52.72727272727272,52.72727272727272,208,395,52.65822784810127,185,369,554,47,65,186,220,549,962
David Lee,12.0,2006 - 2017,PF,872,24960,4688,8772,53.44277245782034,1,30,3.3333333333333335,4687,8742,53.61473347060169,53.4484724122207,2095,2723,76.93720161586486,2212,5297,7509,1868,639,337,1484,2247,11472
David Noel,1.0,2007 - 2007,PF,68,792,65,177,36.72316384180791,17,53,32.075471698113205,48,124,38.70967741935484,41.52542372881356,37,43,86.04651162790698,42,81,123,65,25,9,40,77,184
David Nwaba,3.0,2017 - 2019,SG,141,3027,375,766,48.9556135770235,43,132,32.57575757575758,332,634,52.36593059936908,51.76240208877284,216,327,66.05504587155964,147,405,552,172,108,53,117,300,1009
David Pope,2.0,1985 - 1986,SF,33,203,26,73,35.61643835616438,1,2,50.0,25,71,35.2112676056338,36.3013698630137,9,17,52.94117647058824,15,14,29,9,5,4,9,41,62
David Rivers,3.0,1989 - 1992,PG,120,1319,143,361,39.612188365650965,1,14,7.142857142857142,142,347,40.92219020172911,39.75069252077562,111,139,79.85611510791367,54,97,151,288,61,10,170,123,398
David Robinson,14.0,1990 - 2003,C,1110,38492,8133,15825,51.39336492890996,26,110,23.636363636363637,8107,15715,51.58765510658606,51.47551342812007,6719,9167,73.29551652667176,3450,8348,11798,2721,1539,3266,2697,3258,23011
David Stockton,2.0,2015 - 2018,PG,8,48,5,12,41.66666666666667,3,6,50.0,2,6,33.33333333333333,54.166666666666664,7,10,70.0,0,3,3,9,2,0,5,5,20
David Thirdkill,5.0,1983 - 1987,SF,197,1538,196,436,44.95412844036697,1,14,7.142857142857142,195,422,46.208530805687204,45.06880733944954,138,247,55.87044534412956,80,139,219,89,49,13,112,235,531
David Vanterpool,1.0,2001 - 2001,PG,22,411,46,110,41.81818181818181,0,6,0.0,46,104,44.230769230769226,41.81818181818181,30,50,60.0,15,22,37,66,23,3,37,44,122
David Vaughn,4.0,1996 - 1999,PF,119,1157,137,324,42.28395061728395,0,2,0.0,137,322,42.54658385093168,42.28395061728395,67,105,63.8095238095238,134,227,361,36,31,49,98,216,341
David Wear,1.0,2015 - 2015,PF,2,7,0,2,0.0,0,1,0.0,0,1,0.0,0.0,0,0,,2,0,2,1,0,0,0,1,0
David Wesley,14.0,1994 - 2007,PG,1004,32206,4487,10624,42.23456325301205,1201,3242,37.045033929673046,3286,7382,44.51368192901653,47.886859939759034,2332,2964,78.67746288798921,547,1979,2526,4364,1342,166,1912,2474,12507
David West,15.0,2004 - 2018,PF,1152,32282,6240,12647,49.339764370997074,65,240,27.083333333333332,6175,12407,49.77029096477795,49.59674231042935,2824,3466,81.47720715522215,1935,5310,7245,2538,838,945,1834,2681,15369
David Wingate,15.0,1987 - 2001,SG,799,14127,1809,4060,44.556650246305416,98,334,29.34131736526946,1711,3726,45.920558239398815,45.76354679802956,751,1024,73.33984375,483,1051,1534,1470,635,130,896,1364,4467
David Wood,7.0,1989 - 1997,PF,420,5615,571,1270,44.960629921259844,113,330,34.24242424242424,458,940,48.723404255319146,49.40944881889764,359,459,78.21350762527233,390,622,1012,295,167,76,237,948,1614
Davis Bertans,3.0,2017 - 2019,PF,238,3720,483,1098,43.98907103825137,319,799,39.92490613266583,164,299,54.84949832775919,58.51548269581056,133,160,83.125,69,477,546,229,86,93,118,318,1418
Davon Reed,2.0,2018 - 2019,SG,31,289,27,88,30.681818181818183,13,42,30.952380952380953,14,46,30.434782608695656,38.06818181818182,8,12,66.66666666666666,4,41,45,16,11,2,11,20,75
De'Aaron Fox,2.0,2018 - 2019,PG,154,4572,833,1899,43.86519220642444,133,385,34.54545454545455,700,1514,46.23513870541612,47.367035281727226,444,612,72.54901960784314,76,432,508,910,203,65,400,367,2243
De'Anthony Melton,1.0,2019 - 2019,PG,50,984,100,256,39.0625,29,95,30.526315789473685,71,161,44.099378881987576,44.7265625,21,28,75.0,25,109,134,159,68,23,75,113,250
DeAndre Jordan,11.0,2009 - 2019,C,876,24871,3348,5003,66.91984809114531,1,12,8.333333333333332,3347,4991,67.06070927669806,66.92984209474315,1697,3690,45.989159891598916,2840,6695,9535,760,536,1466,1215,2353,8394
DeAndre Liggins,5.0,2012 - 2018,SG,188,1989,132,331,39.87915407854985,44,127,34.645669291338585,88,204,43.13725490196079,46.52567975830816,47,88,53.40909090909091,47,220,267,126,109,32,90,211,355
DeAndre' Bembry,3.0,2017 - 2019,SF,146,2757,375,842,44.53681710213777,62,221,28.054298642533936,313,621,50.40257648953301,48.218527315914486,112,185,60.54054054054055,76,413,489,279,134,58,205,249,924
DeJuan Blair,7.0,2010 - 2016,PF,466,7428,1319,2512,52.50796178343949,0,9,0.0,1319,2503,52.69676388333999,52.50796178343949,405,669,60.53811659192825,865,1424,2289,366,341,134,482,1065,3043
DeJuan Wheat,2.0,1998 - 1999,PG,81,743,94,245,38.36734693877551,30,77,38.961038961038966,64,168,38.095238095238095,44.48979591836735,49,70,70.0,14,43,57,127,33,3,57,71,267
DeMar DeRozan,10.0,2010 - 2019,SG,803,27588,5744,12814,44.825971593569534,356,1275,27.92156862745098,5388,11539,46.6938209550221,46.2150772592477,4204,5070,82.91913214990137,599,2824,3423,2729,796,232,1643,1813,16048
DeMarco Johnson,1.0,2000 - 2000,PF,5,37,3,9,33.33333333333333,0,0,,3,9,33.33333333333333,33.33333333333333,0,0,,3,4,7,0,1,0,3,5,6
DeMarcus Cousins,9.0,2011 - 2019,C,565,18078,4283,9295,46.078536847767616,342,1031,33.17167798254122,3941,8264,47.688770571151984,47.918235610543306,3098,4205,73.67419738406659,1565,4566,6131,1832,805,697,2000,2175,12006
DeMarcus Nelson,1.0,2009 - 2009,PG,13,171,24,54,44.44444444444444,0,3,0.0,24,51,47.05882352941176,44.44444444444444,5,14,35.714285714285715,6,18,24,13,9,2,15,24,53
DeMarre Carroll,10.0,2010 - 2019,SF,611,15013,1976,4579,43.15352697095436,722,2006,35.99202392821535,1254,2573,48.73688301593471,51.037344398340245,922,1243,74.17538213998391,715,1938,2653,769,567,167,530,1236,5596
DeQuan Jones,1.0,2013 - 2013,SF,63,803,95,218,43.57798165137615,9,35,25.71428571428571,86,183,46.994535519125684,45.642201834862384,34,51,66.66666666666666,17,88,105,16,19,22,30,55,233
DeSagana Diop,12.0,2002 - 2013,C,629,8950,536,1231,43.54183590576767,1,6,16.666666666666664,535,1225,43.673469387755105,43.582453290008125,192,406,47.29064039408867,890,1479,2369,274,244,668,370,1321,1265
DeShawn Stevenson,13.0,2001 - 2013,SG,866,19142,2308,5729,40.28626287310176,597,1750,34.114285714285714,1711,3979,43.000753958280974,45.4965962646186,938,1339,70.0522778192681,420,1472,1892,1397,443,139,839,1205,6151
DeVaughn Akoon-Purcell,1.0,2019 - 2019,SG,7,22,3,10,30.0,0,4,0.0,3,6,50.0,30.0,1,2,50.0,1,3,4,6,2,0,2,4,7
DeWayne Scales,3.0,1981 - 1984,PF,49,521,98,235,41.702127659574465,1,6,16.666666666666664,97,229,42.35807860262008,41.91489361702128,27,43,62.7906976744186,49,91,140,10,14,5,34,58,224
Dean Garrett,6.0,1997 - 2002,C,372,7236,752,1565,48.05111821086262,0,0,,752,1565,48.05111821086262,48.05111821086262,309,456,67.76315789473685,628,1244,1872,213,173,380,206,722,1813
Dean Oliver,2.0,2002 - 2003,PG,35,232,24,75,32.0,3,19,15.789473684210526,21,56,37.5,34.0,13,17,76.47058823529412,8,16,24,44,10,0,21,25,64
Deandre Ayton,1.0,2019 - 2019,C,71,2183,509,870,58.50574712643678,0,4,0.0,509,866,58.775981524249424,58.50574712643678,141,189,74.60317460317461,223,506,729,125,61,67,126,209,1159
Dedric Willoughby,1.0,2000 - 2000,PG,25,508,61,179,34.07821229050279,29,98,29.591836734693878,32,81,39.50617283950617,42.17877094972067,39,51,76.47058823529412,11,40,51,66,23,2,37,32,190
Dee Brown,14.0,1991 - 2009,PG,715,18388,2718,6258,43.43240651965484,634,1810,35.027624309392266,2084,4448,46.852517985611506,48.49792265899649,1161,1416,81.99152542372882,355,1374,1729,2467,855,227,1001,1423,7231
Dejounte Murray,2.0,2017 - 2018,PG,135,2329,357,817,43.696450428396574,22,66,33.33333333333333,335,751,44.607190412782955,45.04283965728274,150,212,70.75471698113208,124,425,549,315,126,40,193,205,886
Delaney Rudd,4.0,1990 - 1993,PG,263,2544,344,833,41.29651860744298,52,201,25.870646766169152,292,632,46.20253164556962,44.41776710684274,143,190,75.26315789473685,48,145,193,568,81,4,260,271,883
Dell Curry,16.0,1987 - 2002,SG,1134,24440,5216,11461,45.51086292644621,1286,3215,40.0,3930,8246,47.65947125879214,51.12119361312276,1292,1530,84.44444444444444,626,2078,2704,1966,1025,245,1340,1876,13010
Dell Demps,3.0,1994 - 1997,SG,20,108,21,42,50.0,1,3,33.33333333333333,20,39,51.28205128205128,51.19047619047619,16,21,76.19047619047619,2,7,9,9,6,1,13,12,59
Delon Wright,4.0,2016 - 2019,PG,226,4155,571,1281,44.57455113192818,132,392,33.6734693877551,439,889,49.38132733408324,49.72677595628415,312,393,79.38931297709924,145,443,588,575,217,87,212,238,1586
Delonte West,8.0,2005 - 2012,SG,490,13528,1790,3999,44.761190297574394,424,1145,37.030567685589524,1366,2854,47.86264891380518,50.06251562890722,720,869,82.85385500575374,241,1170,1411,1705,523,196,804,950,4724
Demetris Nichols,2.0,2008 - 2009,SF,18,58,9,32,28.125,3,15,20.0,6,17,35.294117647058826,32.8125,1,2,50.0,0,7,7,2,0,4,4,5,22
Demetrius Calip,1.0,1992 - 1992,PG,7,58,4,18,22.22222222222222,1,5,20.0,3,13,23.076923076923077,25.0,2,3,66.66666666666666,1,4,5,12,1,0,5,8,11
Demetrius Jackson,3.0,2017 - 2019,PG,26,136,18,37,48.64864864864865,4,14,28.57142857142857,14,23,60.86956521739131,54.054054054054056,8,12,66.66666666666666,9,10,19,17,7,1,11,11,48
Deng Adel,1.0,2019 - 2019,SF,19,194,11,36,30.555555555555557,6,23,26.08695652173913,5,13,38.46153846153847,38.88888888888889,4,4,100.0,3,16,19,5,1,4,6,13,32
Deng Gai,1.0,2006 - 2006,C,2,5,0,0,,0,0,,0,0,,,0,0,,0,0,0,0,0,0,0,0,0
Dennis Hopson,5.0,1988 - 1992,SG,339,7527,1377,3199,43.04470146920913,61,225,27.111111111111114,1316,2974,44.25016812373907,43.99812441387934,826,1083,76.269621421976,423,520,943,540,319,160,549,674,3641
Dennis Horner,1.0,2012 - 2012,PF,8,22,1,4,25.0,0,1,0.0,1,3,33.33333333333333,25.0,3,4,75.0,2,3,5,0,0,0,1,1,5
Dennis Nutt,1.0,1987 - 1987,PG,26,101,17,45,37.77777777777778,5,19,26.31578947368421,12,26,46.15384615384615,43.333333333333336,20,22,90.9090909090909,2,8,10,17,7,0,11,6,59
Dennis Rodman,14.0,1987 - 2000,PF,1080,33628,3208,6212,51.64198325820991,89,402,22.139303482587064,3119,5810,53.68330464716007,52.35833869929169,1259,2184,57.64652014652014,4955,8675,13630,1805,717,628,1742,3473,7764
Dennis Schroder,6.0,2014 - 2019,PG,465,11354,2345,5459,42.956585455211574,477,1459,32.69362577107608,1868,4000,46.7,47.32551749404653,1016,1229,82.66883645240033,198,1034,1232,2142,366,48,1065,876,6183
Dennis Scott,10.0,1991 - 2000,SF,674,19430,3146,7572,41.54780771262546,1309,3321,39.41583860283047,1837,4251,43.213361561985415,50.19149498151083,1012,1278,79.18622848200313,390,1513,1903,1373,561,206,828,1391,8613
Dennis Smith,2.0,2018 - 2019,PG,122,3557,682,1674,40.74074074074074,173,547,31.62705667276051,509,1127,45.16415261756877,45.908004778972526,233,349,66.7621776504298,82,333,415,610,138,38,348,281,1770
Denzel Valentine,2.0,2017 - 2018,SG,138,3093,405,1015,39.90147783251231,217,582,37.2852233676976,188,433,43.418013856812934,50.59113300492611,52,69,75.36231884057972,59,493,552,309,95,19,150,272,1079
Deonte Burton,1.0,2019 - 2019,SG,32,240,33,82,40.243902439024396,8,27,29.629629629629626,25,55,45.45454545454545,45.1219512195122,8,12,66.66666666666666,4,24,28,9,6,8,9,31,82
DerMarr Johnson,7.0,2001 - 2008,SF,354,6059,784,1910,41.047120418848166,279,839,33.253873659118,505,1071,47.152194211017736,48.35078534031413,310,392,79.08163265306123,197,592,789,311,200,153,350,610,2157
Derek Anderson,11.0,1998 - 2008,SG,639,18436,2465,6059,40.683281069483414,658,1934,34.02275077559462,1807,4125,43.806060606060605,46.113220003300874,1936,2272,85.2112676056338,447,1586,2033,2123,703,88,1089,1265,7524
Derek Fisher,18.0,1997 - 2014,PG,1546,39575,4455,11069,40.247538169663024,1533,4056,37.79585798816568,2922,7013,41.66547839726223,47.17228295238955,2416,2965,81.4839797639123,488,2748,3236,4402,1624,114,1710,3329,12859
Derek Grimm,1.0,1998 - 1998,SF,9,34,4,14,28.57142857142857,4,12,33.33333333333333,0,2,0.0,42.857142857142854,2,2,100.0,0,4,4,0,3,1,3,6,14
Derek Harper,16.0,1984 - 1999,PG,1296,40880,6606,14309,46.1667482004333,1166,3289,35.45150501672241,5440,11020,49.364791288566245,50.24110699559717,2722,3662,74.33096668487165,752,2365,3117,7090,2105,315,2501,2992,17100
Derek Hood,1.0,2000 - 2000,PF,2,4,0,3,0.0,0,0,,0,3,0.0,0.0,0,0,,0,1,1,0,0,0,0,0,0
Derek Smith,9.0,1983 - 1991,SG,422,9974,2054,4117,49.89069710954578,45,155,29.03225806451613,2009,3962,50.70671378091873,50.43721156181685,1138,1513,75.21480502313284,480,836,1316,875,270,176,715,1246,5291
Derek Strong,10.0,1992 - 2001,PF,466,8840,1093,2537,43.082380764682696,11,62,17.741935483870968,1082,2475,43.717171717171716,43.29917225068979,967,1232,78.49025974025975,816,1471,2287,298,209,97,441,769,3164
Deron Williams,12.0,2006 - 2017,PG,935,31867,5348,12045,44.40016604400166,1315,3645,36.07681755829904,4033,8400,48.01190476190476,49.85886259858863,3205,3909,81.99027884369404,400,2503,2903,7449,958,227,2646,2371,15216
Derrick Alston,3.0,1995 - 1997,C,139,2657,318,650,48.92307692307693,1,7,14.285714285714285,317,643,49.30015552099534,49.0,114,234,48.717948717948715,228,297,525,94,95,87,112,298,751
Derrick Brown,3.0,2010 - 2012,SF,173,2555,355,688,51.59883720930233,13,41,31.70731707317073,342,647,52.85935085007728,52.54360465116279,174,273,63.73626373626373,167,246,413,119,89,32,109,208,897
Derrick Byars,1.0,2012 - 2012,PF,2,37,3,11,27.27272727272727,0,6,0.0,3,5,60.0,27.27272727272727,4,4,100.0,6,5,11,1,2,0,0,2,10
Derrick Caracter,1.0,2011 - 2011,C,41,215,32,66,48.484848484848484,0,0,,32,66,48.484848484848484,48.484848484848484,17,23,73.91304347826086,19,24,43,7,4,10,19,47,81
Derrick Chievous,3.0,1989 - 1991,SF,161,2308,410,927,44.228694714131606,8,33,24.242424242424242,402,894,44.966442953020135,44.66019417475729,295,390,75.64102564102564,167,206,373,114,79,18,193,256,1123
Derrick Coleman,15.0,1991 - 2005,PF,820,27360,4846,10822,44.77915357604879,352,1179,29.855810008481765,4494,9643,46.603754018458986,46.40547033819996,3496,4537,77.0553229005951,2187,5431,7618,2093,636,1110,2118,2173,13540
Derrick Dial,4.0,2000 - 2004,SG,84,695,105,281,37.36654804270463,8,42,19.047619047619047,97,239,40.58577405857741,38.79003558718861,40,60,66.66666666666666,47,88,135,63,21,11,35,52,258
Derrick Favors,9.0,2011 - 2019,PF,658,16894,3055,5809,52.59080736787743,37,172,21.511627906976745,3018,5637,53.539116551357104,52.909278705457055,1405,2134,65.83880037488285,1623,3079,4702,726,519,836,914,1717,7552
Derrick Gervin,2.0,1990 - 1991,PF,77,1082,257,591,43.48561759729272,7,31,22.58064516129032,250,560,44.642857142857146,44.077834179357026,155,203,76.35467980295566,69,106,175,38,39,26,57,135,676
Derrick Jones,3.0,2017 - 2019,SF,112,1943,249,498,50.0,34,120,28.333333333333332,215,378,56.87830687830689,53.41365461847389,119,187,63.63636363636363,156,201,357,58,64,68,63,210,651
Derrick McKey,15.0,1988 - 2002,SF,1079,31015,4344,8987,48.336486035384446,242,771,31.387808041504538,4102,8216,49.9269717624148,49.68287526427061,2512,3241,77.50694230175871,1744,3269,5013,2573,1183,699,1938,3136,11442
Derrick Phelps,1.0,1995 - 1995,PG,3,5,0,1,0.0,0,0,,0,1,0.0,0.0,0,2,0.0,0,0,0,1,0,0,0,3,0
Derrick Rose,10.0,2009 - 2019,PG,592,19888,4402,9772,45.04707327056897,484,1587,30.497794580970382,3918,8185,47.86805131337813,47.523536635284486,2037,2468,82.53646677471636,523,1593,2116,3360,457,211,1608,826,11325
Derrick Rowland,1.0,1986 - 1986,SG,2,9,1,3,33.33333333333333,0,0,,1,3,33.33333333333333,33.33333333333333,1,2,50.0,0,1,1,1,0,0,0,1,3
Derrick Walton,1.0,2018 - 2018,PG,16,147,8,25,32.0,7,17,41.17647058823529,1,8,12.5,46.0,6,6,100.0,2,14,16,16,7,3,2,7,29
Derrick White,2.0,2018 - 2019,PG,87,1885,279,582,47.93814432989691,57,157,36.30573248407643,222,425,52.23529411764706,52.83505154639175,109,143,76.22377622377621,40,233,273,273,72,52,103,153,724
Derrick Williams,7.0,2012 - 2018,PF,436,8902,1337,3079,43.42318934719064,254,843,30.13048635824436,1083,2236,48.43470483005367,47.547905164014296,902,1269,71.0795902285264,352,1344,1696,297,199,109,402,532,3830
Derrick Zimmerman,1.0,2006 - 2006,PG,2,32,2,3,66.66666666666666,0,0,,2,3,66.66666666666666,66.66666666666666,0,0,,1,3,4,7,0,0,4,4,4
Desmon Farmer,2.0,2007 - 2009,SG,11,86,9,29,31.03448275862069,5,20,25.0,4,9,44.44444444444444,39.6551724137931,3,3,100.0,0,7,7,11,1,0,5,8,26
Desmond Ferguson,1.0,2004 - 2004,SF,7,32,5,12,41.66666666666667,3,8,37.5,2,4,50.0,54.166666666666664,0,2,0.0,0,4,4,1,0,0,1,0,13
Desmond Mason,10.0,2001 - 2010,SF,659,20248,3008,6721,44.75524475524475,67,263,25.475285171102662,2941,6458,45.54041498916073,45.25368248772504,1893,2559,73.97420867526378,819,2141,2960,1075,455,238,1056,1478,7976
Desmond Penigar,1.0,2004 - 2004,PF,10,89,14,28,50.0,0,0,,14,28,50.0,50.0,4,4,100.0,6,18,24,3,2,2,6,14,32
Detlef Schrempf,16.0,1986 - 2001,SF,1250,36935,5888,12044,48.88741281966124,532,1389,38.30093592512599,5356,10655,50.267480056311584,51.09598140152774,4885,6091,80.20029551797735,2014,5574,7588,4129,918,338,2493,3669,17193
Devean George,11.0,2000 - 2010,SF,716,13161,1476,3760,39.25531914893617,486,1427,34.05746320953048,990,2333,42.434633519074154,45.71808510638298,525,733,71.62346521145976,609,1597,2206,600,492,257,498,1438,3963
Devin Booker,4.0,2016 - 2019,SG,272,8945,2014,4607,43.716084219665724,528,1492,35.388739946380696,1486,3115,47.70465489566613,49.44649446494465,1264,1480,85.4054054054054,138,807,945,1154,219,68,859,835,5820
Devin Brown,8.0,2003 - 2010,SG,498,9339,1212,3027,40.0396432111001,314,926,33.909287257019436,898,2101,42.7415516420752,45.226296663363065,730,949,76.92307692307693,351,987,1338,700,269,59,525,780,3468
Devin Durrant,2.0,1985 - 1986,SF,63,807,122,295,41.35593220338983,0,3,0.0,122,292,41.78082191780822,41.35593220338983,73,106,68.86792452830188,51,81,132,85,22,10,81,116,317
Devin Ebanks,3.0,2011 - 2013,SG,72,837,98,252,38.88888888888889,8,39,20.51282051282051,90,213,42.25352112676056,40.476190476190474,57,80,71.25,58,84,142,30,21,19,37,69,261
Devin Gray,2.0,1997 - 2000,SF,27,173,23,63,36.507936507936506,0,0,,23,63,36.507936507936506,36.507936507936506,21,34,61.76470588235294,17,22,39,7,9,3,9,33,67
Devin Green,1.0,2006 - 2006,SG,27,135,6,28,21.428571428571427,0,2,0.0,6,26,23.076923076923077,21.428571428571427,13,21,61.904761904761905,10,14,24,7,3,0,5,13,25
Devin Harris,15.0,2005 - 2019,PG,1049,25480,3702,8552,43.288119738072965,861,2671,32.235117933358296,2841,5881,48.30811086549907,48.32202993451824,2912,3675,79.23809523809524,311,1964,2275,4036,1046,204,1785,2339,11177
Devin Robinson,2.0,2018 - 2019,SF,8,108,20,35,57.14285714285714,0,2,0.0,20,33,60.60606060606061,57.14285714285714,9,14,64.28571428571429,8,17,25,6,5,6,2,13,49
Devonte' Graham,1.0,2019 - 2019,PG,46,676,74,216,34.25925925925926,34,121,28.09917355371901,40,95,42.10526315789473,42.129629629629626,35,46,76.08695652173914,10,53,63,121,23,2,30,48,217
Devyn Marble,2.0,2015 - 2016,SG,44,457,35,115,30.434782608695656,12,54,22.22222222222222,23,61,37.704918032786885,35.65217391304348,15,40,37.5,11,58,69,29,22,3,16,39,97
Dewayne Dedmon,6.0,2014 - 2019,C,362,6518,912,1707,53.427065026362044,133,359,37.04735376044568,779,1348,57.7893175074184,57.32278851786761,353,496,71.16935483870968,578,1584,2162,254,193,304,340,888,2310
Dexter Boney,1.0,1997 - 1997,SG,8,48,6,19,31.57894736842105,1,6,16.666666666666664,5,13,38.46153846153847,34.21052631578947,6,8,75.0,3,3,6,0,2,1,1,3,19
Dexter Cambridge,1.0,1993 - 1993,SF,53,885,151,312,48.3974358974359,0,4,0.0,151,308,49.02597402597403,48.3974358974359,68,99,68.68686868686868,88,79,167,58,24,6,63,128,370
Dexter Pittman,4.0,2011 - 2014,C,53,355,49,111,44.14414414414414,0,0,,49,111,44.14414414414414,44.14414414414414,18,33,54.54545454545454,38,51,89,10,8,9,22,85,116
Dexter Shouse,1.0,1990 - 1990,PG,3,18,0,4,0.0,0,1,0.0,0,3,0.0,0.0,0,0,,0,0,0,2,1,1,2,2,0
Deyonta Davis,3.0,2017 - 2019,C,110,1310,203,339,59.882005899705014,0,1,0.0,203,338,60.05917159763313,59.882005899705014,55,87,63.2183908045977,107,244,351,47,21,61,43,179,461
Diamond Stone,1.0,2017 - 2017,C,7,24,3,13,23.076923076923077,0,0,,3,13,23.076923076923077,23.076923076923077,4,4,100.0,1,5,6,0,0,1,2,5,10
Diante Garrett,2.0,2013 - 2014,PG,90,1197,117,314,37.261146496815286,39,111,35.13513513513514,78,203,38.42364532019704,43.47133757961784,15,22,68.18181818181817,16,96,112,151,51,5,91,80,288
Dick Miller,1.0,1981 - 1981,SF,8,53,4,9,44.44444444444444,0,1,0.0,4,8,50.0,44.44444444444444,0,0,,2,5,7,5,4,0,8,5,8
Dickey Simpkins,7.0,1995 - 2002,PF,340,5275,501,1140,43.94736842105263,2,9,22.22222222222222,499,1131,44.12024756852343,44.03508771929825,400,650,61.53846153846154,427,773,1200,308,93,61,371,603,1404
Didier Ilunga-Mbenga,7.0,2005 - 2011,C,263,1675,191,408,46.81372549019608,0,2,0.0,191,406,47.04433497536946,46.81372549019608,58,94,61.702127659574465,135,246,381,43,41,148,94,313,440
Dijon Thompson,2.0,2006 - 2007,SG,16,93,17,40,42.5,4,13,30.76923076923077,13,27,48.148148148148145,47.5,7,8,87.5,7,12,19,3,3,1,3,8,45
Dikembe Mutombo,18.0,1992 - 2009,C,1297,39908,4472,8631,51.81323137527517,0,3,0.0,4472,8628,51.83124710245711,51.81323137527517,3703,5404,68.52331606217616,4104,9217,13321,1318,534,3540,2322,3642,12647
Dillon Brooks,2.0,2018 - 2019,SF,100,2680,389,894,43.51230425055929,109,304,35.85526315789473,280,590,47.45762711864407,49.608501118568235,146,196,74.48979591836735,58,230,288,151,83,21,143,283,1033
Dino Radja,4.0,1994 - 1997,PF,228,7461,1536,3102,49.51644100580271,0,3,0.0,1536,3099,49.56437560503388,49.51644100580271,721,982,73.42158859470469,501,1410,1911,365,205,287,504,764,3793
Dion Glover,6.0,2000 - 2005,SG,294,6132,914,2222,41.13411341134113,148,467,31.69164882226981,766,1755,43.64672364672364,44.46444644464446,431,570,75.6140350877193,213,684,897,455,233,65,370,487,2407
Dion Waiters,7.0,2013 - 2019,SG,427,12119,2120,5143,41.221077192300214,581,1669,34.811264230077896,1539,3474,44.30051813471503,46.8695314019055,724,1047,69.14995224450811,170,961,1131,1185,397,110,765,834,5545
Dionte Christmas,1.0,2014 - 2014,SF,31,198,22,62,35.483870967741936,9,31,29.03225806451613,13,31,41.935483870967744,42.74193548387097,18,24,75.0,13,25,38,8,2,3,6,19,71
Dirk Minniefield,3.0,1986 - 1988,PG,241,3878,503,1072,46.92164179104478,27,97,27.835051546391753,476,975,48.82051282051282,48.18097014925373,184,246,74.79674796747967,105,266,371,858,199,11,372,493,1217
Dirk Nowitzki,21.0,1999 - 2019,PF,1667,57263,12389,26376,46.97073096754625,2131,5618,37.93164827340691,10258,20758,49.41709220541478,51.01038823172581,8314,9443,88.04405379646299,1680,11255,12935,4011,1359,1410,2822,4008,35223
Doc Rivers,13.0,1984 - 1996,PG,945,25960,3603,8107,44.44307388676452,411,1249,32.90632506004803,3192,6858,46.54418197725284,46.97792031577649,2686,3432,78.26340326340326,688,2207,2895,5368,1688,374,1804,2925,10303
Domantas Sabonis,3.0,2017 - 2019,C,238,5452,981,1907,51.44205558468799,74,221,33.4841628959276,907,1686,53.79596678529063,53.38227582590456,438,604,72.51655629139073,411,1173,1584,450,129,97,387,685,2474
Dominic McGuire,6.0,2008 - 2013,SF,345,5363,388,927,41.855447680690396,3,16,18.75,385,911,42.26125137211855,42.017259978425024,161,245,65.71428571428571,345,827,1172,423,155,185,242,502,940
Dominic Pressley,1.0,1989 - 1989,PG,13,124,9,31,29.03225806451613,0,2,0.0,9,29,31.03448275862069,29.03225806451613,5,9,55.55555555555556,3,12,15,26,4,0,11,11,23
Dominique Jones,3.0,2011 - 2013,SG,80,741,83,227,36.56387665198238,2,21,9.523809523809524,81,206,39.32038834951456,37.00440528634361,78,107,72.89719626168224,33,81,114,144,29,10,76,64,246
Dominique Wilkins,15.0,1983 - 1999,SF,1130,40285,10478,22790,45.97630539710399,738,2327,31.714654061022774,9740,20463,47.59810389483458,47.59543659499781,6397,7882,81.15960416138036,3108,4436,7544,2820,1451,677,2822,2184,28091
Don Collins,6.0,1981 - 1987,SG,311,6285,1254,2592,48.379629629629626,2,29,6.896551724137931,1252,2563,48.84900507218104,48.41820987654321,516,689,74.89114658925979,438,421,859,552,336,99,559,780,3026
Don MacLean,9.0,1993 - 2001,SF,319,6679,1320,2902,45.485871812543074,56,197,28.426395939086298,1264,2705,46.728280961182996,46.450723638869746,794,1038,76.49325626204238,356,854,1210,404,118,51,398,598,3490
Don Reid,8.0,1996 - 2003,PF,418,5487,594,1116,53.2258064516129,0,2,0.0,594,1114,53.3213644524237,53.2258064516129,296,453,65.34216335540839,447,745,1192,145,184,288,256,1169,1484
Donald Hodge,5.0,1992 - 1996,C,249,3501,462,1057,43.70860927152318,4,14,28.57142857142857,458,1043,43.9117929050815,43.897824030274364,254,357,71.1484593837535,306,503,809,191,84,95,236,531,1182
Donald Royal,8.0,1990 - 1998,SF,540,8866,996,2112,47.159090909090914,0,14,0.0,996,2098,47.47378455672069,47.159090909090914,1276,1663,76.72880336740829,570,913,1483,516,253,102,567,912,3268
Donald Sloan,5.0,2012 - 2016,PG,222,3764,451,1105,40.81447963800905,99,320,30.9375,352,785,44.840764331210195,45.294117647058826,195,260,75.0,54,402,456,654,84,8,232,193,1196
Donald Whiteside,2.0,1997 - 1998,PG,30,275,19,57,33.33333333333333,12,37,32.432432432432435,7,20,35.0,43.859649122807014,11,17,64.70588235294117,2,11,13,37,11,0,18,23,61
Donatas Motiejunas,6.0,2013 - 2019,PF,257,4669,749,1597,46.90043832185348,125,413,30.26634382566586,624,1184,52.702702702702695,50.81402629931121,258,435,59.310344827586206,309,670,979,274,122,84,299,549,1881
Donell Taylor,2.0,2006 - 2007,SG,101,854,110,283,38.869257950530034,7,35,20.0,103,248,41.53225806451613,40.10600706713781,42,65,64.61538461538461,30,79,109,95,48,7,61,83,269
Donnell Harvey,5.0,2001 - 2005,PF,205,3318,453,985,45.98984771573604,1,10,10.0,452,975,46.35897435897436,46.04060913705584,243,369,65.85365853658537,261,566,827,161,97,80,209,464,1150
Donnie Boyce,2.0,1996 - 1997,SG,31,197,30,88,34.090909090909086,6,26,23.076923076923077,24,62,38.70967741935484,37.5,13,26,50.0,12,13,25,16,13,5,22,19,79
Donny Marshall,5.0,1996 - 2003,SF,127,934,88,276,31.88405797101449,42,129,32.55813953488372,46,147,31.292517006802722,39.492753623188406,78,114,68.42105263157895,39,82,121,36,37,5,45,108,296
Donovan Mitchell,2.0,2018 - 2019,SG,167,5647,1358,3135,43.31738437001595,400,1149,34.81288076588338,958,1986,48.23766364551863,49.696969696969695,597,736,81.11413043478261,120,557,677,659,240,62,465,456,3713
Donta Smith,2.0,2005 - 2006,SG,61,560,59,140,42.142857142857146,8,26,30.76923076923077,51,114,44.73684210526316,45.0,39,60,65.0,22,44,66,48,31,5,29,70,165
Dontae' Jones,1.0,1998 - 1998,SF,15,91,19,57,33.33333333333333,6,23,26.08695652173913,13,34,38.23529411764706,38.59649122807017,0,0,,3,6,9,5,2,3,11,12,44
Donte DiVincenzo,1.0,2019 - 2019,SG,27,411,50,124,40.32258064516129,22,83,26.506024096385545,28,41,68.29268292682927,49.193548387096776,9,12,75.0,16,49,65,31,13,6,19,38,131
Donte Grantham,1.0,2019 - 2019,SF,3,2,0,2,0.0,0,2,0.0,0,0,,0.0,0,0,,0,0,0,0,0,0,0,0,0
Donte Greene,4.0,2009 - 2012,SF,253,4259,585,1441,40.59680777238029,165,542,30.44280442804428,420,899,46.71857619577308,46.32199861207495,206,294,70.06802721088435,140,460,600,183,111,116,222,373,1541
Dontell Jefferson,1.0,2009 - 2009,SG,6,84,11,22,50.0,1,2,50.0,10,20,50.0,52.27272727272727,6,9,66.66666666666666,1,11,12,9,4,1,6,9,29
Dontonio Wingfield,4.0,1995 - 1998,SF,122,1224,167,427,39.11007025761124,53,162,32.71604938271605,114,265,43.0188679245283,45.31615925058548,68,96,70.83333333333334,131,160,291,81,40,15,94,204,455
Donyell Marshall,15.0,1995 - 2009,PF,1004,25910,4213,9703,43.41956096052767,942,2694,34.96659242761693,3271,7009,46.66856898273648,48.27372977429661,1663,2272,73.19542253521126,1961,4605,6566,1337,806,873,1326,2260,11031
Dorell Wright,11.0,2005 - 2015,SF,569,12503,1678,3962,42.35234729934377,625,1716,36.421911421911425,1053,2246,46.8833481745325,50.239777889954574,686,850,80.70588235294117,379,1755,2134,864,423,280,486,803,4667
Dorian Finney-Smith,3.0,2017 - 2019,PF,183,4075,398,982,40.52953156822811,155,512,30.2734375,243,470,51.70212765957447,48.42158859470469,130,179,72.62569832402235,215,471,686,188,131,65,140,354,1081
Doron Lamb,2.0,2013 - 2014,SG,100,1272,123,323,38.080495356037154,50,127,39.37007874015748,73,196,37.244897959183675,45.82043343653251,49,70,70.0,16,79,95,75,24,1,53,106,345
Doug Christie,15.0,1993 - 2007,SG,885,27975,3417,8072,42.33151635282458,850,2421,35.10945890128046,2567,5651,45.42558839143515,47.596630327056495,2169,2639,82.19022356953391,857,2809,3666,3211,1648,421,1837,2221,9853
Doug Edwards,3.0,1994 - 1996,PF,86,841,71,188,37.765957446808514,0,6,0.0,71,182,39.010989010989015,37.765957446808514,61,86,70.93023255813954,61,92,153,60,17,28,57,90,203
Doug Lee,3.0,1992 - 1995,SG,75,421,61,151,40.397350993377486,18,60,30.0,43,91,47.25274725274725,46.35761589403973,28,40,70.0,17,25,42,33,17,6,20,65,168
Doug McDermott,5.0,2015 - 2019,SF,349,6874,1010,2199,45.9299681673488,384,945,40.63492063492063,626,1254,49.920255183413076,54.66120964074579,285,345,82.6086956521739,121,612,733,271,69,37,208,463,2689
Doug Overton,11.0,1993 - 2004,PG,499,7275,880,2134,41.23711340206185,108,339,31.858407079646017,772,1795,43.008356545961,43.767572633552014,385,472,81.5677966101695,140,514,654,1038,202,19,473,582,2253
Doug Roth,1.0,1990 - 1990,C,42,412,37,86,43.02325581395349,0,1,0.0,37,85,43.529411764705884,43.02325581395349,7,14,50.0,44,76,120,20,8,13,16,70,81
Doug Smith,5.0,1992 - 1996,PF,296,5833,1020,2399,42.5177157148812,3,36,8.333333333333332,1017,2363,43.03851036817605,42.58024176740308,313,405,77.28395061728395,394,840,1234,400,224,150,353,979,2356
Doug West,12.0,1990 - 2001,SG,679,16736,2643,5495,48.098271155595995,37,196,18.877551020408163,2606,5299,49.17909039441404,48.43494085532302,1187,1479,80.25693035835023,532,1142,1674,1298,461,190,824,1873,6510
Dragan Bender,3.0,2017 - 2019,PF,171,3469,332,842,39.42992874109264,168,524,32.06106870229007,164,318,51.57232704402516,49.4061757719715,75,116,64.65517241379311,97,550,647,209,50,97,181,330,907
Dragan Tarlac,1.0,2001 - 2001,C,43,598,39,99,39.39393939393939,0,0,,39,99,39.39393939393939,39.39393939393939,25,33,75.75757575757575,37,85,122,31,7,19,38,95,103
Draymond Green,7.0,2013 - 2019,PF,634,18505,2178,4976,43.770096463022504,617,1907,32.35448348190876,1561,3069,50.863473444118604,49.96985530546624,1096,1535,71.40065146579805,803,3823,4626,3156,895,723,1331,1855,6069
Drazen Petrovic,4.0,1990 - 1993,SG,319,8278,1824,3620,50.38674033149171,266,617,43.11183144246353,1558,3003,51.88145188145188,54.06077348066298,844,1015,83.15270935960591,256,464,720,743,277,28,646,819,4758
Drew Barry,3.0,1998 - 2000,PG,62,603,43,104,41.34615384615385,24,64,37.5,19,40,47.5,52.88461538461539,24,31,77.41935483870968,8,60,68,111,19,2,55,75,134
Drew Eubanks,1.0,2019 - 2019,PF,23,113,15,26,57.692307692307686,0,0,,15,26,57.692307692307686,57.692307692307686,11,13,84.61538461538461,6,28,34,7,2,5,8,11,41
Drew Gooden,14.0,2003 - 2016,PF,854,21643,3660,7943,46.078307944101724,100,379,26.385224274406333,3560,7564,47.06504494976203,46.7077930253053,1797,2360,76.14406779661017,2024,4053,6077,941,566,506,1236,2146,9217
Drew Gordon,1.0,2015 - 2015,PF,9,71,8,19,42.10526315789473,0,3,0.0,8,16,50.0,42.10526315789473,1,2,50.0,7,11,18,2,1,0,8,7,17
Duane Causwell,11.0,1991 - 2001,C,549,9464,1031,2035,50.663390663390665,2,8,25.0,1029,2027,50.76467686235816,50.712530712530715,595,962,61.85031185031185,795,1490,2285,245,221,767,503,1477,2659
Duane Cooper,2.0,1993 - 1994,PG,90,785,80,205,39.02439024390244,8,40,20.0,72,165,43.63636363636363,40.97560975609756,36,50,72.0,17,44,61,179,21,2,89,78,204
Duane Ferrell,11.0,1989 - 1999,SF,617,9202,1482,3108,47.68339768339768,45,155,29.03225806451613,1437,2953,48.6623772434812,48.407335907335906,875,1173,74.59505541346974,595,610,1205,546,311,110,534,962,3884
Duane Washington,2.0,1988 - 1993,SG,19,184,18,47,38.297872340425535,2,4,50.0,16,43,37.2093023255814,40.42553191489361,16,20,80.0,5,19,24,39,13,0,11,25,54
Duje Dukan,1.0,2016 - 2016,SF,1,24,2,10,20.0,2,5,40.0,0,5,0.0,30.0,0,0,,2,2,4,1,1,0,0,2,6
Duncan Robinson,1.0,2019 - 2019,PF,15,161,18,46,39.130434782608695,10,35,28.57142857142857,8,11,72.72727272727273,50.0,4,6,66.66666666666666,2,17,19,5,5,0,4,11,50
Dusty Hannahs,1.0,2019 - 2019,SG,2,26,3,12,25.0,0,5,0.0,3,7,42.857142857142854,25.0,2,2,100.0,0,1,1,5,1,0,1,1,8
Dwayne Bacon,2.0,2018 - 2019,SG,96,1472,194,449,43.207126948775056,49,130,37.69230769230769,145,319,45.45454545454545,48.66369710467706,54,71,76.05633802816901,12,201,213,85,28,7,41,118,491
Dwayne Jones,5.0,2006 - 2010,PF,91,668,35,69,50.72463768115942,0,1,0.0,35,68,51.470588235294116,50.72463768115942,45,89,50.56179775280899,89,113,202,12,11,30,28,116,115
Dwayne McClain,1.0,1986 - 1986,SF,45,461,69,180,38.333333333333336,1,9,11.11111111111111,68,171,39.76608187134503,38.611111111111114,18,35,51.42857142857142,14,16,30,67,38,4,40,61,157
Dwayne Morton,1.0,1995 - 1995,PG,41,395,50,129,38.759689922480625,9,25,36.0,41,104,39.42307692307692,42.248062015503876,58,85,68.23529411764706,21,37,58,18,11,15,27,45,167
Dwayne Polee,1.0,1987 - 1987,SG,1,6,1,4,25.0,0,3,0.0,1,1,100.0,25.0,0,0,,0,0,0,0,1,0,1,3,2
Dwayne Schintzius,8.0,1991 - 1999,C,222,2056,269,662,40.6344410876133,1,8,12.5,268,654,40.97859327217125,40.70996978851964,77,122,63.114754098360656,173,388,561,97,31,123,122,333,616
Dwayne Whitfield,1.0,1996 - 1996,PF,8,122,13,30,43.333333333333336,0,0,,13,30,43.333333333333336,43.333333333333336,14,22,63.63636363636363,9,16,25,2,3,2,8,14,40
Dwight Anderson,1.0,1983 - 1983,PG,5,33,7,14,50.0,0,0,,7,14,50.0,50.0,7,10,70.0,0,2,2,3,1,0,5,7,21
Dwight Buycks,3.0,2014 - 2018,PG,49,696,115,286,40.20979020979021,27,73,36.986301369863014,88,213,41.31455399061033,44.93006993006993,53,60,88.33333333333333,18,58,76,83,30,2,61,53,310
Dwight Howard,15.0,2005 - 2019,C,1139,39498,7163,12286,58.302132508546315,6,67,8.955223880597014,7157,12219,58.57271462476471,58.326550545336154,5531,9797,56.45605797693172,4054,10445,14499,1667,1070,2285,3354,3756,19863
Dwight Powell,5.0,2015 - 2019,C,337,5962,925,1676,55.1909307875895,93,313,29.712460063897762,832,1363,61.04181951577403,57.965393794749396,572,766,74.67362924281984,479,1023,1502,310,218,151,212,686,2515
Dwyane Wade,16.0,2004 - 2019,SG,1231,42470,9904,20679,47.89399874268582,652,2179,29.92198256080771,9252,18500,50.01081081081081,49.47047729580734,6659,8683,76.69008407232523,1492,4369,5861,6571,1893,1060,3909,2795,27119
Dyron Nix,1.0,1990 - 1990,SF,20,109,14,39,35.8974358974359,0,0,,14,39,35.8974358974359,35.8974358974359,11,16,68.75,8,18,26,5,3,1,7,15,39
Dzanan Musa,1.0,2019 - 2019,SG,9,39,9,22,40.909090909090914,1,10,10.0,8,12,66.66666666666666,43.18181818181818,0,2,0.0,1,4,5,2,2,0,4,1,19
E'Twaun Moore,8.0,2012 - 2019,SG,536,11469,1731,3780,45.79365079365079,492,1258,39.109697933227345,1239,2522,49.12767644726407,52.301587301587304,302,408,74.01960784313727,243,818,1061,955,356,117,483,857,4256
Earl Barron,8.0,2006 - 2015,C,141,1985,255,687,37.117903930131,3,18,16.666666666666664,252,669,37.66816143497758,37.33624454148472,127,181,70.1657458563536,188,304,492,63,46,30,107,270,640
Earl Boykins,13.0,1999 - 2012,PG,667,13377,2150,5170,41.58607350096712,393,1144,34.35314685314685,1757,4026,43.64133134624938,45.38684719535783,1291,1476,87.46612466124661,286,615,901,2150,403,36,774,684,5984
Earl Clark,6.0,2010 - 2015,PF,276,3832,472,1178,40.0679117147708,84,257,32.68482490272373,388,921,42.12812160694897,43.63327674023769,156,235,66.38297872340425,207,624,831,138,89,143,187,335,1184
Earl Cureton,12.0,1981 - 1997,PF,728,13008,1621,3432,47.231934731934736,0,19,0.0,1621,3413,47.49487254614708,47.231934731934736,547,1021,53.57492654260528,1244,2101,3345,700,360,369,754,1618,3789
Earl Jones,2.0,1985 - 1986,C,14,50,5,13,38.46153846153847,0,0,,5,13,38.46153846153847,38.46153846153847,3,4,75.0,4,6,10,4,0,1,8,13,13
Earl Watson,13.0,2002 - 2014,PG,890,19644,2128,5179,41.08901332303533,503,1564,32.1611253196931,1625,3615,44.951590594744125,45.94516315891099,872,1238,70.43618739903069,469,1536,2005,3894,881,177,1557,1775,5631
Ed Davis,9.0,2011 - 2019,PF,670,13302,1755,3094,56.72268907563025,0,6,0.0,1755,3088,56.832901554404145,56.72268907563025,745,1279,58.24863174354965,1538,2927,4465,513,325,547,525,1648,4255
Ed Gray,2.0,1998 - 1999,SG,68,880,145,425,34.11764705882353,34,99,34.34343434343434,111,326,34.04907975460122,38.11764705882353,93,113,82.30088495575221,18,64,82,50,33,13,61,114,417
Ed Horton,1.0,1990 - 1990,PF,45,374,80,162,49.382716049382715,0,4,0.0,80,158,50.63291139240506,49.382716049382715,42,69,60.86956521739131,59,49,108,19,9,5,39,63,202
Ed Nealy,10.0,1983 - 1993,PF,573,7168,583,1179,49.44868532654792,43,145,29.655172413793103,540,1034,52.22437137330754,51.27226463104325,326,476,68.4873949579832,613,1277,1890,407,270,52,236,959,1535
Ed O'Bannon,2.0,1996 - 1997,SG,128,2062,249,679,36.671575846833576,28,126,22.22222222222222,221,553,39.963833634719705,38.733431516936676,108,143,75.52447552447552,115,201,316,102,73,23,82,192,634
Ed Pinckney,12.0,1986 - 1997,PF,823,16258,1977,3678,53.752039151712886,0,19,0.0,1977,3659,54.031156053566555,53.752039151712886,1600,2087,76.66506947771921,1550,2537,4087,738,631,447,866,1588,5554
Ed Rains,2.0,1982 - 1983,SF,91,970,115,271,42.435424354243544,0,4,0.0,115,267,43.07116104868914,42.435424354243544,71,116,61.206896551724135,66,67,133,64,29,3,52,114,301
Ed Sherod,1.0,1983 - 1983,PG,70,1647,172,426,40.375586854460096,1,13,7.6923076923076925,171,413,41.404358353510894,40.49295774647887,52,80,65.0,44,107,151,315,100,14,105,115,397
Ed Stokes,1.0,1998 - 1998,C,4,17,1,3,33.33333333333333,0,0,,1,3,33.33333333333333,33.33333333333333,1,2,50.0,1,3,4,1,1,2,2,4,3
Eddie Basden,1.0,2006 - 2006,SF,19,141,15,37,40.54054054054054,1,7,14.285714285714285,14,30,46.666666666666664,41.891891891891895,8,10,80.0,7,21,28,8,9,2,9,17,39
Eddie Gill,7.0,2001 - 2009,PG,196,2079,184,512,35.9375,64,203,31.527093596059114,120,309,38.83495145631068,42.1875,163,192,84.89583333333334,28,183,211,222,105,14,143,209,595
Eddie Griffin,5.0,2002 - 2007,PF,303,6729,854,2263,37.73751657092355,237,752,31.515957446808514,617,1511,40.833884844473864,42.97392841361025,226,337,67.06231454005935,497,1247,1744,236,105,518,227,506,2171
Eddie House,11.0,2001 - 2011,PG,783,13085,2179,5335,40.84348641049672,856,2202,38.87375113533152,1323,3133,42.22789658474306,48.865979381443296,409,480,85.20833333333333,171,1117,1288,1160,495,62,596,993,5623
Eddie Hughes,3.0,1988 - 1990,PG,104,1174,118,286,41.25874125874126,29,80,36.25,89,206,43.203883495145625,46.32867132867133,36,52,69.23076923076923,24,69,93,160,66,3,57,123,301
Eddie Jones,14.0,1995 - 2008,SG,1035,35543,5280,12090,43.67245657568238,1670,4471,37.35182285842094,3610,7619,47.381546134663346,50.57899090157155,2962,3671,80.68646145464452,818,3366,4184,3009,1725,641,1614,2722,15192
Eddie Lee Wilkins,6.0,1985 - 1993,C,337,3880,614,1302,47.15821812596006,0,9,0.0,614,1293,47.48646558391338,47.15821812596006,354,629,56.27980922098569,412,614,1026,62,84,60,296,623,1582
Eddie Phillips,1.0,1983 - 1983,SF,50,428,59,144,40.97222222222222,0,4,0.0,59,140,42.142857142857146,40.97222222222222,41,63,65.07936507936508,30,52,82,32,14,8,51,60,159
Eddie Robinson,5.0,2000 - 2004,SF,292,5582,888,1753,50.656018254421,9,35,25.71428571428571,879,1718,51.164144353899886,50.912721049629205,234,314,74.52229299363057,251,549,800,265,222,96,221,359,2019
Eddy Curry,11.0,2002 - 2013,C,527,13109,2578,4734,54.45711871567384,2,2,100.0,2576,4732,54.437869822485204,54.47824250105619,1662,2588,64.2194744976816,947,1778,2725,287,155,384,1174,1562,6820
Edgar Jones,6.0,1981 - 1986,PF,378,7198,1244,2464,50.48701298701299,16,64,25.0,1228,2400,51.16666666666667,50.81168831168831,853,1205,70.7883817427386,587,1219,1806,351,228,469,583,1214,3357
Edmond Sumner,2.0,2018 - 2019,PG,24,212,23,65,35.38461538461539,7,27,25.925925925925924,16,38,42.10526315789473,40.76923076923077,15,24,62.5,9,16,25,10,12,5,10,27,68
Edmund Lawrence,1.0,1981 - 1981,C,3,19,5,8,62.5,0,0,,5,8,62.5,62.5,2,4,50.0,2,2,4,1,1,0,1,6,12
Eduardo Najera,12.0,2001 - 2012,PF,678,12142,1289,2697,47.79384501297738,115,371,30.997304582210244,1174,2326,50.47291487532244,49.92584352984798,582,860,67.67441860465117,979,1514,2493,524,477,240,436,1520,3275
Edwin Ubiles,1.0,2012 - 2012,SF,4,52,5,18,27.77777777777778,1,5,20.0,4,13,30.76923076923077,30.555555555555557,3,3,100.0,2,8,10,1,1,1,1,1,14
Edy Tavares,2.0,2016 - 2017,C,13,101,15,24,62.5,0,0,,15,24,62.5,62.5,3,11,27.27272727272727,11,21,32,4,1,12,7,11,33
Efthimi Rentzias,1.0,2003 - 2003,C,35,144,20,59,33.89830508474576,4,8,50.0,16,51,31.372549019607842,37.28813559322034,8,9,88.88888888888889,10,16,26,7,6,2,4,21,52
Ekpe Udoh,7.0,2011 - 2019,C,398,5781,525,1158,45.33678756476684,0,4,0.0,525,1154,45.493934142114384,45.33678756476684,315,443,71.10609480812641,460,652,1112,261,179,433,223,723,1365
Elden Campbell,15.0,1991 - 2005,PF,1150,28044,4401,9605,45.81988547631442,3,41,7.317073170731707,4398,9564,45.98494353826851,45.835502342529935,2888,4144,69.6911196911197,2037,4579,6616,1298,753,1739,1496,3304,11693
Eldridge Recasner,8.0,1995 - 2002,SG,313,5348,650,1533,42.400521852576645,250,608,41.118421052631575,400,925,43.24324324324324,50.554468362687544,245,279,87.81362007168458,134,417,551,543,133,12,316,419,1795
Elfrid Payton,5.0,2015 - 2019,PG,342,10104,1557,3429,45.40682414698163,144,477,30.18867924528302,1413,2952,47.86585365853659,47.506561679790025,540,857,63.010501750291716,386,1105,1491,2243,446,119,838,757,3798
Elias Harris,1.0,2014 - 2014,SF,2,11,0,1,0.0,0,0,,0,1,0.0,0.0,0,0,,1,0,1,1,1,0,0,0,0
Elie Okobo,1.0,2019 - 2019,PG,53,958,114,290,39.310344827586206,39,132,29.545454545454547,75,158,47.46835443037975,46.03448275862069,37,47,78.72340425531915,12,86,98,127,32,7,69,109,304
Elijah Millsap,3.0,2015 - 2017,SG,69,1120,93,284,32.74647887323944,29,104,27.884615384615387,64,180,35.55555555555556,37.852112676056336,72,106,67.9245283018868,37,154,191,78,63,19,78,159,287
Elliot Perry,10.0,1992 - 2002,PG,568,9688,1387,3018,45.95758780649437,140,390,35.8974358974359,1247,2628,47.45053272450533,48.27700463883367,626,800,78.25,189,569,758,1728,584,20,790,720,3540
Elliot Williams,4.0,2012 - 2016,SG,109,1470,193,458,42.13973799126637,54,174,31.03448275862069,139,284,48.943661971830984,48.03493449781659,97,145,66.89655172413794,38,123,161,94,45,6,78,158,537
Elmer Bennett,3.0,1995 - 1997,PG,21,159,16,47,34.04255319148936,3,11,27.27272727272727,13,36,36.11111111111111,37.234042553191486,13,18,72.22222222222221,1,9,10,22,9,1,20,16,48
Elmore Spencer,5.0,1993 - 1997,C,160,2646,389,756,51.455026455026456,0,3,0.0,389,753,51.66002656042497,51.455026455026456,145,252,57.53968253968254,128,428,556,109,53,170,249,337,923
Elston Turner,8.0,1982 - 1989,SF,548,9741,1146,2629,43.59071890452644,10,50,20.0,1136,2579,44.048080651415276,43.78090528718144,313,442,70.81447963800905,607,898,1505,1000,475,29,490,989,2615
Elton Brand,17.0,2000 - 2016,PF,1098,36053,6805,13584,50.09570082449941,2,22,9.090909090909092,6803,13562,50.162217961952514,50.103062426383985,3719,5057,73.54162546964604,3396,5896,9292,2248,965,1891,2100,3219,17331
Emanual Davis,6.0,1997 - 2003,PG,226,3934,402,1020,39.411764705882355,156,443,35.214446952595935,246,577,42.63431542461005,47.05882352941176,140,178,78.65168539325843,79,361,440,396,167,29,267,344,1100
Emanuel Terry,1.0,2019 - 2019,PF,3,23,4,7,57.14285714285714,0,0,,4,7,57.14285714285714,57.14285714285714,2,4,50.0,3,4,7,2,3,0,2,4,10
Emeka Okafor,10.0,2005 - 2018,C,623,19247,3024,5899,51.262925919647394,0,2,0.0,3024,5897,51.28031202306258,51.262925919647394,1366,2336,58.476027397260275,1971,4029,6000,520,420,1009,996,1725,7414
Emmanuel Mudiay,4.0,2016 - 2019,PG,246,6326,1071,2722,39.3460690668626,246,768,32.03125,825,1954,42.22108495394063,43.86480529022778,513,691,74.24023154848047,120,638,758,1023,190,78,593,419,2901
Enes Kanter,8.0,2012 - 2019,C,610,13360,2919,5408,53.975591715976336,44,157,28.02547770700637,2875,5251,54.7514759093506,54.38239644970414,1272,1627,78.18070067609096,1773,2799,4572,497,241,279,945,1351,7154
Ennis Whatley,10.0,1984 - 1997,PG,416,7368,863,1869,46.17442482611022,3,32,9.375,860,1837,46.81545998911268,46.254681647940075,467,617,75.68881685575364,203,507,710,1786,399,44,708,744,2196
Eric Anderson,2.0,1993 - 1994,PF,29,89,13,37,35.13513513513514,2,2,100.0,11,35,31.428571428571427,37.83783783783784,16,27,59.25925925925925,12,20,32,5,3,2,8,25,44
Eric Bledsoe,9.0,2011 - 2019,PG,594,16414,2940,6445,45.61675717610551,619,1850,33.45945945945946,2321,4595,50.511425462459194,50.4189294026377,1756,2220,79.0990990990991,487,1808,2295,2791,869,288,1545,1220,8255
Eric Dawson,1.0,2012 - 2012,C,4,39,7,12,58.333333333333336,0,0,,7,12,58.333333333333336,58.333333333333336,1,2,50.0,5,5,10,0,1,2,3,6,15
Eric Gordon,11.0,2009 - 2019,SG,661,21833,3734,8750,42.674285714285716,1540,4130,37.28813559322034,2194,4620,47.489177489177486,51.47428571428571,1967,2418,81.34822167080232,282,1384,1666,1907,596,230,1318,1304,10975
Eric Johnson,1.0,1990 - 1990,PG,49,275,20,84,23.809523809523807,1,6,16.666666666666664,19,78,24.358974358974358,24.404761904761905,13,17,76.47058823529412,8,20,28,64,17,2,26,49,54
Eric Leckner,8.0,1989 - 1997,C,456,5489,720,1417,50.81157374735356,1,6,16.666666666666664,719,1411,50.95676824946847,50.84685956245589,414,620,66.77419354838709,365,1063,1428,213,84,140,390,1026,1855
Eric Maynor,5.0,2010 - 2014,PG,290,4192,475,1219,38.966365873666945,121,348,34.770114942528735,354,871,40.64293915040184,43.92945036915504,174,238,73.10924369747899,73,306,379,806,121,21,302,317,1245
Eric Mobley,3.0,1995 - 1997,C,113,1570,180,333,54.054054054054056,3,4,75.0,177,329,53.799392097264445,54.5045045045045,77,162,47.53086419753087,139,212,351,57,27,61,103,194,440
Eric Montross,8.0,1995 - 2002,C,481,8647,901,1841,48.940793047256925,0,3,0.0,901,1838,49.020674646354735,48.940793047256925,293,612,47.875816993464056,731,1462,2193,208,122,280,415,1306,2095
Eric Moreland,4.0,2015 - 2019,PF,83,898,73,136,53.67647058823529,1,1,100.0,72,135,53.333333333333336,54.04411764705882,13,33,39.39393939393939,88,222,310,83,32,56,50,130,160
Eric Murdock,9.0,1992 - 2000,PG,516,12018,1903,4347,43.777317690361166,298,873,34.13516609392898,1605,3474,46.200345423143354,47.20496894409938,1069,1359,78.66077998528328,342,942,1284,2483,838,70,998,993,5173
Eric Piatkowski,14.0,1995 - 2008,SG,806,14754,2058,4749,43.335439039797855,874,2191,39.890460976722956,1184,2558,46.28616106333073,52.53737628974521,980,1168,83.9041095890411,511,1222,1733,782,409,117,629,1163,5970
Eric Riley,5.0,1994 - 1999,C,186,1844,218,478,45.60669456066946,0,4,0.0,218,474,45.9915611814346,45.60669456066946,138,196,70.40816326530613,180,299,479,60,54,132,126,303,574
Eric Snow,13.0,1996 - 2008,PG,949,25603,2394,5673,42.199894235854046,65,315,20.634920634920633,2329,5358,43.46771183277342,42.772783359774365,1613,2108,76.5180265654649,477,1932,2409,4618,1066,114,1546,2244,6466
Eric Washington,2.0,1998 - 1999,SG,104,2300,274,682,40.17595307917888,81,234,34.61538461538461,193,448,43.080357142857146,46.11436950146627,87,115,75.65217391304347,82,134,216,108,78,43,106,230,716
Eric White,2.0,1988 - 1989,SF,55,788,128,244,52.459016393442624,1,1,100.0,127,243,52.2633744855967,52.66393442622951,79,99,79.7979797979798,65,67,132,26,17,4,47,72,336
Eric Williams,12.0,1996 - 2007,SF,684,16528,1945,4672,41.63099315068493,236,733,32.196452933151434,1709,3939,43.38664635694339,44.15667808219178,1737,2358,73.66412213740458,734,1507,2241,974,582,107,812,1691,5863
Erick Barkley,2.0,2001 - 2002,PG,27,266,32,90,35.55555555555556,4,15,26.666666666666668,28,75,37.333333333333336,37.77777777777778,9,10,90.0,5,16,21,40,19,1,17,31,77
Erick Dampier,16.0,1997 - 2012,C,1048,25326,2896,5802,49.91382281971734,2,18,11.11111111111111,2894,5784,50.03457814661134,49.93105825577387,1802,2899,62.15936529837875,2900,4475,7375,841,354,1458,1494,3088,7596
Erick Green,2.0,2015 - 2016,PG,52,452,66,175,37.714285714285715,15,52,28.846153846153843,51,123,41.46341463414634,42.0,12,14,85.71428571428571,10,27,37,42,13,0,14,30,159
Erick Strickland,9.0,1997 - 2005,SG,521,10390,1355,3465,39.105339105339105,409,1181,34.63166807790009,946,2284,41.41856392294221,45.00721500721501,731,883,82.78595696489242,229,1113,1342,1237,430,42,681,981,3850
Erik Daniels,1.0,2005 - 2005,SF,21,72,6,18,33.33333333333333,1,2,50.0,5,16,31.25,36.11111111111111,0,0,,7,11,18,4,2,0,6,7,13
Erik McCree,1.0,2018 - 2018,SF,4,8,0,2,0.0,0,1,0.0,0,1,0.0,0.0,0,0,,0,1,1,0,1,0,1,0,0
Erik Murphy,1.0,2014 - 2014,C,24,62,3,13,23.076923076923077,0,3,0.0,3,10,30.0,23.076923076923077,0,0,,2,6,8,2,0,4,2,7,6
Ernest Brown,1.0,2002 - 2002,C,3,21,1,6,16.666666666666664,0,0,,1,6,16.666666666666664,16.666666666666664,1,4,25.0,1,5,6,0,0,1,3,4,3
Ersan Ilyasova,11.0,2007 - 2019,PF,778,18562,3064,6944,44.124423963133644,839,2314,36.25756266205705,2225,4630,48.056155507559396,50.165610599078335,1201,1558,77.08600770218229,1405,3137,4542,883,549,282,785,1934,8168
Ervin Johnson,13.0,1994 - 2006,C,922,18571,1497,2981,50.218047635021804,2,10,20.0,1495,2971,50.31975765735442,50.251593425025156,744,1220,60.983606557377044,1827,3789,5616,423,510,1169,765,2649,3740
Esteban Batista,2.0,2006 - 2007,PF,70,576,42,96,43.75,0,1,0.0,42,95,44.21052631578947,43.75,37,60,61.66666666666667,68,106,174,11,18,11,42,124,121
Etan Thomas,9.0,2002 - 2011,C,427,7336,923,1793,51.47796988287786,0,0,,923,1793,51.47796988287786,51.47796988287786,581,967,60.082730093071355,695,1301,1996,152,132,439,401,926,2427
Etdrick Bohannon,4.0,1998 - 2001,PF,26,152,9,21,42.857142857142854,0,0,,9,21,42.857142857142854,42.857142857142854,19,28,67.85714285714286,18,26,44,6,2,10,14,32,37
Eugene Jeter,1.0,2011 - 2011,PG,62,858,106,259,40.92664092664093,6,30,20.0,100,229,43.66812227074236,42.084942084942085,37,41,90.2439024390244,9,61,70,162,29,2,51,54,255
Evan Eschmeyer,4.0,2000 - 2003,C,161,2178,161,348,46.264367816091955,0,0,,161,348,46.264367816091955,46.264367816091955,105,169,62.1301775147929,223,385,608,79,72,97,96,409,427
Evan Fournier,7.0,2013 - 2019,SG,461,12835,2235,5018,44.539657233957755,760,2059,36.911121903836815,1475,2959,49.84792159513349,52.11239537664408,946,1175,80.51063829787233,206,1056,1262,1155,375,44,743,1123,6176
Evan Turner,9.0,2011 - 2019,SF,733,19925,2882,6686,43.10499551301226,290,970,29.896907216494846,2592,5716,45.34639608117565,45.27370625186958,1122,1439,77.97081306462822,416,3069,3485,2550,563,192,1321,1459,7176
Everette Stephens,2.0,1989 - 1991,PG,38,215,25,75,33.33333333333333,2,10,20.0,23,65,35.38461538461539,34.66666666666667,19,24,79.16666666666666,11,12,23,39,9,4,29,22,71
Evers Burns,1.0,1994 - 1994,PF,23,143,22,55,40.0,0,0,,22,55,40.0,40.0,12,23,52.17391304347826,13,17,30,9,6,3,7,33,56
Evric Gray,1.0,1997 - 1997,SF,5,42,4,15,26.666666666666668,1,4,25.0,3,11,27.27272727272727,30.0,4,4,100.0,1,2,3,2,1,0,3,5,13
Fab Melo,1.0,2013 - 2013,C,6,36,3,6,50.0,0,0,,3,6,50.0,50.0,1,4,25.0,0,3,3,0,2,2,1,7,7
Fabricio Oberto,6.0,2006 - 2011,C,382,5673,566,976,57.99180327868852,0,5,0.0,566,971,58.29042224510813,57.99180327868852,143,232,61.63793103448276,504,850,1354,335,104,87,253,844,1275
Fat Lever,11.0,1983 - 1994,PG,800,25255,4471,10052,44.478710704337445,180,567,31.746031746031743,4291,9485,45.239852398523986,45.37405491444489,1907,2472,77.14401294498381,1527,3272,4799,4993,1755,218,1552,1921,11029
Felipe Lopez,4.0,1999 - 2002,SG,256,4230,558,1300,42.92307692307693,50,154,32.467532467532465,508,1146,44.32809773123909,44.84615384615385,303,460,65.8695652173913,217,399,616,258,166,62,257,462,1469
Felton Spencer,12.0,1991 - 2002,C,676,13070,1264,2624,48.170731707317074,0,2,0.0,1264,2622,48.20747520976354,48.170731707317074,1004,1528,65.70680628272252,1400,2225,3625,222,256,576,710,2249,3532
Fennis Dembo,1.0,1989 - 1989,SF,33,78,15,43,34.883720930232556,0,4,0.0,15,39,38.46153846153847,34.883720930232556,8,10,80.0,8,15,23,5,1,0,8,16,38
Fernando Martin,1.0,1987 - 1987,C,25,147,9,32,28.125,0,1,0.0,9,31,29.03225806451613,28.125,4,11,36.36363636363637,8,20,28,9,7,1,20,24,22
Festus Ezeli,3.0,2013 - 2016,C,225,2914,345,668,51.646706586826355,0,0,,345,668,51.646706586826355,51.646706586826355,209,385,54.285714285714285,352,526,878,79,53,190,171,411,899
Forrest McKenzie,1.0,1987 - 1987,SF,6,42,7,28,25.0,1,2,50.0,6,26,23.076923076923077,26.785714285714285,2,2,100.0,2,5,7,1,1,0,3,9,17
Francisco Elson,9.0,2004 - 2012,C,502,7578,761,1579,48.19506016466118,3,17,17.647058823529413,758,1562,48.52752880921895,48.29005699810006,288,412,69.90291262135922,525,1198,1723,266,242,262,380,1068,1813
Francisco Garcia,10.0,2006 - 2015,SF,563,12080,1593,3726,42.7536231884058,599,1671,35.84679832435667,994,2055,48.3698296836983,50.79173376274826,622,779,79.84595635430038,282,1142,1424,757,447,395,549,1258,4407
Frank Brickowski,12.0,1985 - 1997,C,768,16868,2966,5719,51.86221367371918,62,195,31.794871794871792,2904,5524,52.57060101375814,52.40426648015387,1541,2091,73.69679579148732,1037,2495,3532,1423,666,295,1422,2412,7535
Frank Jackson,1.0,2019 - 2019,PG,61,1169,194,447,43.40044742729307,53,169,31.360946745562128,141,278,50.719424460431654,49.328859060402685,54,73,73.97260273972603,25,109,134,69,25,2,48,92,495
Frank Johnson,10.0,1982 - 1994,PG,650,13698,2049,4690,43.68869936034115,61,272,22.426470588235293,1988,4418,44.99773653236759,44.33901918976546,1068,1394,76.61406025824964,329,759,1088,2602,601,36,1114,1203,5227
Frank Kaminsky,4.0,2016 - 2019,C,289,6442,994,2387,41.64222873900293,343,986,34.7870182555781,651,1401,46.466809421841546,48.82697947214076,477,626,76.19808306709265,214,938,1152,460,138,113,243,443,2808
Frank Kornet,2.0,1990 - 1991,PF,91,599,65,177,36.72316384180791,10,39,25.64102564102564,55,138,39.85507246376812,39.548022598870055,31,52,59.61538461538461,35,61,96,30,19,4,35,83,171
Frank Mason,2.0,2018 - 2019,PG,90,1419,215,549,39.162112932604735,45,150,30.0,170,399,42.606516290726816,43.26047358834244,133,172,77.32558139534885,36,137,173,231,50,14,101,106,608
Frank Ntilikina,2.0,2018 - 2019,PG,121,2610,277,782,35.42199488491048,83,272,30.514705882352942,194,510,38.03921568627451,40.728900255754475,72,98,73.46938775510205,49,215,264,371,95,32,187,285,709
Frank Williams,3.0,2003 - 2005,PG,90,1026,98,283,34.62897526501767,28,93,30.107526881720432,70,190,36.84210526315789,39.57597173144876,48,59,81.35593220338984,14,65,79,171,37,11,87,100,272
Frankie King,2.0,1996 - 1997,PG,13,79,10,28,35.714285714285715,1,3,33.33333333333333,9,25,36.0,37.5,6,8,75.0,5,11,16,7,6,0,5,11,27
Frankie Sanders,1.0,1981 - 1981,SF,32,236,43,95,45.26315789473684,1,2,50.0,42,93,45.16129032258064,45.78947368421053,24,26,92.3076923076923,10,16,26,19,19,1,29,28,111
Franklin Edwards,7.0,1982 - 1988,PG,317,4569,763,1696,44.988207547169814,2,34,5.88235294117647,761,1662,45.788206979542714,45.04716981132076,347,435,79.77011494252874,82,232,314,796,257,21,406,355,1875
Fred Cofield,2.0,1986 - 1987,PG,50,496,77,195,39.48717948717949,3,16,18.75,74,179,41.340782122905026,40.256410256410255,12,20,60.0,7,44,51,86,22,3,50,66,169
Fred Hoiberg,10.0,1996 - 2005,SG,565,10456,1003,2325,43.13978494623656,396,991,39.95963673057518,607,1334,45.502248875562216,51.655913978494624,670,783,85.5683269476373,153,1358,1511,872,448,59,300,815,3072
Fred Jones,7.0,2003 - 2009,SG,463,10963,1146,2792,41.04584527220631,372,1040,35.76923076923077,774,1752,44.178082191780824,47.70773638968481,708,873,81.09965635738831,163,871,1034,1034,357,125,543,888,3372
Fred Roberts,13.0,1984 - 1997,PF,885,15766,2405,4795,50.156412930135566,51,162,31.48148148148148,2354,4633,50.80941074897475,50.68821689259645,1508,1898,79.45205479452055,890,1558,2448,1034,435,265,1032,1703,6369
Fred VanVleet,3.0,2017 - 2019,PG,190,3717,536,1304,41.104294478527606,241,619,38.933764135702745,295,685,43.06569343065693,50.34509202453987,206,246,83.73983739837398,50,354,404,602,142,42,176,287,1519
Fred Vinson,2.0,1995 - 2000,SG,13,67,6,24,25.0,3,13,23.076923076923077,3,11,27.27272727272727,31.25,2,3,66.66666666666666,0,1,1,1,3,0,6,6,17
Furkan Aldemir,1.0,2015 - 2015,PF,41,540,40,78,51.28205128205128,0,5,0.0,40,73,54.794520547945204,51.28205128205128,13,27,48.148148148148145,78,98,176,28,17,16,17,96,93
Furkan Korkmaz,2.0,2018 - 2019,SG,63,761,107,274,39.05109489051095,53,162,32.71604938271605,54,112,48.214285714285715,48.722627737226276,38,48,79.16666666666666,18,100,118,56,31,3,27,75,305
Gabe Pruitt,2.0,2008 - 2009,PG,66,472,45,143,31.46853146853147,17,61,27.86885245901639,28,82,34.146341463414636,37.41258741258741,18,23,78.26086956521739,10,41,51,54,20,4,26,44,125
Gal Mekel,2.0,2014 - 2015,PG,35,335,33,106,31.132075471698112,5,23,21.73913043478261,28,83,33.734939759036145,33.490566037735846,8,12,66.66666666666666,5,23,28,76,6,1,33,32,79
Gani Lawal,1.0,2011 - 2011,PF,1,2,0,0,,0,0,,0,0,,,0,0,,0,0,0,0,0,0,0,1,0
Garret Siler,1.0,2011 - 2011,C,21,101,17,31,54.83870967741935,0,0,,17,31,54.83870967741935,54.83870967741935,11,22,50.0,16,12,28,3,1,4,10,20,45
Garrett Temple,9.0,2010 - 2019,SG,534,10477,1083,2655,40.790960451977405,440,1247,35.28468323977546,643,1408,45.66761363636363,49.07721280602637,428,588,72.78911564625851,200,904,1104,837,440,152,484,993,3034
Garry Witts,1.0,1982 - 1982,SF,50,521,51,86,59.30232558139535,1,2,50.0,50,84,59.523809523809526,59.883720930232556,34,42,80.95238095238095,31,34,65,40,18,4,35,80,137
Garth Joseph,1.0,2001 - 2001,C,4,16,1,5,20.0,0,0,,1,5,20.0,20.0,0,2,0.0,2,0,2,1,0,1,2,1,2
Gary Alexander,1.0,1994 - 1994,PF,11,55,8,14,57.14285714285714,0,0,,8,14,57.14285714285714,57.14285714285714,3,9,33.33333333333333,7,8,15,2,3,0,8,10,19
Gary Clark,1.0,2019 - 2019,PF,51,641,50,151,33.11258278145696,41,138,29.71014492753623,9,13,69.23076923076923,46.688741721854306,7,7,100.0,24,92,116,18,20,26,7,47,148
Gary Forbes,2.0,2011 - 2012,SG,112,1506,236,545,43.30275229357798,48,141,34.04255319148936,188,404,46.53465346534654,47.706422018348626,125,178,70.2247191011236,55,164,219,103,47,10,100,133,645
Gary Grant,13.0,1989 - 2001,PG,569,12823,1888,4206,44.88825487398954,98,351,27.92022792022792,1790,3855,46.43320363164721,46.05325725154541,549,708,77.54237288135593,352,945,1297,3062,829,72,1286,1225,4423
Gary Harris,5.0,2015 - 2019,SG,312,8883,1455,3164,45.986093552465235,471,1291,36.48334624322231,984,1873,52.53603844100374,53.429203539823014,497,620,80.16129032258064,201,597,798,661,384,67,399,538,3878
Gary Leonard,3.0,1990 - 1992,C,33,154,19,39,48.717948717948715,0,1,0.0,19,38,50.0,48.717948717948715,10,20,50.0,13,23,36,2,4,10,9,31,48
Gary Neal,7.0,2011 - 2017,SG,397,8329,1401,3335,42.00899550224887,508,1342,37.85394932935917,893,1993,44.80682388359257,49.62518740629685,499,584,85.44520547945206,88,761,849,616,151,12,399,599,3809
Gary Payton,20.0,1991 - 2019,PG,1521,52934,9606,20740,46.31629701060752,1277,4041,31.60108883939619,8329,16699,49.87723815797353,49.39488910318225,3579,4930,72.59634888438133,1554,4348,5902,9815,2674,325,3345,3692,24068
Gary Plummer,2.0,1985 - 1993,PF,126,1439,198,460,43.04347826086957,1,7,14.285714285714285,197,453,43.4878587196468,43.15217391304348,134,187,71.65775401069519,107,200,307,66,29,25,128,268,531
Gary Trent,10.0,1996 - 2019,PF,549,10209,1843,3718,49.569661108122645,9,74,12.162162162162163,1834,3644,50.329308452250274,49.69069392146315,799,1248,64.0224358974359,863,1465,2328,517,226,177,619,1139,4494
Gary Voce,1.0,1990 - 1990,PF,1,4,1,3,33.33333333333333,0,0,,1,3,33.33333333333333,33.33333333333333,0,0,,2,0,2,0,0,0,0,0,2
Gaylon Nickerson,1.0,1997 - 1997,SG,4,42,4,12,33.33333333333333,0,2,0.0,4,10,40.0,33.33333333333333,7,7,100.0,1,4,5,1,1,1,1,1,15
Geert Hammink,3.0,1994 - 1996,C,8,27,4,10,40.0,0,0,,4,10,40.0,40.0,6,9,66.66666666666666,3,4,7,2,0,0,2,4,14
Gene Banks,6.0,1982 - 1987,SF,495,13776,2263,4217,53.6637419966801,2,49,4.081632653061225,2261,4168,54.24664107485605,53.687455537111695,1069,1475,72.47457627118644,1064,1791,2855,1402,452,105,870,1352,5597
Geno Carlisle,1.0,2005 - 2005,SG,6,16,2,3,66.66666666666666,0,0,,2,3,66.66666666666666,66.66666666666666,4,6,66.66666666666666,1,0,1,1,0,0,1,1,8
Geoff Crompton,4.0,1981 - 1984,C,62,407,30,82,36.58536585365854,0,0,,30,82,36.58536585365854,36.58536585365854,13,31,41.935483870967744,41,75,116,23,10,20,31,72,73
George Hill,11.0,2009 - 2019,PG,828,23871,3311,7328,45.18286026200873,1015,2696,37.64836795252226,2296,4632,49.568221070811745,52.108351528384276,1790,2234,80.1253357206804,481,2097,2578,2599,765,237,1079,1759,9427
George King,1.0,2019 - 2019,SF,1,6,0,0,,0,0,,0,0,,,0,0,,0,1,1,0,0,0,0,0,0
George Lynch,12.0,1994 - 2005,SF,836,19194,2250,5051,44.545634527816276,160,533,30.0187617260788,2090,4518,46.259406817175744,46.129479311027524,854,1307,65.34047436878348,1650,2610,4260,1207,884,281,960,1849,5514
George McCloud,12.0,1990 - 2002,SF,780,17771,2518,6248,40.30089628681178,946,2632,35.94224924012158,1572,3616,43.47345132743363,47.87131882202304,1086,1347,80.62360801781738,667,1721,2388,1799,605,193,1088,1695,7068
George Zidek,3.0,1996 - 1998,C,135,1328,161,395,40.75949367088608,1,4,25.0,160,391,40.92071611253197,40.88607594936709,130,166,78.3132530120482,108,178,286,32,14,12,69,241,453
Georges Niang,3.0,2017 - 2019,PF,91,641,99,228,43.42105263157895,44,121,36.36363636363637,55,107,51.4018691588785,53.07017543859649,23,28,82.14285714285714,16,97,113,43,15,6,31,64,265
Georgi Glouchkov,1.0,1986 - 1986,PF,49,772,84,209,40.19138755980861,1,1,100.0,83,208,39.90384615384615,40.430622009569376,70,122,57.377049180327866,31,132,163,32,26,25,76,124,239
Georgios Papagiannis,2.0,2017 - 2018,C,39,477,74,144,51.388888888888886,0,2,0.0,74,142,52.112676056338024,51.388888888888886,12,14,85.71428571428571,37,86,123,29,7,23,32,56,160
Gerald Brown,1.0,1999 - 1999,SG,34,237,34,90,37.77777777777778,3,10,30.0,31,80,38.75,39.44444444444444,11,14,78.57142857142857,5,17,22,31,5,1,22,21,82
Gerald Fitch,1.0,2006 - 2006,PG,18,239,30,89,33.70786516853933,7,26,26.923076923076923,23,63,36.507936507936506,37.640449438202246,17,23,73.91304347826086,7,23,30,33,7,5,15,28,84
Gerald Glass,4.0,1991 - 1996,SF,201,3347,686,1583,43.335439039797855,26,110,23.636363636363637,660,1473,44.806517311608964,44.1566645609602,155,241,64.31535269709543,228,284,512,298,130,58,179,361,1553
Gerald Green,12.0,2006 - 2019,SG,715,13731,2424,5825,41.613733905579394,1026,2837,36.16496298907296,1398,2988,46.787148594377506,50.4206008583691,848,1037,81.77434908389586,330,1410,1740,610,347,209,748,1304,6722
Gerald Madkins,3.0,1994 - 1998,SG,48,420,26,71,36.61971830985916,12,32,37.5,14,39,35.8974358974359,45.07042253521127,16,21,76.19047619047619,3,23,26,65,24,1,29,36,80
Gerald Paddio,3.0,1991 - 1994,SF,138,1655,312,739,42.2192151556157,8,34,23.52941176470588,304,705,43.12056737588652,42.760487144790254,97,130,74.61538461538461,61,126,187,138,40,13,95,105,729
Gerald Wallace,14.0,2002 - 2015,SF,865,25420,3603,7683,46.895743850058565,426,1360,31.323529411764707,3177,6323,50.24513680215088,49.66809839906286,2563,3612,70.9579180509413,1162,3804,4966,1770,1222,698,1520,1888,10195
Gerald Wilkins,13.0,1986 - 1999,SG,955,27770,5046,11225,44.953229398663694,440,1401,31.40613847251963,4606,9824,46.88517915309446,46.91314031180401,1915,2560,74.8046875,1025,1774,2799,2887,959,218,1778,1990,12447
Gerard King,3.0,1999 - 2001,SF,134,1843,237,471,50.318471337579616,0,0,,237,471,50.318471337579616,50.318471337579616,96,129,74.4186046511628,129,268,397,85,50,28,93,240,570
Gheorghe Muresan,6.0,1994 - 2000,C,310,6799,1269,2215,57.29119638826185,0,1,0.0,1269,2214,57.3170731707317,57.29119638826185,497,769,64.62938881664499,660,1315,1975,150,171,459,457,964,3035
Gian Clavell,1.0,2018 - 2018,SG,7,64,6,18,33.33333333333333,6,15,40.0,0,3,0.0,50.0,2,2,100.0,1,6,7,3,2,0,2,8,20
Giannis Antetokounmpo,6.0,2014 - 2019,PF,484,15944,3343,6423,52.047329908142615,228,819,27.83882783882784,3115,5604,55.58529621698787,53.82220146349058,2229,3021,73.78351539225422,778,3232,4010,2005,585,651,1276,1461,9143
Gilbert Arenas,11.0,2002 - 2012,PG,583,20283,3894,9270,42.006472491909385,1125,3228,34.85130111524163,2769,6042,45.8291956305859,48.07443365695793,3019,3766,80.16463090812533,463,1812,2275,3027,921,145,1818,1771,11932
Glen Davis,8.0,2008 - 2015,PF,610,12678,1872,4158,45.02164502164502,10,61,16.39344262295082,1862,4097,45.447888699048086,45.14189514189514,1022,1455,70.24054982817869,868,1722,2590,523,413,208,614,1466,4776
Glen Rice,17.0,1990 - 2015,SF,1071,37174,7112,15662,45.40927084663517,1636,4116,39.74732750242954,5476,11546,47.42768058201975,50.63210317967054,3403,4026,84.52558370591157,990,3670,4660,2207,1009,278,1833,2512,19263
Glenn Hagan,1.0,1982 - 1982,PG,4,25,3,7,42.857142857142854,0,0,,3,7,42.857142857142854,42.857142857142854,1,1,100.0,2,2,4,8,3,0,1,7,7
Glenn Robinson,16.0,1995 - 2019,SF,955,29629,6147,13454,45.68901441950349,755,2189,34.49063499314756,5392,11265,47.865068797159346,48.49487141370596,2704,3313,81.61786900090551,1171,3666,4837,2081,942,466,2313,2093,15753
God Shammgod,1.0,1998 - 1998,PG,20,146,19,58,32.758620689655174,0,2,0.0,19,56,33.92857142857143,32.758620689655174,23,30,76.66666666666667,2,5,7,36,7,1,21,27,61
Goran Dragic,11.0,2009 - 2019,PG,793,22101,4017,8645,46.46616541353383,904,2498,36.188951160928745,3113,6147,50.642589881242884,51.694621168305375,1929,2533,76.15475720489539,584,1842,2426,3761,786,145,1767,1851,10867
Gordan Giricek,6.0,2003 - 2008,SG,413,9434,1494,3390,44.07079646017699,309,831,37.18411552346571,1185,2559,46.307151230949586,48.6283185840708,560,679,82.4742268041237,175,823,998,610,229,50,555,816,3857
Gordon Hayward,9.0,2011 - 2019,SF,604,18566,3107,6987,44.46829826821239,795,2185,36.38443935926773,2312,4802,48.14660558100791,50.15743523686847,2189,2651,82.57261410788381,437,2113,2550,2055,602,241,1191,1055,9198
Gorgui Dieng,6.0,2014 - 2019,C,457,10318,1393,2762,50.434467776973214,64,192,33.33333333333333,1329,2570,51.71206225680935,51.59304851556843,761,964,78.94190871369294,861,1969,2830,633,378,451,544,1056,3611
Grant Gondrezick,2.0,1987 - 1989,SG,91,1080,173,395,43.79746835443038,7,28,25.0,166,367,45.23160762942779,44.68354430379747,101,147,68.70748299319727,62,84,146,115,38,5,73,127,454
Grant Hill,18.0,1995 - 2013,SF,1065,36008,6545,13552,48.29545454545455,224,718,31.197771587743734,6321,12834,49.25198690977092,49.12190082644628,4346,5649,76.933970614268,1219,5188,6407,4392,1283,595,2538,2485,17660
Grant Jerrett,1.0,2015 - 2015,PF,8,51,7,26,26.923076923076923,1,15,6.666666666666667,6,11,54.54545454545454,28.846153846153843,1,1,100.0,2,7,9,3,2,2,3,11,16
Grant Long,15.0,1989 - 2003,PF,1045,29694,3604,7761,46.43731477902332,90,328,27.439024390243905,3514,7433,47.27566258576618,47.01713696688571,2593,3407,76.1080129145876,2263,4134,6397,1775,1240,376,1694,3061,9891
Granville Waiters,5.0,1984 - 1988,C,262,2581,274,596,45.97315436241611,0,5,0.0,274,591,46.36209813874789,45.97315436241611,66,118,55.932203389830505,185,361,546,121,57,189,154,414,614
Grayson Allen,1.0,2019 - 2019,SG,38,416,67,178,37.640449438202246,32,99,32.323232323232325,35,79,44.303797468354425,46.62921348314607,45,60,75.0,3,20,23,25,6,6,33,47,211
Greg Anderson,10.0,1988 - 1998,PF,697,14313,2042,4155,49.14560770156438,2,23,8.695652173913043,2040,4132,49.37076476282672,49.16967509025271,944,1699,55.56209535020601,1447,2868,4315,390,487,602,945,1785,5030
Greg Anthony,11.0,1992 - 2002,PG,859,17447,2068,5175,39.96135265700483,667,1942,34.34603501544799,1401,3233,43.334364367460566,46.405797101449274,1149,1585,72.49211356466877,299,1242,1541,3231,969,97,1137,1531,5952
Greg Buckner,10.0,2000 - 2009,SG,608,11468,1180,2650,44.528301886792455,254,774,32.81653746770026,926,1876,49.36034115138593,49.32075471698113,421,555,75.85585585585586,487,1206,1693,742,470,117,408,1420,3035
Greg Butler,3.0,1989 - 1991,C,55,210,28,79,35.44303797468354,0,3,0.0,28,76,36.84210526315789,35.44303797468354,20,28,71.42857142857143,20,33,53,4,1,2,24,45,76
Greg Dreiling,10.0,1987 - 1997,C,483,4330,381,821,46.406820950060904,4,10,40.0,377,811,46.48581997533909,46.65042630937881,265,408,64.95098039215686,295,743,1038,186,82,137,253,945,1031
Greg Foster,13.0,1991 - 2003,PF,723,8840,1141,2603,43.83403764886669,25,104,24.03846153846154,1116,2499,44.657863145258105,44.314252785247795,464,618,75.08090614886731,552,1295,1847,371,102,209,505,1371,2771
Greg Graham,5.0,1994 - 1998,SG,213,2573,335,827,40.507859733978236,50,173,28.901734104046245,285,654,43.57798165137615,43.53083434099154,230,297,77.44107744107744,59,165,224,207,130,12,180,218,950
Greg Grant,6.0,1990 - 1996,PG,284,3417,323,846,38.17966903073286,42,150,28.000000000000004,281,696,40.37356321839081,40.66193853427896,100,140,71.42857142857143,69,188,257,766,164,8,236,289,788
Greg Kite,12.0,1984 - 1995,C,741,10457,737,1687,43.68701837581506,1,6,16.666666666666664,736,1681,43.78346222486615,43.71665678719621,299,608,49.17763157894737,936,1768,2704,362,177,427,560,1683,1774
Greg Minor,5.0,1995 - 1999,SG,281,5181,799,1675,47.701492537313435,24,106,22.641509433962266,775,1569,49.39451880178458,48.417910447761194,291,379,76.78100263852242,259,483,742,386,157,47,226,467,1913
Greg Monroe,9.0,2011 - 2019,C,649,17721,3385,6588,51.381299332119,1,17,5.88235294117647,3384,6571,51.49901080505251,51.388888888888886,1687,2390,70.58577405857741,1800,3508,5308,1369,682,368,1211,1436,8458
Greg Oden,3.0,2009 - 2014,C,114,2131,328,573,57.24258289703316,0,0,,328,573,57.24258289703316,57.24258289703316,214,325,65.84615384615384,267,416,683,52,43,135,146,403,870
Greg Ostertag,11.0,1996 - 2006,C,845,16521,1478,3056,48.36387434554974,1,10,10.0,1477,3046,48.48982271831911,48.38023560209424,927,1629,56.9060773480663,1655,2972,4627,474,218,1458,752,2120,3884
Greg Smith,5.0,2012 - 2016,C,155,1894,249,403,61.78660049627791,0,1,0.0,249,402,61.940298507462686,61.78660049627791,116,203,57.14285714285714,172,330,502,41,34,61,69,299,614
Greg Stiemsma,4.0,2012 - 2015,C,223,3193,283,549,51.54826958105647,0,1,0.0,283,548,51.64233576642335,51.54826958105647,108,154,70.12987012987013,199,521,720,102,122,243,147,538,674
Greg Stokes,2.0,1986 - 1990,PF,49,474,65,156,41.66666666666667,0,1,0.0,65,155,41.935483870967744,41.66666666666667,27,36,75.0,35,40,75,21,16,17,26,76,157
Greg Sutton,3.0,1992 - 1996,PG,173,1984,274,700,39.14285714285714,116,328,35.36585365853659,158,372,42.473118279569896,47.42857142857143,104,139,74.82014388489209,25,133,158,289,85,14,184,321,768
Greivis Vasquez,7.0,2011 - 2017,PG,425,9953,1437,3431,41.88283299329642,431,1232,34.98376623376623,1006,2199,45.74806730331969,48.163800641212475,443,543,81.58379373848987,131,942,1073,2008,247,37,776,815,3748
Guerschon Yabusele,2.0,2018 - 2019,PF,86,534,62,147,42.17687074829932,21,71,29.577464788732392,41,76,53.94736842105263,49.31972789115646,32,49,65.3061224489796,43,73,116,34,14,12,27,64,177
Guillermo Diaz,1.0,2008 - 2008,SG,6,18,1,4,25.0,0,1,0.0,1,3,33.33333333333333,25.0,3,5,60.0,2,0,2,1,0,0,0,0,5
Gundars Vetra,1.0,1993 - 1993,SF,13,89,19,40,47.5,3,3,100.0,16,37,43.24324324324324,51.24999999999999,4,6,66.66666666666666,4,4,8,6,2,0,2,12,45
Gustavo Ayon,3.0,2012 - 2014,C,138,2258,286,534,53.558052434456926,0,1,0.0,286,533,53.65853658536586,53.558052434456926,67,133,50.37593984962406,188,401,589,173,100,73,122,272,639
Guy Morgan,1.0,1983 - 1983,SG,8,46,7,24,29.166666666666668,0,0,,7,24,29.166666666666668,29.166666666666668,1,4,25.0,6,11,17,7,2,0,2,7,15
Guy Rucker,1.0,2003 - 2003,PF,3,4,0,0,,0,0,,0,0,,,0,0,,0,1,1,1,0,0,0,1,0
Guy Williams,2.0,1985 - 1986,SF,26,144,31,68,45.588235294117645,1,4,25.0,30,64,46.875,46.32352941176471,5,11,45.45454545454545,15,18,33,9,6,4,8,24,68
Ha Seung-Jin,2.0,2005 - 2006,C,46,316,28,54,51.85185185185185,0,0,,28,54,51.85185185185185,51.85185185185185,14,28,50.0,20,47,67,3,4,13,26,62,70
Hakeem Olajuwon,18.0,1985 - 2002,C,1383,49971,12253,23838,51.40112425539055,29,142,20.422535211267608,12224,23696,51.58676569885212,51.461951505998826,6166,8655,71.2420566146736,4505,10864,15369,3516,2407,4302,4091,4945,30701
Hakim Warrick,8.0,2006 - 2013,PF,532,10698,1782,3654,48.76847290640394,21,112,18.75,1761,3542,49.71767363071711,49.05582922824302,1391,1912,72.7510460251046,696,1433,2129,400,219,154,630,979,4976
Hamady N'Diaye,3.0,2011 - 2014,C,33,157,7,15,46.666666666666664,0,0,,7,15,46.666666666666664,46.666666666666664,6,13,46.15384615384615,7,18,25,3,2,9,6,33,20
Hamed Haddadi,5.0,2009 - 2013,C,164,1108,135,293,46.075085324232084,0,6,0.0,135,287,47.038327526132406,46.075085324232084,85,133,63.90977443609023,145,244,389,44,11,99,95,221,355
Hamidou Diallo,1.0,2019 - 2019,SG,51,526,75,165,45.45454545454545,4,24,16.666666666666664,71,141,50.35460992907801,46.666666666666664,36,59,61.016949152542374,38,59,97,17,21,10,23,77,190
Hank McDowell,6.0,1982 - 1987,PF,221,1894,231,516,44.76744186046512,0,7,0.0,231,509,45.383104125736736,44.76744186046512,147,208,70.67307692307693,190,284,474,102,34,29,133,282,609
Hanno Mottola,2.0,2001 - 2002,SF,155,2360,292,661,44.175491679273826,1,16,6.25,291,645,45.11627906976744,44.251134644478064,130,166,78.3132530120482,130,312,442,75,31,28,137,337,715
Harold Ellis,3.0,1994 - 1998,SF,145,1923,312,592,52.702702702702695,1,21,4.761904761904762,311,571,54.46584938704028,52.78716216216216,215,329,65.34954407294833,177,114,291,89,159,18,111,252,840
Harold Jamison,2.0,2000 - 2002,PF,37,250,29,63,46.03174603174603,0,0,,29,63,46.03174603174603,46.03174603174603,14,33,42.42424242424242,40,20,60,10,7,2,10,40,72
Harold Keeling,1.0,1986 - 1986,SG,21,76,17,39,43.58974358974359,0,0,,17,39,43.58974358974359,43.58974358974359,10,14,71.42857142857143,3,3,6,10,7,0,7,9,44
Harold Miner,4.0,1993 - 1996,SG,204,3805,704,1530,46.01307189542484,23,74,31.08108108108108,681,1456,46.77197802197802,46.76470588235294,402,513,78.3625730994152,194,246,440,247,81,27,280,374,1833
Harold Pressley,4.0,1987 - 1990,SF,299,6802,1075,2458,43.734743694060214,208,581,35.800344234079176,867,1877,46.19072988811934,47.96582587469487,344,442,77.82805429864254,517,822,1339,628,275,188,410,670,2702
Harrison Barnes,7.0,2013 - 2019,SF,604,18633,2986,6734,44.34214434214434,733,1971,37.1892440385591,2253,4763,47.30212051228217,49.784674784674785,1304,1646,79.22235722964763,637,2335,2972,915,425,128,692,1061,8009
Harry Giles,1.0,2019 - 2019,PF,58,820,175,348,50.287356321839084,0,6,0.0,175,342,51.16959064327485,50.287356321839084,58,91,63.73626373626373,66,156,222,85,31,22,73,150,408
Harvey Grant,11.0,1989 - 1999,PF,802,20923,3390,7241,46.81673801961055,71,260,27.307692307692307,3319,6981,47.543331900873795,47.30700179533214,1036,1468,70.57220708446866,1184,2305,3489,1232,603,437,722,1798,7887
Hasheem Thabeet,5.0,2010 - 2014,C,230,2390,183,323,56.656346749226,0,0,,183,323,56.656346749226,56.656346749226,119,206,57.76699029126213,204,397,601,27,60,184,125,464,485
Hassan Adams,2.0,2007 - 2009,SG,79,556,80,150,53.333333333333336,0,1,0.0,80,149,53.691275167785236,53.333333333333336,27,42,64.28571428571429,36,49,85,14,18,5,26,54,187
Hassan Whiteside,7.0,2011 - 2019,C,358,9297,1966,3416,57.55269320843092,4,18,22.22222222222222,1962,3398,57.739846968805175,57.61124121779859,793,1337,59.31189229618548,1159,2889,4048,207,222,832,568,943,4729
Hawkeye Whitney,2.0,1981 - 1982,SG,70,1048,174,377,46.15384615384615,2,7,28.57142857142857,172,370,46.48648648648649,46.41909814323608,54,72,75.0,42,104,146,87,59,7,62,129,404
Haywood Highsmith,1.0,2019 - 2019,SF,5,40,4,10,40.0,1,5,20.0,3,5,60.0,45.0,0,2,0.0,0,5,5,2,1,0,1,1,9
Haywoode Workman,8.0,1990 - 2000,PG,400,8094,828,2011,41.17354549975137,130,415,31.32530120481928,698,1596,43.734335839599,44.405768274490306,418,539,77.55102040816327,168,736,904,1576,398,22,601,781,2204
Hedo Turkoglu,15.0,2001 - 2015,SF,1106,29680,4229,9973,42.40449212874762,1347,3542,38.02936194240542,2882,6431,44.81418130928316,49.15772585982152,2276,2914,78.10569663692519,712,3675,4387,3119,831,331,1758,2687,12081
Henry Ellenson,3.0,2017 - 2019,PF,76,734,115,305,37.704918032786885,47,133,35.338345864661655,68,172,39.53488372093023,45.40983606557377,48,62,77.41935483870968,23,165,188,43,13,3,41,55,325
Henry James,7.0,1991 - 1998,PF,228,2770,476,1162,40.963855421686745,154,411,37.469586374695865,322,751,42.876165113182424,47.59036144578313,198,246,80.48780487804879,108,213,321,91,50,18,139,320,1304
Henry Sims,4.0,2013 - 2016,C,135,2542,403,856,47.07943925233645,4,23,17.391304347826086,399,833,47.89915966386555,47.31308411214953,221,288,76.73611111111111,248,422,670,140,76,64,153,289,1031
Henry Turner,2.0,1990 - 1995,PF,66,464,81,179,45.2513966480447,2,8,25.0,79,171,46.198830409356724,45.81005586592179,60,100,60.0,39,39,78,29,25,8,38,60,224
Henry Walker,5.0,2009 - 2015,SG,189,3115,395,897,44.03567447045708,193,526,36.69201520912547,202,371,54.44743935309974,54.793756967670014,121,159,76.10062893081762,60,354,414,157,100,27,151,386,1104
Herb Williams,18.0,1982 - 1999,C,1159,29022,5098,10911,46.723490055906886,8,84,9.523809523809524,5090,10827,47.01209938117669,46.760150307029605,1893,2717,69.67243283032757,1649,4938,6587,1873,615,1630,1954,2959,12097
Hersey Hawkins,13.0,1989 - 2001,SG,1057,34563,5215,11328,46.03637005649718,1325,3358,39.45801072066706,3890,7970,48.80803011292346,51.8847104519774,3758,4307,87.25330856744834,899,2941,3840,3055,1741,331,1950,2231,15513
Hilton Armstrong,6.0,2007 - 2014,C,319,3555,366,732,50.0,2,8,25.0,364,724,50.27624309392266,50.13661202185792,195,344,56.68604651162791,311,497,808,106,97,151,246,584,929
Hiram Fuller,1.0,2004 - 2004,PF,4,43,3,8,37.5,0,0,,3,8,37.5,37.5,2,6,33.33333333333333,4,7,11,2,0,1,4,5,8
Hollis Thompson,4.0,2014 - 2017,SG,265,6424,742,1795,41.33704735376045,363,941,38.5759829968119,379,854,44.37939110070258,51.448467966573816,203,287,70.73170731707317,199,630,829,292,166,68,213,541,2050
Horace Grant,17.0,1988 - 2004,PF,1335,44793,6225,12178,51.11676794219083,5,71,7.042253521126761,6220,12107,51.375237465928805,51.13729676465758,2448,3521,69.52570292530531,4016,6884,10900,2935,1314,1309,1487,3347,14903
Horace Jenkins,1.0,2005 - 2005,PG,15,104,15,45,33.33333333333333,0,9,0.0,15,36,41.66666666666667,33.33333333333333,12,13,92.3076923076923,3,6,9,9,5,1,7,6,42
Horacio Llamas Grey,2.0,1997 - 1998,C,28,143,23,49,46.93877551020408,1,3,33.33333333333333,22,46,47.82608695652174,47.95918367346938,11,18,61.111111111111114,8,28,36,5,11,8,20,39,58
Hot Rod Williams,13.0,1987 - 1999,C,944,27996,3918,8161,48.00882244822938,2,20,10.0,3916,8141,48.10219874708267,48.02107584854797,2567,3538,72.5551158846806,2192,4164,6356,1692,793,1526,1293,2433,10405
Howard Carter,2.0,1984 - 1985,SG,71,814,156,361,43.21329639889196,6,27,22.22222222222222,150,334,44.91017964071856,44.04432132963989,48,62,77.41935483870968,40,54,94,80,24,5,55,88,366
Howard Eisley,12.0,1995 - 2006,PG,874,17433,2043,5039,40.54375868227823,560,1598,35.04380475594493,1483,3441,43.097936646323745,46.100416749355034,931,1118,83.2737030411449,225,1229,1454,2981,576,95,1277,1868,5577
Howard Nathan,1.0,1996 - 1996,PG,5,15,5,9,55.55555555555556,0,1,0.0,5,8,62.5,55.55555555555556,3,4,75.0,0,0,0,2,3,0,8,2,13
Howard Wood,1.0,1982 - 1982,SF,42,342,55,120,45.83333333333333,0,1,0.0,55,119,46.21848739495798,45.83333333333333,34,52,65.38461538461539,22,43,65,9,8,6,15,37,144
Howard Wright,2.0,1991 - 1993,PF,19,174,23,52,44.230769230769226,0,1,0.0,23,51,45.09803921568628,44.230769230769226,16,26,61.53846153846154,13,34,47,3,4,5,11,28,62
Hubert Davis,12.0,1993 - 2004,SG,734,15964,2200,4825,45.59585492227979,759,1734,43.77162629757785,1441,3091,46.619217081850536,53.461139896373055,675,811,83.23057953144266,219,872,1091,1216,309,52,694,1094,5834
Hutch Jones,2.0,1983 - 1984,SF,13,103,17,40,42.5,0,0,,17,40,42.5,42.5,7,10,70.0,10,7,17,4,4,0,8,14,41
Ian Clark,6.0,2014 - 2019,SG,371,5070,812,1833,44.29896344789962,269,787,34.18043202033037,543,1046,51.91204588910134,51.6366612111293,192,235,81.70212765957446,73,420,493,423,150,46,265,449,2085
Ian Lockhart,1.0,1991 - 1991,SF,1,2,1,1,100.0,0,0,,1,1,100.0,100.0,2,2,100.0,0,0,0,0,0,0,0,0,4
Ian Mahinmi,11.0,2008 - 2019,C,647,10345,1174,2190,53.60730593607306,3,24,12.5,1171,2166,54.06278855032317,53.67579908675799,791,1293,61.17556071152359,932,1726,2658,327,345,449,599,1671,3142
Ibo Kutluay,1.0,2005 - 2005,SG,5,12,0,1,0.0,0,0,,0,1,0.0,0.0,0,0,,0,1,1,0,0,0,2,1,0
Igor Rakocevic,1.0,2003 - 2003,PG,42,244,22,58,37.93103448275862,5,12,41.66666666666667,17,46,36.95652173913043,42.241379310344826,29,36,80.55555555555556,4,13,17,33,4,0,23,25,78
Ike Anigbogu,2.0,2018 - 2019,C,14,36,4,12,33.33333333333333,0,0,,4,12,33.33333333333333,33.33333333333333,5,6,83.33333333333334,6,6,12,1,1,4,3,1,13
Ike Diogu,6.0,2006 - 2012,PF,225,2795,488,958,50.939457202505224,1,2,50.0,487,956,50.94142259414226,50.99164926931107,371,472,78.60169491525424,275,414,689,69,36,65,200,425,1348
Iman Shumpert,8.0,2012 - 2019,SG,517,12911,1353,3448,39.24013921113689,555,1610,34.47204968944099,798,1838,43.41675734494015,47.28828306264501,440,574,76.65505226480836,371,1393,1764,905,560,143,566,1193,3701
Ime Udoka,7.0,2004 - 2011,SF,337,6051,654,1562,41.86939820742638,235,660,35.60606060606061,419,902,46.45232815964523,49.39180537772087,196,280,70.0,234,762,996,329,223,57,234,567,1739
Ira Bowman,3.0,2000 - 2002,SG,24,79,7,13,53.84615384615385,0,2,0.0,7,11,63.63636363636363,53.84615384615385,1,4,25.0,1,4,5,11,3,0,2,3,15
Ira Newble,8.0,2001 - 2008,SF,392,7667,785,1758,44.653014789533565,86,252,34.12698412698413,699,1506,46.41434262948207,47.098976109215016,281,361,77.8393351800554,404,713,1117,343,205,105,290,699,1937
Irving Thomas,1.0,1991 - 1991,PF,29,113,18,51,35.294117647058826,0,0,,18,51,35.294117647058826,35.294117647058826,12,21,57.14285714285714,14,17,31,10,4,1,13,24,48
Isaac Austin,9.0,1992 - 2002,C,452,8752,1341,3007,44.595942800133024,10,57,17.543859649122805,1331,2950,45.11864406779661,44.762221483205856,719,1067,67.38519212746017,640,1473,2113,552,224,237,731,1017,3411
Isaac Bonga,1.0,2019 - 2019,PG,22,120,5,33,15.151515151515152,0,8,0.0,5,25,20.0,15.151515151515152,9,15,60.0,9,16,25,15,9,4,6,9,19
Isaac Fontaine,1.0,2002 - 2002,SG,6,75,3,14,21.428571428571427,1,5,20.0,2,9,22.22222222222222,25.0,4,6,66.66666666666666,0,5,5,4,0,0,4,6,11
Isaac Humphries,1.0,2019 - 2019,C,5,56,6,21,28.57142857142857,3,11,27.27272727272727,3,10,30.0,35.714285714285715,0,0,,4,7,11,0,1,0,0,7,15
Isaiah Briscoe,1.0,2019 - 2019,PG,39,559,55,138,39.85507246376812,11,34,32.35294117647059,44,104,42.30769230769231,43.84057971014493,15,26,57.692307692307686,5,69,74,87,11,2,31,66,136
Isaiah Canaan,6.0,2014 - 2019,PG,238,4894,629,1687,37.285121517486665,371,1056,35.13257575757576,258,631,40.88748019017432,48.2809721398933,319,383,83.28981723237598,63,379,442,458,148,23,264,370,1948
Isaiah Hartenstein,1.0,2019 - 2019,PF,28,221,20,41,48.78048780487805,2,6,33.33333333333333,18,35,51.42857142857142,51.21951219512195,11,14,78.57142857142857,21,26,47,15,7,12,13,56,53
Isaiah Hicks,2.0,2018 - 2019,PF,21,272,37,80,46.25,2,9,22.22222222222222,35,71,49.29577464788733,47.5,16,23,69.56521739130434,12,36,48,18,3,7,17,50,92
Isaiah Morris,1.0,1993 - 1993,SF,25,102,26,57,45.614035087719294,0,0,,26,57,45.614035087719294,45.614035087719294,3,4,75.0,6,6,12,4,3,1,8,14,55
Isaiah Rider,9.0,1994 - 2002,SG,584,18604,3697,8358,44.2330701124671,685,1949,35.14622883530015,3012,6409,46.99641129661414,48.330940416367554,1670,2049,81.50317227916057,701,1543,2244,1600,386,136,1486,1379,9749
Isaiah Taylor,2.0,2017 - 2018,PG,74,1229,164,399,41.10275689223057,20,83,24.096385542168676,144,316,45.56962025316456,43.609022556390975,100,143,69.93006993006993,24,75,99,210,35,11,84,123,448
Isaiah Thomas,8.0,2012 - 2019,PG,510,15117,3093,7105,43.532723434201266,985,2764,35.63675832127352,2108,4341,48.56023957613453,50.464461646727656,2413,2768,87.17485549132948,276,1021,1297,2611,471,57,1222,1095,9584
Isaiah Whitehead,2.0,2017 - 2018,PG,89,1823,244,594,41.07744107744108,51,167,30.538922155688624,193,427,45.19906323185012,45.370370370370374,104,132,78.78787878787878,36,174,210,212,50,38,166,198,643
Ish Smith,9.0,2011 - 2019,PG,552,10544,1714,4013,42.711188636929975,196,640,30.625000000000004,1518,3373,45.00444707975097,45.15325193122352,400,590,67.79661016949152,186,1099,1285,2054,381,121,685,705,4024
Isiah Thomas,13.0,1982 - 1994,PG,1090,39732,8019,17773,45.119000731446576,479,1607,29.807093963907903,7540,16166,46.641098602004206,46.466550385416085,4566,6005,76.03663613655287,1085,2917,4002,10048,2095,287,4051,3334,21083
Ivan Johnson,2.0,2012 - 2013,PF,136,2131,343,673,50.965824665676074,3,20,15.0,340,653,52.06738131699847,51.18870728083209,168,254,66.14173228346458,157,372,529,81,106,35,149,277,857
Ivan McFarlin,1.0,2007 - 2007,PF,11,41,5,13,38.46153846153847,0,1,0.0,5,12,41.66666666666667,38.46153846153847,5,7,71.42857142857143,7,4,11,1,0,0,1,8,15
Ivan Rabb,2.0,2018 - 2019,PF,85,1237,202,364,55.494505494505496,3,15,20.0,199,349,57.02005730659025,55.90659340659341,78,105,74.28571428571429,123,241,364,86,29,27,70,145,485
Ivano Newbill,3.0,1995 - 1998,PF,137,1435,76,193,39.37823834196891,1,1,100.0,75,192,39.0625,39.637305699481864,45,104,43.269230769230774,140,215,355,51,50,29,72,215,198
Ivica Zubac,3.0,2017 - 2019,C,140,2059,399,739,53.99188092016238,0,4,0.0,399,735,54.285714285714285,53.99188092016238,172,226,76.10619469026548,201,443,644,118,36,99,126,250,970
J.J. Anderson,3.0,1983 - 1985,SF,162,1983,311,666,46.6966966966967,1,10,10.0,310,656,47.256097560975604,46.77177177177177,139,249,55.82329317269076,189,254,443,110,107,40,131,253,762
J.J. Barea,13.0,2007 - 2019,PG,851,16816,2904,6853,42.375601926163725,819,2347,34.89561141883255,2085,4506,46.27163781624501,48.35108711513206,956,1212,78.87788778877888,263,1533,1796,3336,341,23,1290,1221,7583
J.J. Hickson,8.0,2009 - 2016,C,545,12004,2063,4078,50.588523786169695,0,21,0.0,2063,4057,50.85038205570619,50.588523786169695,994,1609,61.777501553760096,1174,2474,3648,450,274,309,780,1042,5120
J.J. O'Brien,1.0,2016 - 2016,SF,2,6,0,1,0.0,0,0,,0,1,0.0,0.0,0,0,,0,1,1,0,1,0,0,1,0
J.J. Redick,13.0,2007 - 2019,SG,934,24194,3968,8907,44.54923094195576,1857,4551,40.80421885299934,2111,4356,48.461891643709826,54.97361625687661,2026,2277,88.97672375933246,172,1670,1842,1851,442,84,1044,1451,11819
J.P. Macura,1.0,2019 - 2019,SG,2,17,3,9,33.33333333333333,0,4,0.0,3,5,60.0,33.33333333333333,0,0,,0,3,3,2,0,0,0,0,6
J.R. Bremer,2.0,2003 - 2004,PG,110,2093,230,678,33.92330383480826,128,392,32.6530612244898,102,286,35.66433566433567,43.36283185840708,105,139,75.53956834532374,27,169,196,227,59,7,91,124,693
J.R. Giddens,2.0,2009 - 2010,SF,38,247,30,63,47.61904761904761,0,10,0.0,30,53,56.60377358490566,47.61904761904761,13,23,56.52173913043478,18,36,54,13,10,2,18,30,73
J.R. Henderson,1.0,1999 - 1999,SF,30,331,35,96,36.45833333333333,2,5,40.0,33,91,36.26373626373626,37.5,25,45,55.55555555555556,20,27,47,22,9,4,18,29,97
J.R. Reid,11.0,1990 - 2001,PF,719,16154,2254,4791,47.046545606345234,5,40,12.5,2249,4751,47.337402652073244,47.098726779378005,1416,1966,72.02441505595118,1053,2495,3548,672,537,285,990,2112,5929
J.R. Smith,15.0,2005 - 2019,SG,1101,30030,4885,11723,41.67022093320823,2217,5946,37.28557013118062,2668,5777,46.18314003808205,51.1259916403651,1617,2216,72.96931407942239,552,2937,3489,2258,1098,242,1447,2530,13604
JaJuan Johnson,1.0,2012 - 2012,PF,36,298,54,121,44.62809917355372,0,0,,54,121,44.62809917355372,44.62809917355372,6,9,66.66666666666666,20,38,58,6,5,14,14,25,114
JaKarr Sampson,4.0,2015 - 2019,SF,173,2762,359,798,44.987468671679196,55,214,25.70093457943925,304,584,52.054794520547944,48.43358395989975,170,253,67.19367588932806,107,356,463,136,73,84,158,333,943
JaMychal Green,5.0,2015 - 2019,PF,314,6822,989,2066,47.8702807357212,191,517,36.94390715667311,798,1549,51.51710781149128,52.49273959341723,413,537,76.90875232774674,584,1289,1873,289,179,137,362,842,2582
JaVale McGee,11.0,2009 - 2019,C,677,11616,2291,4007,57.174943848265535,2,28,7.142857142857142,2289,3979,57.527016838401615,57.199900174694285,775,1323,58.57898715041572,1267,2143,3410,253,265,1037,644,1454,5359
Jabari Bird,1.0,2018 - 2018,SG,13,115,15,26,57.692307692307686,3,7,42.857142857142854,12,19,63.1578947368421,63.46153846153846,6,13,46.15384615384615,6,13,19,8,3,1,8,7,39
Jabari Brown,1.0,2015 - 2015,SG,19,568,70,170,41.17647058823529,23,62,37.096774193548384,47,108,43.51851851851852,47.94117647058824,64,85,75.29411764705883,3,33,36,40,12,2,32,33,227
Jabari Parker,5.0,2015 - 2019,PF,254,7508,1528,3119,48.990060916960566,176,524,33.587786259541986,1352,2595,52.100192678227366,51.811478037832636,562,763,73.65661861074705,381,1081,1462,535,228,100,458,517,3794
Jabari Smith,4.0,2001 - 2005,C,115,1077,126,305,41.31147540983607,1,8,12.5,125,297,42.08754208754209,41.47540983606557,81,117,69.23076923076923,50,131,181,66,37,27,54,170,334
Jack Cooley,2.0,2015 - 2018,PF,23,174,22,49,44.89795918367347,0,0,,22,49,44.89795918367347,44.89795918367347,23,40,57.49999999999999,24,31,55,7,7,3,6,36,67
Jack Haley,9.0,1989 - 1998,PF,355,3331,442,1044,42.337164750957854,0,3,0.0,442,1041,42.45917387127761,42.337164750957854,319,486,65.63786008230453,346,591,937,86,60,49,217,584,1203
Jackie Butler,3.0,2005 - 2007,C,69,848,137,254,53.937007874015755,0,0,,137,254,53.937007874015755,53.937007874015755,69,89,77.52808988764045,73,132,205,30,20,31,73,143,343
Jackson Vroman,2.0,2005 - 2006,C-PF,87,1111,108,265,40.75471698113208,0,3,0.0,108,262,41.221374045801525,40.75471698113208,69,119,57.98319327731093,97,164,261,51,37,30,85,183,285
Jacky Dorsey,1.0,1981 - 1981,SF,29,253,20,70,28.57142857142857,0,0,,20,70,28.57142857142857,28.57142857142857,13,25,52.0,23,65,88,9,9,1,14,47,53
Jacob Evans,1.0,2019 - 2019,SG,30,204,18,53,33.9622641509434,4,15,26.666666666666668,14,38,36.84210526315789,37.735849056603776,0,1,0.0,6,19,25,23,5,3,11,28,40
Jacob Pullen,1.0,2018 - 2018,PG,3,6,1,2,50.0,0,1,0.0,1,1,100.0,50.0,0,0,,0,0,0,0,0,0,1,0,2
Jacob Wiley,1.0,2018 - 2018,PF,5,33,1,4,25.0,1,2,50.0,0,2,0.0,37.5,1,2,50.0,2,9,11,2,1,0,0,4,4
Jacque Vaughn,12.0,1998 - 2009,PG,851,13422,1366,3221,42.40918969264204,99,280,35.35714285714286,1267,2941,43.08058483509011,43.945979509469105,797,1028,77.52918287937743,159,921,1080,2021,420,18,837,1369,3628
Jae Crowder,7.0,2013 - 2019,SF,589,14450,1947,4636,41.99741156169111,805,2383,33.780948384389426,1142,2253,50.68797159343098,50.679465056082826,912,1176,77.55102040816327,431,1932,2363,860,570,188,502,1202,5611
Jahidi White,7.0,1999 - 2005,C,334,5913,736,1443,51.004851004851005,0,1,0.0,736,1442,51.04022191400832,51.004851004851005,482,903,53.37763012181617,707,1237,1944,63,119,355,397,887,1954
Jahlil Okafor,4.0,2016 - 2019,C,190,4013,928,1752,52.96803652968036,3,15,20.0,925,1737,53.25273459988485,53.05365296803652,319,470,67.87234042553192,306,670,976,175,60,168,288,409,2178
Jake Layman,3.0,2017 - 2019,SF,144,1760,261,567,46.03174603174603,77,253,30.434782608695656,184,314,58.59872611464968,52.82186948853615,66,93,70.96774193548387,66,193,259,77,49,37,62,153,665
Jake Tsakalidis,7.0,2001 - 2007,C,325,5145,592,1210,48.925619834710744,0,1,0.0,592,1209,48.966087675765095,48.925619834710744,342,519,65.89595375722543,451,830,1281,103,74,231,279,713,1526
Jake Voskuhl,9.0,2001 - 2009,C,456,6541,685,1398,48.99856938483548,1,3,33.33333333333333,684,1395,49.03225806451613,49.0343347639485,479,667,71.81409295352323,571,990,1561,239,152,170,346,1187,1850
Jakob Poeltl,3.0,2017 - 2019,C,228,3589,529,831,63.65824308062575,1,3,33.33333333333333,528,828,63.76811594202898,63.718411552346566,155,271,57.19557195571956,442,574,1016,168,89,193,170,477,1214
Jalen Brunson,1.0,2019 - 2019,PG,73,1591,264,565,46.72566371681416,63,181,34.806629834254146,201,384,52.34375,52.30088495575222,87,120,72.5,25,144,169,230,37,4,88,127,678
Jalen Jones,2.0,2018 - 2019,SF,32,395,52,130,40.0,20,54,37.03703703703704,32,76,42.10526315789473,47.69230769230769,31,46,67.3913043478261,24,48,72,11,14,3,15,49,155
Jalen Rose,13.0,1995 - 2007,SF,982,29809,5176,11685,44.296106118955926,796,2232,35.66308243727598,4380,9453,46.3344969850841,47.70218228498074,2935,3663,80.12558012558011,520,2862,3382,3696,778,340,2220,2584,14083
Jamaal Franklin,2.0,2014 - 2015,SG,26,178,17,43,39.53488372093023,6,13,46.15384615384615,11,30,36.666666666666664,46.51162790697674,3,4,75.0,5,21,26,9,4,3,14,27,43
Jamaal Magloire,12.0,2001 - 2012,C,726,15531,1872,3907,47.91400051190172,0,8,0.0,1872,3899,48.01231084893563,47.91400051190172,1507,2346,64.23699914748508,1493,3159,4652,409,234,643,1050,1907,5251
Jamaal Tinsley,11.0,2002 - 2014,PG,588,15457,1874,4770,39.287211740041926,424,1418,29.90126939351199,1450,3352,43.25775656324583,43.731656184486376,773,1079,71.6404077849861,365,1346,1711,3538,827,161,1460,1433,4945
Jamal Crawford,19.0,2001 - 2019,SG,1400,41068,7121,17424,40.86891643709826,2327,6725,34.60223048327137,4794,10699,44.80792597439013,47.546487603305785,3905,4530,86.20309050772626,486,2604,3090,4699,1244,283,2571,2144,20474
Jamal Mashburn,11.0,1994 - 2004,SF,663,24611,4554,10934,41.649899396378274,825,2383,34.6202266051196,3729,8551,43.608934627528946,45.42253521126761,2493,3250,76.70769230769231,754,2759,3513,2579,681,118,1698,1681,12426
Jamal Murray,3.0,2017 - 2019,PG,238,6776,1287,2965,43.40640809443508,432,1194,36.18090452261307,855,1771,48.27780914737436,50.691399662731875,524,596,87.91946308724832,188,640,828,807,197,79,443,450,3530
Jamal Robinson,1.0,2001 - 2001,SF,6,72,3,22,13.636363636363635,0,2,0.0,3,20,15.0,13.636363636363635,0,0,,3,8,11,2,6,0,3,7,6
Jamal Sampson,5.0,2003 - 2007,PF,72,631,53,108,49.074074074074076,0,1,0.0,53,107,49.532710280373834,49.074074074074076,36,67,53.73134328358209,80,162,242,26,9,32,33,91,142
Jamario Moon,5.0,2008 - 2012,SF,305,6708,753,1626,46.309963099631,191,567,33.68606701940035,562,1059,53.06893295561851,52.183271832718326,187,235,79.57446808510639,213,1063,1276,301,240,245,151,443,1884
Jameel Warney,1.0,2018 - 2018,PF,3,27,7,12,58.333333333333336,0,0,,7,12,58.333333333333336,58.333333333333336,3,5,60.0,4,5,9,0,0,0,1,2,17
Jameer Nelson,14.0,2005 - 2018,PG,922,25968,4027,9224,43.65784908933218,1226,3330,36.81681681681682,2801,5894,47.52290464879538,50.30355594102341,1321,1635,80.79510703363914,452,2297,2749,4712,809,71,1921,2325,10601
Jamel Artis,1.0,2018 - 2018,SG,15,279,31,79,39.24050632911392,8,29,27.586206896551722,23,50,46.0,44.303797468354425,7,12,58.333333333333336,4,34,38,18,2,3,8,11,77
Jamel Thomas,2.0,2000 - 2001,SF,12,102,14,37,37.83783783783784,1,6,16.666666666666664,13,31,41.935483870967744,39.189189189189186,1,1,100.0,5,9,14,6,4,0,11,8,30
James Anderson,5.0,2011 - 2016,SG,257,4369,530,1290,41.08527131782946,198,618,32.038834951456316,332,672,49.404761904761905,48.75968992248062,177,235,75.31914893617021,109,460,569,294,122,55,216,295,1435
James Augustine,2.0,2007 - 2008,PF,28,158,20,38,52.63157894736842,0,0,,20,38,52.63157894736842,52.63157894736842,4,8,50.0,17,17,34,4,5,2,6,20,44
James Blackwell,1.0,1995 - 1995,PG,13,80,8,13,61.53846153846154,0,0,,8,13,61.53846153846154,61.53846153846154,2,3,66.66666666666666,2,9,11,11,4,0,5,8,18
James Collins,1.0,1998 - 1998,SG,23,103,21,55,38.18181818181819,9,20,45.0,12,35,34.285714285714285,46.36363636363636,8,14,57.14285714285714,7,7,14,3,6,3,8,12,59
James Cotton,2.0,1998 - 1999,SG,19,92,14,39,35.8974358974359,0,7,0.0,14,32,43.75,35.8974358974359,21,27,77.77777777777779,4,12,16,0,4,1,9,9,49
James Donaldson,14.0,1981 - 1995,C,1008,27601,3258,5686,57.298628209637705,0,0,,3258,5686,57.298628209637705,57.298628209637705,2088,2844,73.41772151898735,2178,5714,7892,800,354,1309,1513,2136,8604
James Ennis,5.0,2015 - 2019,SF,284,5874,637,1397,45.59770937723694,220,618,35.59870550161812,417,779,53.53016688061617,53.471725125268435,357,449,79.51002227171492,282,626,908,252,180,84,214,586,1851
James Harden,10.0,2010 - 2019,SG,870,29756,6183,14040,44.03846153846154,2255,6257,36.03963560811891,3928,7783,50.46897083386869,52.06908831908832,6312,7348,85.9009254218835,656,3892,4548,5320,1370,430,3118,2296,20933
James Johnson,10.0,2010 - 2019,PF,626,12781,1931,4052,47.65547877591313,304,983,30.925737538148525,1627,3069,53.01401107852721,51.40671273445212,734,1063,69.04985888993414,503,1717,2220,1313,482,544,899,1385,4900
James Jones,14.0,2004 - 2017,SF,857,13080,1378,3431,40.16321772078111,880,2206,39.89120580235721,498,1225,40.6530612244898,52.98746721072574,629,748,84.0909090909091,266,1241,1507,410,263,255,271,1108,4265
James Lang,1.0,2007 - 2007,C,11,55,4,9,44.44444444444444,0,0,,4,9,44.44444444444444,44.44444444444444,3,5,60.0,5,6,11,2,0,3,2,14,11
James Michael McAdoo,4.0,2015 - 2018,PF,137,978,146,276,52.89855072463768,7,22,31.818181818181817,139,254,54.7244094488189,54.166666666666664,68,128,53.125,85,128,213,39,38,52,45,119,367
James Nunnally,2.0,2014 - 2019,SF,28,267,27,80,33.75,16,50,32.0,11,30,36.666666666666664,43.75,10,13,76.92307692307693,1,23,24,15,7,2,8,21,80
James Posey,12.0,2000 - 2011,SF,929,24932,2647,6452,41.02603843769374,1124,3197,35.157960588051296,1523,3255,46.78955453149001,49.736515809051454,1512,1843,82.04015192620727,797,3579,4376,1478,982,316,1032,2518,7930
James Ray,3.0,1981 - 1983,PF,107,863,137,324,42.28395061728395,1,3,33.33333333333333,136,321,42.36760124610592,42.43827160493827,62,101,61.386138613861384,69,162,231,76,38,41,100,177,337
James Robinson,7.0,1994 - 2001,PG,395,7034,1065,2701,39.42984079970381,410,1175,34.8936170212766,655,1526,42.922673656618606,47.019622362088114,383,576,66.49305555555556,202,466,668,728,209,73,511,661,2923
James Scott,1.0,1997 - 1997,SF,8,32,0,8,0.0,0,4,0.0,0,4,0.0,0.0,1,2,50.0,1,5,6,3,2,0,2,5,1
James Singleton,5.0,2006 - 2012,PF,259,3306,368,796,46.231155778894475,37,127,29.133858267716533,331,669,49.47683109118087,48.55527638190954,195,236,82.62711864406779,323,596,919,111,97,118,142,401,968
James Southerland,1.0,2014 - 2014,SF,4,30,5,15,33.33333333333333,3,6,50.0,2,9,22.22222222222222,43.333333333333336,1,2,50.0,0,8,8,0,1,2,1,3,14
James Thomas,2.0,2005 - 2006,PF,33,267,22,39,56.41025641025641,0,0,,22,39,56.41025641025641,56.41025641025641,10,20,50.0,29,47,76,5,4,7,14,48,54
James Webb,1.0,2018 - 2018,SF,10,120,6,24,25.0,4,19,21.052631578947366,2,5,40.0,33.33333333333333,0,0,,8,16,24,4,1,0,4,10,16
James White,3.0,2007 - 2013,SF,76,604,76,175,43.42857142857143,18,54,33.33333333333333,58,121,47.93388429752066,48.57142857142857,23,34,67.64705882352942,10,61,71,35,17,6,26,54,193
James Wilkes,3.0,1981 - 1983,SF,116,1536,224,485,46.18556701030928,0,3,0.0,224,482,46.47302904564315,46.18556701030928,99,137,72.26277372262774,107,168,275,105,59,31,103,220,547
James Worthy,12.0,1983 - 1994,SF,1069,35298,8145,15533,52.43674756969033,131,553,23.688969258589513,8014,14980,53.49799732977303,52.85843043842142,2921,3836,76.14702815432743,1818,3637,5455,3254,1218,720,2157,2327,19342
James Young,4.0,2015 - 2018,SG,108,861,83,228,36.40350877192983,43,152,28.289473684210524,40,76,52.63157894736842,45.83333333333333,27,48,56.25,20,83,103,31,24,5,17,61,236
JamesOn Curry,1.0,2010 - 2010,PG,1,0,0,0,,0,0,,0,0,,,0,0,,0,0,0,0,0,0,0,0,0
Jamie Feick,5.0,1997 - 2001,PF-C,201,4316,351,827,42.44256348246675,12,30,40.0,339,797,42.534504391468005,43.16807738814994,197,313,62.939297124600635,515,922,1437,139,117,90,152,439,911
Jamie Waller,1.0,1988 - 1988,SG,9,91,16,40,40.0,0,2,0.0,16,38,42.10526315789473,40.0,10,18,55.55555555555556,9,4,13,3,4,1,11,13,42
Jamie Watson,4.0,1995 - 1999,SF,107,1305,132,278,47.482014388489205,12,38,31.57894736842105,120,240,50.0,49.64028776978417,59,85,69.41176470588235,40,110,150,120,67,18,99,163,335
Jamil Wilson,1.0,2018 - 2018,SF,15,274,38,81,46.913580246913575,27,63,42.857142857142854,11,18,61.111111111111114,63.580246913580254,2,4,50.0,3,29,32,10,5,8,8,34,105
Jamison Brewer,4.0,2002 - 2005,PG,56,474,35,96,36.45833333333333,8,32,25.0,27,64,42.1875,40.625,12,30,40.0,17,37,54,57,19,2,33,37,90
Jan Vesely,3.0,2012 - 2014,PF,162,2455,263,505,52.07920792079208,0,2,0.0,263,503,52.286282306163024,52.07920792079208,64,157,40.76433121019109,225,337,562,96,107,84,123,384,590
Jannero Pargo,11.0,2003 - 2015,PG,540,7995,1311,3369,38.91362422083704,440,1233,35.685320356853204,871,2136,40.77715355805244,45.44375185514989,346,407,85.01228501228502,123,634,757,1048,275,31,593,711,3408
Jared Cunningham,4.0,2013 - 2016,SG,84,605,60,173,34.68208092485549,19,62,30.64516129032258,41,111,36.93693693693694,40.17341040462428,58,86,67.44186046511628,6,50,56,39,21,2,32,72,197
Jared Dudley,12.0,2008 - 2019,SF,876,20204,2439,5255,46.412940057088484,899,2278,39.46444249341528,1540,2977,51.7299294591871,54.966698382492865,953,1309,72.80366692131398,813,2040,2853,1399,725,171,767,1642,6730
Jared Jeffries,11.0,2003 - 2013,SF,654,14160,1216,2849,42.681642681642685,77,305,25.245901639344265,1139,2544,44.772012578616355,44.03299403299403,633,1074,58.93854748603352,1224,1449,2673,826,449,346,702,1594,3142
Jared Reiner,2.0,2005 - 2007,C,49,383,25,74,33.78378378378378,0,0,,25,74,33.78378378378378,33.78378378378378,4,14,28.57142857142857,36,76,112,14,8,13,24,83,54
Jared Sullinger,5.0,2013 - 2017,PF,279,6693,1206,2765,43.616636528028934,146,531,27.49529190207156,1060,2234,47.448522829006265,46.256781193490056,415,575,72.17391304347827,703,1358,2061,485,181,164,343,812,2973
Jared Terrell,1.0,2019 - 2019,SG,14,111,12,39,30.76923076923077,4,17,23.52941176470588,8,22,36.36363636363637,35.8974358974359,3,6,50.0,1,5,6,12,3,2,10,16,31
Jarell Eddie,3.0,2016 - 2018,SF,34,218,26,86,30.23255813953488,19,65,29.230769230769234,7,21,33.33333333333333,41.27906976744186,16,17,94.11764705882352,3,28,31,5,7,1,2,6,87
Jarell Martin,4.0,2016 - 2019,PF,189,2983,380,878,43.28018223234624,63,182,34.61538461538461,317,696,45.54597701149425,46.86788154897494,186,245,75.91836734693878,195,455,650,115,71,73,147,417,1009
Jaren Jackson,13.0,1990 - 2019,SG,528,9453,1248,3039,41.06614017769003,446,1269,35.1457840819543,802,1770,45.31073446327684,48.40408028956894,470,620,75.80645161290323,295,852,1147,601,331,136,484,1026,3412
Jarnell Stokes,3.0,2015 - 2017,C,28,151,25,43,58.139534883720934,0,0,,25,43,58.139534883720934,58.139534883720934,17,32,53.125,18,22,40,7,7,5,7,29,67
Jaron Blossomgame,1.0,2019 - 2019,SF,27,439,47,106,44.339622641509436,10,39,25.64102564102564,37,67,55.223880597014926,49.056603773584904,10,13,76.92307692307693,26,72,98,13,7,8,11,20,114
Jarred Vanderbilt,1.0,2019 - 2019,PF,17,69,9,19,47.368421052631575,0,1,0.0,9,18,50.0,47.368421052631575,6,10,60.0,7,16,23,3,6,1,8,8,24
Jarrett Allen,2.0,2018 - 2019,C,152,3537,569,965,58.96373056994819,11,60,18.333333333333332,558,905,61.65745856353592,59.53367875647668,311,425,73.1764705882353,335,725,1060,159,71,208,185,331,1460
Jarrett Jack,13.0,2006 - 2018,PG,891,24830,3492,7915,44.118761844598865,632,1853,34.10685375067458,2860,6062,47.17914879577697,48.111181301326596,2048,2393,85.58295027162558,287,2293,2580,4048,702,113,1789,1627,9664
Jarrod Uthoff,1.0,2017 - 2017,PF,9,115,16,38,42.10526315789473,3,9,33.33333333333333,13,29,44.827586206896555,46.05263157894737,5,7,71.42857142857143,8,14,22,9,2,4,3,8,40
Jarron Collins,10.0,2002 - 2011,C,578,8869,701,1550,45.225806451612904,0,5,0.0,701,1545,45.372168284789645,45.225806451612904,750,1075,69.76744186046511,673,966,1639,426,145,100,342,1381,2152
Jarvis Hayes,7.0,2004 - 2010,SF,442,10098,1421,3439,41.32015120674615,404,1134,35.626102292768955,1017,2305,44.12147505422993,47.19395173015412,373,467,79.87152034261243,252,1108,1360,467,315,59,378,875,3619
Jarvis Varnado,2.0,2013 - 2014,PF,37,397,39,67,58.2089552238806,0,0,,39,67,58.2089552238806,58.2089552238806,29,56,51.78571428571429,21,51,72,16,11,31,16,72,107
Jason Caffey,8.0,1996 - 2003,PF,497,9509,1315,2748,47.85298398835517,0,8,0.0,1315,2740,47.99270072992701,47.85298398835517,847,1327,63.82818387339865,897,1241,2138,449,215,118,674,1219,3477
Jason Collier,5.0,2001 - 2005,C,151,2178,338,743,45.49125168236878,7,20,35.0,331,723,45.78146611341632,45.96231493943472,158,214,73.83177570093457,175,268,443,51,36,32,120,295,841
Jason Collins,13.0,2002 - 2014,C,830,17008,1020,2489,40.98031337886702,7,36,19.444444444444446,1013,2453,41.29637178964533,41.12093210124548,889,1366,65.0805270863836,1066,2005,3071,674,409,395,696,2400,2936
Jason Hart,9.0,2001 - 2010,PG,364,5428,631,1510,41.788079470198674,64,204,31.372549019607842,567,1306,43.415007656967845,43.907284768211916,333,422,78.90995260663507,77,498,575,783,263,35,281,546,1659
Jason Kapono,9.0,2004 - 2012,SF,519,9299,1375,3096,44.412144702842376,472,1082,43.622920517560075,903,2014,44.83614697120159,52.03488372093024,274,328,83.53658536585365,167,695,862,423,184,25,330,795,3496
Jason Kidd,19.0,1995 - 2013,PG,1549,56199,6939,17400,39.87931034482759,2224,6434,34.566366179670496,4715,10966,42.996534743753415,46.270114942528735,3470,4424,78.43580470162749,1986,7797,9783,13354,2986,502,4453,2920,19572
Jason Lawson,1.0,1998 - 1998,C,17,80,9,15,60.0,0,0,,9,15,60.0,60.0,8,10,80.0,8,19,27,5,4,4,2,14,26
Jason Maxiell,10.0,2006 - 2015,PF,653,11960,1465,2930,50.0,0,6,0.0,1465,2924,50.102599179206564,50.0,717,1278,56.10328638497653,1087,1603,2690,286,250,522,506,1271,3647
Jason Miskiri,1.0,2000 - 2000,PG,1,3,0,1,0.0,0,1,0.0,0,0,,0.0,0,0,,0,0,0,1,0,0,0,2,0
Jason Richardson,13.0,2002 - 2015,SG,894,30503,5789,13178,43.92927606617089,1703,4579,37.19152653417777,4086,8599,47.51715315734388,50.390802853240245,1996,2819,70.80525008868393,1084,3361,4445,2334,1035,380,1546,2059,15277
Jason Sasser,2.0,1997 - 1999,SF,14,108,14,34,41.17647058823529,1,3,33.33333333333333,13,31,41.935483870967744,42.64705882352941,1,2,50.0,3,12,15,4,5,0,4,15,30
Jason Smith,11.0,2008 - 2019,C,642,10328,1606,3432,46.794871794871796,87,263,33.07984790874524,1519,3169,47.93310192489744,48.06235431235431,563,719,78.30319888734353,671,1455,2126,461,213,420,519,1383,3862
Jason Terry,19.0,2000 - 2018,SG,1534,46022,7548,17022,44.34261543884384,2503,6584,38.01640340218712,5045,10438,48.3330139873539,51.6948654682176,3032,3593,84.38630670748678,552,3026,3578,5790,1715,299,2604,2853,20631
Jason Thompson,8.0,2009 - 2016,PF,598,14874,2116,4264,49.62476547842402,6,43,13.953488372093023,2110,4221,49.98815446576641,49.69512195121951,980,1495,65.55183946488295,1270,2621,3891,636,283,415,748,1757,5218
Jason Williams,12.0,1999 - 2011,PG,855,24921,3263,8203,39.77812995245642,1319,4046,32.60009886307464,1944,4157,46.76449362521049,47.81787151042302,978,1194,81.90954773869346,203,1734,1937,4832,984,62,1744,1209,8823
Javaris Crittenton,2.0,2008 - 2009,SG,113,1853,229,518,44.20849420849421,12,52,23.076923076923077,217,466,46.56652360515021,45.366795366795365,125,196,63.775510204081634,84,192,276,201,59,8,137,148,595
Jawad Williams,3.0,2009 - 2011,SF,93,1157,127,346,36.70520231213873,45,146,30.82191780821918,82,200,41.0,43.20809248554913,41,57,71.9298245614035,24,109,133,56,22,8,35,110,340
Jawann Oldham,10.0,1981 - 1991,C,334,5336,615,1285,47.85992217898833,0,3,0.0,615,1282,47.97191887675507,47.85992217898833,239,394,60.659898477157356,440,937,1377,165,103,553,374,839,1469
Jawun Evans,2.0,2018 - 2019,PG,56,843,92,267,34.45692883895131,15,57,26.31578947368421,77,210,36.666666666666664,37.265917602996254,38,49,77.55102040816327,10,86,96,110,39,6,50,105,237
Jay Edwards,1.0,1990 - 1990,SG,4,26,3,7,42.857142857142854,0,2,0.0,3,5,60.0,42.857142857142854,1,3,33.33333333333333,1,1,2,4,1,0,1,4,7
Jay Guidinger,2.0,1993 - 1994,C,68,361,36,90,40.0,0,0,,36,90,40.0,40.0,28,48,58.333333333333336,42,56,98,20,13,16,28,72,100
Jay Humphries,11.0,1985 - 1995,PG,829,24166,3653,7685,47.534157449577094,234,794,29.47103274559194,3419,6891,49.615440429545785,49.056603773584904,1628,2082,78.1940441882805,555,1541,2096,4526,1185,94,1590,2296,9168
Jay Murphy,4.0,1985 - 1988,PF,67,436,63,190,33.1578947368421,0,3,0.0,63,187,33.68983957219251,33.1578947368421,34,56,60.71428571428571,34,77,111,13,8,7,24,59,160
Jay Taylor,1.0,1990 - 1990,SG,17,114,21,52,40.38461538461539,3,13,23.076923076923077,18,39,46.15384615384615,43.269230769230774,6,9,66.66666666666666,5,6,11,5,5,3,10,9,51
Jay Vincent,9.0,1982 - 1990,SF,614,16527,3660,7782,47.031611410948344,4,29,13.793103448275861,3656,7753,47.155939636269835,47.05731174505269,1895,2400,78.95833333333333,1044,2300,3344,1170,437,181,1172,1728,9219
Jay Williams,1.0,2003 - 2003,PG,75,1961,273,685,39.85401459854015,65,202,32.17821782178218,208,483,43.064182194616976,44.598540145985396,103,161,63.975155279503106,27,168,195,350,86,17,171,179,714
Jaylen Adams,1.0,2019 - 2019,PG,34,428,38,110,34.54545454545455,25,74,33.78378378378378,13,36,36.11111111111111,45.909090909090914,7,9,77.77777777777779,11,49,60,65,14,5,28,45,108
Jaylen Brown,3.0,2017 - 2019,SG,257,6204,1091,2355,46.32696390658174,311,852,36.502347417840376,780,1503,51.896207584830336,52.92993630573248,412,627,65.70972886762361,204,798,1002,317,194,88,327,593,2905
Jaylen Morris,2.0,2018 - 2019,SG,10,127,17,42,40.476190476190474,3,13,23.076923076923077,14,29,48.275862068965516,44.047619047619044,1,2,50.0,2,19,21,11,4,1,7,3,38
Jayson Tatum,2.0,2018 - 2019,SF,178,5576,986,2132,46.24765478424015,244,624,39.1025641025641,742,1508,49.20424403183024,51.969981238273924,490,583,84.04802744425386,130,832,962,348,190,125,277,388,2706
Jayson Williams,9.0,1991 - 1999,PF,484,9948,1373,3121,43.992310157000965,3,24,12.5,1370,3097,44.23635776557959,44.04037167574496,753,1244,60.530546623794216,1612,2021,3633,292,206,304,520,1298,3502
Jeff Adrien,5.0,2011 - 2015,PF,153,2148,264,557,47.3967684021544,0,2,0.0,264,555,47.56756756756757,47.3967684021544,181,288,62.84722222222222,221,438,659,100,50,79,91,259,709
Jeff Ayres,6.0,2010 - 2016,PF,275,2498,305,565,53.98230088495575,2,6,33.33333333333333,303,559,54.203935599284435,54.15929203539823,123,160,76.875,208,468,676,107,39,71,137,383,735
Jeff Cross,1.0,1986 - 1986,PF,21,128,6,24,25.0,0,0,,6,24,25.0,25.0,14,25,56.00000000000001,9,21,30,1,2,3,6,38,26
Jeff Foote,1.0,2012 - 2012,C,4,39,2,6,33.33333333333333,0,0,,2,6,33.33333333333333,33.33333333333333,0,0,,1,5,6,0,0,1,2,5,4
Jeff Foster,13.0,2000 - 2012,C,817,16643,1556,3112,50.0,9,59,15.254237288135593,1547,3053,50.67147068457255,50.14460154241645,833,1351,61.6580310880829,2224,3317,5541,738,535,337,652,2032,3954
Jeff Grayer,9.0,1989 - 1998,SG,448,8372,1352,2958,45.70655848546315,35,137,25.547445255474454,1317,2821,46.6855724920241,46.29817444219067,557,838,66.46778042959427,578,730,1308,643,273,66,490,742,3296
Jeff Green,11.0,2008 - 2019,PF,920,27454,4316,9842,43.8528754318228,925,2775,33.33333333333333,3391,7067,47.98358567992076,48.55212355212355,2351,2928,80.29371584699454,846,3237,4083,1452,658,499,1387,2033,11908
Jeff Hornacek,14.0,1987 - 2000,SG,1217,38730,6670,13535,49.279645363871445,950,2337,40.65040650406504,5720,11198,51.080550098231825,52.78906538603621,3461,3941,87.82035016493276,1055,3118,4173,5806,1706,251,2202,2748,17751
Jeff Lamp,6.0,1982 - 1989,SF,303,3550,620,1324,46.82779456193353,13,57,22.807017543859647,607,1267,47.90844514601421,47.318731117824775,270,322,83.85093167701864,134,307,441,277,106,14,225,410,1523
Jeff Lebo,1.0,1990 - 1990,SG,4,32,2,7,28.57142857142857,0,0,,2,7,28.57142857142857,28.57142857142857,2,2,100.0,2,2,4,3,2,0,1,7,6
Jeff Malone,13.0,1984 - 1996,SG,956,31469,7481,15486,48.308149296138446,88,333,26.426426426426424,7393,15153,48.78901867616974,48.592276895260234,3137,3606,86.99389905712701,607,1898,2505,2264,616,112,1628,1818,18187
Jeff Martin,2.0,1990 - 1991,SG,143,2685,384,921,41.69381107491857,29,103,28.155339805825243,355,818,43.39853300733496,43.268186753528774,159,229,69.43231441048034,131,159,290,109,78,47,96,201,956
Jeff McInnis,11.0,1997 - 2008,PG,583,16026,2198,5107,43.03896612492657,305,932,32.72532188841202,1893,4175,45.34131736526946,46.02506363814373,716,900,79.55555555555556,248,934,1182,2533,373,32,795,1205,5417
Jeff Nordgaard,1.0,1998 - 1998,PF,13,48,5,18,27.77777777777778,0,0,,5,18,27.77777777777778,27.77777777777778,8,9,88.88888888888889,4,10,14,3,2,0,3,7,18
Jeff Ruland,8.0,1982 - 1993,C,349,11728,2215,3945,56.14702154626109,3,23,13.043478260869565,2212,3922,56.399796022437535,56.1850443599493,1643,2279,72.09302325581395,1144,2397,3541,1069,263,280,1283,1278,6076
Jeff Sanders,4.0,1990 - 1993,PF,58,465,50,125,40.0,0,0,,50,125,40.0,40.0,14,23,60.86956521739131,41,62,103,25,18,9,32,64,114
Jeff Sheppard,1.0,1999 - 1999,SG,22,197,15,42,35.714285714285715,2,7,28.57142857142857,13,35,37.142857142857146,38.095238095238095,8,13,61.53846153846154,8,16,24,18,4,0,7,12,40
Jeff Taylor,2.0,1983 - 1987,SG,56,818,70,170,41.17647058823529,0,1,0.0,70,169,41.42011834319527,41.17647058823529,39,56,69.64285714285714,26,56,82,113,42,16,68,86,179
Jeff Teague,10.0,2010 - 2019,PG,783,21830,3546,8026,44.18141041614752,697,1971,35.36276002029427,2849,6055,47.05202312138728,48.52354846748069,2216,2628,84.32267884322678,260,1684,1944,4490,925,275,1770,1538,10005
Jeff Trepagnier,3.0,2002 - 2004,SG,31,270,34,101,33.663366336633665,6,13,46.15384615384615,28,88,31.818181818181817,36.633663366336634,14,20,70.0,17,26,43,22,19,4,25,20,88
Jeff Turner,10.0,1985 - 1996,PF,636,11462,1563,3352,46.62887828162291,84,234,35.8974358974359,1479,3118,47.43425272610648,47.881861575178995,543,705,77.02127659574468,627,1441,2068,651,219,88,697,1815,3753
Jeff Webster,1.0,1996 - 1996,SF,11,58,8,23,34.78260869565217,2,6,33.33333333333333,6,17,35.294117647058826,39.130434782608695,0,0,,2,5,7,3,4,0,3,7,18
Jeff Wilkins,6.0,1981 - 1986,C,478,10482,1582,3446,45.90829947765525,0,11,0.0,1582,3435,46.05531295487628,45.90829947765525,617,828,74.51690821256038,620,2069,2689,480,182,258,657,1268,3781
Jeff Withey,5.0,2014 - 2018,C,209,2093,251,478,52.51046025104602,2,14,14.285714285714285,249,464,53.66379310344828,52.719665271966534,167,234,71.36752136752136,184,338,522,65,57,157,76,234,671
Jeffery Taylor,3.0,2013 - 2015,SF,132,2566,299,731,40.902872777017784,82,257,31.906614785992215,217,474,45.78059071729958,46.51162790697674,127,191,66.49214659685863,80,183,263,107,72,21,92,234,807
Jelani McCoy,8.0,1999 - 2008,C,263,3850,512,952,53.78151260504202,0,0,,512,952,53.78151260504202,53.78151260504202,180,370,48.64864864864865,285,642,927,137,75,193,247,527,1204
Jemerrio Jones,1.0,2019 - 2019,SF,6,143,12,33,36.36363636363637,2,10,20.0,10,23,43.47826086956522,39.39393939393939,1,2,50.0,16,33,49,13,7,5,5,10,27
Jerald Honeycutt,2.0,1998 - 1999,PF,60,644,100,258,38.759689922480625,34,97,35.051546391752574,66,161,40.993788819875775,45.348837209302324,43,68,63.23529411764706,31,75,106,36,25,8,59,102,277
Jerami Grant,5.0,2015 - 2019,PF,394,9477,1217,2624,46.37957317073171,278,835,33.293413173652695,939,1789,52.48742314141979,51.67682926829268,746,1141,65.38124452234881,383,1156,1539,406,224,456,369,899,3458
Jerel McNeal,1.0,2015 - 2015,PG,6,36,3,11,27.27272727272727,1,2,50.0,2,9,22.22222222222222,31.818181818181817,2,2,100.0,0,3,3,2,3,1,5,5,9
Jeremy Evans,7.0,2011 - 2018,SF,252,2633,364,641,56.78627145085804,6,26,23.076923076923077,358,615,58.211382113821145,57.25429017160687,147,213,69.01408450704226,239,405,644,108,91,121,85,292,881
Jeremy Lamb,7.0,2013 - 2019,SG,449,9017,1680,3790,44.327176781002635,444,1314,33.789954337899545,1236,2476,49.919224555735056,50.18469656992084,702,822,85.40145985401459,233,1375,1608,682,304,152,360,697,4506
Jeremy Lin,9.0,2011 - 2019,PG,497,12668,1942,4497,43.1843451189682,459,1362,33.70044052863436,1483,3135,47.30462519936204,48.287747387146986,1395,1723,80.96343586767266,207,1177,1384,2094,529,177,1117,1105,5738
Jeremy Pargo,2.0,2012 - 2013,PG,83,1079,149,400,37.25,35,112,31.25,114,288,39.58333333333333,41.625,58,89,65.1685393258427,20,66,86,147,28,2,96,92,391
Jeremy Richardson,3.0,2007 - 2009,SF,49,253,34,104,32.69230769230769,15,39,38.46153846153847,19,65,29.230769230769234,39.90384615384615,5,8,62.5,3,22,25,5,4,0,11,22,88
Jeremy Tyler,3.0,2012 - 2014,C,104,1034,157,349,44.985673352435526,0,1,0.0,157,348,45.11494252873563,44.985673352435526,59,106,55.660377358490564,98,171,269,25,23,42,68,164,373
Jerian Grant,4.0,2016 - 2019,PG,278,4970,589,1438,40.95966620305981,173,540,32.03703703703704,416,898,46.32516703786192,46.97496522948539,330,427,77.28337236533957,90,438,528,801,206,32,278,403,1681
Jermaine Jackson,5.0,2000 - 2006,SG,141,1360,91,227,40.08810572687225,3,19,15.789473684210526,88,208,42.30769230769231,40.7488986784141,83,120,69.16666666666667,34,112,146,186,42,9,81,130,268
Jermaine O'Neal,18.0,1997 - 2014,PF,1108,29941,5557,11995,46.32763651521467,14,111,12.612612612612612,5543,11884,46.642544597778524,46.3859941642351,3305,4623,71.49037421587714,2147,5745,7892,1468,505,1987,2033,3182,14433
Jermaine Taylor,2.0,2010 - 2011,SG,65,786,139,315,44.12698412698413,19,67,28.35820895522388,120,248,48.38709677419355,47.14285714285714,54,74,72.97297297297297,47,61,108,48,24,8,65,54,351
Jermareo Davidson,2.0,2008 - 2009,SF,52,433,68,160,42.5,0,0,,68,160,42.5,42.5,26,45,57.77777777777777,31,65,96,14,9,18,22,58,162
Jerome Allen,2.0,1996 - 1997,SG,117,1305,114,326,34.96932515337423,40,126,31.746031746031743,74,200,37.0,41.104294478527606,68,108,62.96296296296296,30,93,123,201,52,9,103,126,336
Jerome Beasley,1.0,2004 - 2004,PF,2,5,1,3,33.33333333333333,0,0,,1,3,33.33333333333333,33.33333333333333,0,0,,0,1,1,0,0,0,0,0,2
Jerome Dyson,1.0,2012 - 2012,PG,9,180,19,48,39.58333333333333,1,8,12.5,18,40,45.0,40.625,28,36,77.77777777777779,2,17,19,18,11,2,20,19,67
Jerome Harmon,1.0,1995 - 1995,SG,10,158,21,53,39.62264150943396,1,1,100.0,20,52,38.46153846153847,40.56603773584906,3,6,50.0,9,14,23,12,9,0,7,12,46
Jerome Henderson,2.0,1986 - 1987,PF,8,40,6,16,37.5,0,0,,6,16,37.5,37.5,4,4,100.0,2,6,8,0,1,1,6,14,16
Jerome James,9.0,1999 - 2009,C,375,5140,717,1475,48.610169491525426,0,2,0.0,717,1473,48.676171079429736,48.610169491525426,266,425,62.588235294117645,431,757,1188,127,98,409,422,1056,1700
Jerome Jordan,2.0,2012 - 2015,C,67,500,68,131,51.908396946564885,0,0,,68,131,51.908396946564885,51.908396946564885,46,54,85.18518518518519,69,67,136,17,9,21,25,73,182
Jerome Kersey,17.0,1985 - 2001,SF,1279,31509,5322,11443,46.50878266188936,60,309,19.41747572815534,5262,11134,47.26064307526495,46.77095167351219,2678,3855,69.46822308690012,2613,4443,7056,2367,1607,879,1746,3882,13382
Jerome Lane,5.0,1989 - 1993,PF,222,3250,499,1136,43.92605633802817,1,17,5.88235294117647,498,1119,44.50402144772118,43.970070422535215,162,424,38.20754716981132,568,697,1265,326,138,39,263,554,1161
Jerome Moiso,5.0,2001 - 2005,C,149,1452,168,339,49.557522123893804,0,3,0.0,168,336,50.0,49.557522123893804,73,122,59.83606557377049,134,277,411,43,45,75,108,192,409
Jerome Robinson,1.0,2019 - 2019,SG,33,320,44,110,40.0,18,57,31.57894736842105,26,53,49.056603773584904,48.18181818181818,6,9,66.66666666666666,3,38,41,19,11,3,13,46,112
Jerome Williams,9.0,1997 - 2005,PF,612,13263,1472,2939,50.08506294658047,1,26,3.8461538461538463,1471,2913,50.497768623412284,50.10207553589656,1041,1624,64.10098522167488,1503,2374,3877,496,645,135,605,1286,3986
Jerrelle Benimon,1.0,2015 - 2015,PF,2,3,0,0,,0,0,,0,0,,,0,0,,1,2,3,0,0,0,1,0,0
Jerrod Mustaf,4.0,1991 - 1994,PF,189,1934,292,645,45.27131782945737,0,2,0.0,292,643,45.41213063763608,45.27131782945737,155,238,65.12605042016807,148,311,459,99,54,48,145,239,739
Jerry Eaves,4.0,1983 - 1987,PG,179,2817,438,928,47.19827586206897,2,17,11.76470588235294,436,911,47.85949506037321,47.30603448275862,309,400,77.25,67,151,218,427,90,10,258,228,1187
Jerry Reynolds,8.0,1986 - 1996,SF,461,8476,1439,3447,41.74644618508848,29,130,22.30769230769231,1410,3317,42.508290624057885,42.16710182767624,1182,1583,74.66835123183829,472,861,1333,912,495,259,727,689,4089
Jerry Sichting,10.0,1981 - 1990,PG,645,13387,1853,3684,50.2985884907709,49,184,26.6304347826087,1804,3500,51.542857142857144,50.963626492942446,526,618,85.11326860841424,207,649,856,2041,455,19,675,999,4281
Jerry Smith,1.0,2012 - 2012,PG,5,46,3,14,21.428571428571427,1,6,16.666666666666664,2,8,25.0,25.0,0,0,,2,5,7,4,5,0,0,5,7
Jerry Stackhouse,18.0,1996 - 2013,SG,1045,32384,5710,14061,40.60877604722282,1067,3440,31.017441860465116,4643,10621,43.7152810469824,44.402958537799584,4906,5969,82.19132182945216,990,2309,3299,3414,909,455,2782,1940,17393
Jerryd Bayless,11.0,2009 - 2019,PG,616,13105,1810,4423,40.92245082523174,525,1464,35.86065573770492,1285,2959,43.42683338965867,46.85733664933303,1029,1258,81.79650238473768,185,1112,1297,1747,381,81,854,1274,5174
Jeryl Sasser,2.0,2002 - 2003,SG,88,1086,69,228,30.263157894736842,14,48,29.166666666666668,55,180,30.555555555555557,33.33333333333333,57,83,68.67469879518072,68,128,196,68,49,13,42,95,209
Jevon Carter,1.0,2019 - 2019,PG,39,577,56,185,30.270270270270274,34,102,33.33333333333333,22,83,26.506024096385545,39.45945945945946,26,32,81.25,14,52,66,69,26,11,33,55,172
Jim Brogan,2.0,1982 - 1983,SG,121,1493,256,577,44.367417677642976,12,45,26.666666666666668,244,532,45.86466165413533,45.407279029462735,95,127,74.80314960629921,94,88,182,222,75,22,126,202,619
Jim Farmer,5.0,1988 - 1994,SG,141,1468,277,651,42.54992319508449,22,79,27.848101265822784,255,572,44.58041958041958,44.23963133640553,143,196,72.95918367346938,80,110,190,112,42,4,120,166,719
Jim Grandholm,1.0,1991 - 1991,PF,26,168,30,58,51.724137931034484,9,17,52.94117647058824,21,41,51.21951219512195,59.48275862068966,10,21,47.61904761904761,20,30,50,8,2,8,11,33,79
Jim Jackson,14.0,1993 - 2006,SF,933,30344,4980,11625,42.83870967741936,939,2551,36.80909447275578,4041,9074,44.533832929248405,46.877419354838715,2264,2744,82.5072886297376,1232,3113,4345,2918,757,202,2235,2087,13163
Jim Johnstone,1.0,1983 - 1983,PF-C,23,191,11,30,36.666666666666664,0,0,,11,30,36.666666666666664,36.666666666666664,9,20,45.0,15,31,46,11,3,7,15,33,31
Jim Lampley,1.0,1987 - 1987,C,1,16,1,3,33.33333333333333,0,0,,1,3,33.33333333333333,33.33333333333333,1,2,50.0,1,4,5,0,1,0,1,0,3
Jim Les,7.0,1989 - 1995,PG,324,4227,372,938,39.6588486140725,196,495,39.5959595959596,176,443,39.729119638826184,50.10660980810234,270,330,81.81818181818183,86,310,396,931,169,20,296,423,1210
Jim McIlvaine,7.0,1995 - 2001,C,412,6014,433,975,44.41025641025641,1,11,9.090909090909092,432,964,44.81327800829876,44.46153846153847,227,412,55.09708737864077,487,768,1255,106,139,699,233,1081,1094
Jim Petersen,8.0,1985 - 1992,PF,537,10590,1468,3021,48.59318106587223,2,28,7.142857142857142,1466,2993,48.98095556298029,48.626282687851706,700,972,72.0164609053498,839,1722,2561,524,230,380,695,1486,3638
Jim Rowinski,2.0,1989 - 1990,PF-C,23,127,15,36,41.66666666666667,0,0,,15,36,41.66666666666667,41.66666666666667,27,32,84.375,18,16,34,5,1,2,10,19,57
Jim Smith,2.0,1982 - 1983,PF,76,876,89,173,51.445086705202314,0,0,,89,173,51.445086705202314,51.445086705202314,41,89,46.06741573033708,72,115,187,46,22,51,47,189,219
Jim Thomas,4.0,1984 - 1991,SG,161,3361,541,1148,47.12543554006969,9,53,16.9811320754717,532,1095,48.58447488584475,47.51742160278746,264,346,76.30057803468208,136,282,418,377,142,12,210,322,1355
Jim Zoet,1.0,1983 - 1983,C,7,30,1,5,20.0,0,0,,1,5,20.0,20.0,0,0,,3,5,8,1,1,3,4,9,2
Jimmer Fredette,6.0,2012 - 2019,SG,241,3213,524,1282,40.87363494539781,193,519,37.1868978805395,331,763,43.381389252948885,48.4009360374415,197,224,87.94642857142857,53,190,243,331,94,11,223,222,1438
Jimmy Butler,8.0,2012 - 2019,SG,566,18856,3102,6864,45.19230769230769,538,1564,34.39897698209718,2564,5300,48.37735849056604,49.11130536130536,2706,3246,83.3641404805915,813,1993,2806,1932,886,267,825,842,9448
Jimmy Carruth,1.0,1997 - 1997,PF,4,21,2,3,66.66666666666666,0,0,,2,3,66.66666666666666,66.66666666666666,1,1,100.0,0,4,4,0,0,2,1,4,5
Jimmy King,2.0,1996 - 1997,SG,64,890,112,261,42.911877394636015,5,34,14.705882352941178,107,227,47.136563876651984,43.86973180076628,56,81,69.1358024691358,45,67,112,90,24,13,61,78,285
Jimmy Oliver,5.0,1992 - 1999,SG,78,856,135,332,40.66265060240964,17,50,34.0,118,282,41.843971631205676,43.22289156626506,44,57,77.19298245614034,18,62,80,55,27,3,33,66,331
Jiri Welsch,4.0,2003 - 2006,SF,255,4715,529,1307,40.4743687834736,119,348,34.195402298850574,410,959,42.75286757038582,45.026778882938025,381,504,75.59523809523809,120,497,617,386,190,15,270,402,1558
Jo Jo English,3.0,1993 - 1995,SG,57,635,79,190,41.578947368421055,12,36,33.33333333333333,67,154,43.506493506493506,44.73684210526316,23,42,54.761904761904766,13,44,57,48,19,14,47,89,193
Joakim Noah,12.0,2008 - 2019,C,727,20697,2472,5056,48.892405063291136,0,16,0.0,2472,5040,49.047619047619044,48.892405063291136,1502,2153,69.763121226196,2373,4328,6701,2067,591,979,1233,2083,6446
Joao Vianna,1.0,1992 - 1992,SF,1,9,1,2,50.0,0,0,,1,2,50.0,50.0,0,0,,0,0,0,2,0,0,1,3,2
Jodie Meeks,10.0,2010 - 2019,SG,559,12359,1689,4031,41.90027288514017,786,2111,37.23353860729512,903,1920,47.03125,51.64971471098983,904,1026,88.10916179337231,153,983,1136,591,420,37,418,651,5068
Joe Alexander,2.0,2009 - 2010,SF,67,745,103,251,41.03585657370518,16,47,34.04255319148936,87,204,42.64705882352941,44.223107569721115,60,86,69.76744186046511,46,74,120,44,16,30,52,116,282
Joe Arlauckas,1.0,1988 - 1988,SF,9,85,14,43,32.55813953488372,0,0,,14,43,32.55813953488372,32.55813953488372,6,8,75.0,6,7,13,8,3,4,4,16,34
Joe Barry Carroll,10.0,1981 - 1991,C,724,23349,5126,10817,47.3883701580845,0,14,0.0,5126,10803,47.44978246783301,47.3883701580845,2464,3296,74.75728155339806,1715,3783,5498,1290,705,1153,2002,2272,12716
Joe Binion,1.0,1987 - 1987,PF,11,51,4,10,40.0,0,0,,4,10,40.0,40.0,6,10,60.0,8,10,18,1,2,2,3,5,14
Joe Chealey,1.0,2019 - 2019,PG,1,8,1,3,33.33333333333333,0,0,,1,3,33.33333333333333,33.33333333333333,0,0,,0,0,0,1,0,0,0,1,2
Joe Cooper,3.0,1982 - 1985,C,24,389,45,89,50.56179775280899,0,0,,45,89,50.56179775280899,50.56179775280899,19,35,54.285714285714285,46,51,97,19,11,21,33,58,109
Joe Courtney,4.0,1993 - 1997,PF,96,749,106,245,43.26530612244898,2,3,66.66666666666666,104,242,42.97520661157025,43.673469387755105,50,79,63.29113924050633,65,75,140,27,20,23,47,110,264
Joe Crawford,1.0,2009 - 2009,SF,2,23,3,10,30.0,1,4,25.0,2,6,33.33333333333333,35.0,2,2,100.0,1,3,4,1,1,0,0,2,9
Joe Crispin,1.0,2002 - 2002,PG,21,156,26,68,38.23529411764706,15,39,38.46153846153847,11,29,37.93103448275862,49.26470588235294,12,13,92.3076923076923,2,9,11,26,5,0,10,10,79
Joe Dumars,14.0,1986 - 1999,SG,1130,39236,6640,14424,46.034387132556844,1043,2740,38.065693430656935,5597,11684,47.90311537144814,49.64988907376595,3830,4535,84.4542447629548,766,1694,2460,5124,993,89,2289,2053,18153
Joe Harris,5.0,2015 - 2019,SG,268,5930,884,1861,47.50134336378291,451,1056,42.70833333333333,433,805,53.7888198757764,59.618484685652874,243,305,79.67213114754098,126,617,743,392,110,47,296,520,2462
Joe Ingles,5.0,2015 - 2019,SF,428,10748,1251,2799,44.69453376205787,719,1756,40.945330296127565,532,1043,51.006711409395976,57.53840657377635,263,358,73.46368715083798,130,1220,1350,1437,439,69,664,800,3484
Joe Johnson,17.0,2002 - 2018,SG,1396,48498,8525,19366,44.02044820819994,2136,5797,36.84664481628428,6389,13569,47.08526789004348,49.53526799545595,3047,3807,80.0367743630155,1183,4382,5565,5370,1167,279,2663,2478,22233
Joe Kleine,15.0,1986 - 2000,C,1015,15304,1986,4364,45.50870760769936,14,53,26.41509433962264,1972,4311,45.7434469960566,45.66911090742438,872,1098,79.41712204007287,1308,2816,4124,640,272,300,803,2091,4858
Joe Kopicki,3.0,1983 - 1985,PF,128,1244,146,300,48.66666666666667,3,11,27.27272727272727,143,289,49.48096885813148,49.166666666666664,164,208,78.84615384615384,113,219,332,88,38,9,78,161,459
Joe Smith,16.0,1996 - 2011,PF,1092,28101,4453,9796,45.45732952225398,33,134,24.62686567164179,4420,9662,45.74622231422066,45.625765618619845,2606,3300,78.96969696969697,2538,4280,6818,1030,629,906,1324,3125,11545
Joe Stephens,3.0,1997 - 2000,SF,22,227,30,84,35.714285714285715,4,21,19.047619047619047,26,63,41.269841269841265,38.095238095238095,7,10,70.0,18,27,45,12,12,3,11,14,71
Joe Wolf,11.0,1988 - 1999,C,606,9744,1077,2548,42.26844583987442,19,113,16.8141592920354,1058,2435,43.44969199178645,42.641287284144425,334,434,76.95852534562212,598,1345,1943,598,258,132,513,1299,2507
Joe Young,3.0,2016 - 2018,PG,132,1090,171,435,39.310344827586206,41,139,29.496402877697843,130,296,43.91891891891892,44.02298850574712,55,71,77.46478873239437,19,112,131,120,33,1,66,78,438
Joel Anthony,10.0,2008 - 2017,C,556,8213,448,880,50.90909090909091,0,0,,448,880,50.90909090909091,50.90909090909091,315,468,67.3076923076923,646,912,1558,114,144,603,254,947,1211
Joel Bolomboy,2.0,2017 - 2018,PF,20,100,14,25,56.00000000000001,1,5,20.0,13,20,65.0,57.99999999999999,6,12,50.0,10,19,29,2,3,3,4,4,35
Joel Embiid,3.0,2017 - 2019,C,166,5130,1350,2822,47.838412473423105,189,604,31.29139072847682,1161,2218,52.344454463480616,51.18710134656273,1115,1421,78.4658691062632,387,1518,1905,523,120,323,606,563,4004
Joel Freeland,3.0,2013 - 2015,C,162,1852,209,458,45.633187772925766,0,2,0.0,209,456,45.83333333333333,45.633187772925766,60,83,72.28915662650603,194,333,527,66,34,57,78,262,478
Joel Przybilla,13.0,2001 - 2013,C,603,11930,907,1643,55.203895313451,0,3,0.0,907,1640,55.304878048780495,55.203895313451,504,906,55.62913907284768,1133,2586,3719,265,161,850,578,1636,2318
Joey Dorsey,4.0,2009 - 2015,PF,136,1501,142,268,52.98507462686567,0,1,0.0,142,267,53.18352059925093,52.98507462686567,61,162,37.65432098765432,199,318,517,57,67,44,87,258,345
Joey Graham,6.0,2006 - 2011,SF,389,6257,873,1816,48.0726872246696,55,185,29.72972972972973,818,1631,50.153280196198644,49.58700440528634,478,588,81.29251700680273,277,811,1088,209,140,44,316,822,2279
Joffrey Lauvergne,4.0,2015 - 2018,C,212,2855,482,1007,47.86494538232373,49,174,28.160919540229884,433,833,51.980792316926774,50.29791459781529,162,223,72.6457399103139,244,555,799,185,55,34,167,287,1175
Johan Petro,8.0,2006 - 2013,C,495,7434,998,2161,46.18232299861175,2,13,15.384615384615385,996,2148,46.36871508379888,46.22859787135585,255,378,67.46031746031747,544,1331,1875,233,195,242,381,1193,2253
John Amaechi,5.0,1996 - 2003,C,301,4858,667,1659,40.20494273658831,1,13,7.6923076923076925,666,1646,40.46172539489672,40.23508137432188,515,768,67.05729166666666,231,545,776,231,93,96,386,505,1850
John Bagley,11.0,1983 - 1994,PG,684,17666,2431,5564,43.69158878504673,115,481,23.90852390852391,2316,5083,45.56364351760771,44.72501797268153,1006,1296,77.62345679012346,425,1351,1776,4122,778,56,1573,1123,5983
John Battle,10.0,1986 - 1995,SG,667,11629,2178,4719,46.15384615384615,66,249,26.506024096385545,2112,4470,47.24832214765101,46.85314685314685,1263,1584,79.73484848484848,195,701,896,1337,286,44,714,944,5685
John Celestand,1.0,2000 - 2000,PG,16,185,15,45,33.33333333333333,2,9,22.22222222222222,13,36,36.11111111111111,35.55555555555556,5,6,83.33333333333334,1,10,11,20,7,0,16,22,37
John Coker,3.0,1996 - 2001,C,25,141,18,44,40.909090909090914,0,0,,18,44,40.909090909090914,40.909090909090914,5,6,83.33333333333334,12,17,29,3,2,3,4,22,41
John Collins,2.0,2018 - 2019,PF,135,3614,779,1376,56.61337209302325,71,205,34.63414634146341,708,1171,60.46114432109309,59.19331395348837,336,452,74.33628318584071,395,741,1136,219,69,119,225,414,1965
John Crotty,11.0,1993 - 2003,PG,513,6064,648,1511,42.885506287227,151,392,38.52040816326531,497,1119,44.41465594280608,47.88219722038385,527,629,83.78378378378379,144,381,525,1034,190,23,448,627,1974
John Douglas,2.0,1982 - 1983,SG,67,1043,182,395,46.07594936708861,19,61,31.147540983606557,163,334,48.80239520958084,48.48101265822785,69,104,66.34615384615384,27,64,91,147,48,9,92,147,452
John Duren,3.0,1981 - 1983,PG,201,2947,317,729,43.484224965706446,3,25,12.0,314,704,44.60227272727273,43.68998628257887,75,100,75.0,60,166,226,411,104,11,205,400,712
John Edwards,2.0,2005 - 2006,C,65,435,42,94,44.680851063829785,0,0,,42,94,44.680851063829785,44.680851063829785,15,25,60.0,26,41,67,8,6,19,20,88,99
John Garris,1.0,1984 - 1984,PF,33,267,52,102,50.98039215686274,0,0,,52,102,50.98039215686274,50.98039215686274,27,34,79.41176470588235,35,42,77,10,8,6,11,40,131
John Greig,1.0,1983 - 1983,SF,9,26,7,13,53.84615384615385,0,0,,7,13,53.84615384615385,53.84615384615385,5,6,83.33333333333334,2,4,6,0,0,1,2,4,19
John Henson,7.0,2013 - 2019,C,419,8424,1380,2559,53.92731535756155,12,46,26.08695652173913,1368,2513,54.43692797453244,54.161781946072686,471,828,56.88405797101449,783,1495,2278,452,195,617,478,944,3243
John Holland,2.0,2018 - 2019,SF,26,176,17,60,28.333333333333332,11,37,29.72972972972973,6,23,26.08695652173913,37.5,9,13,69.23076923076923,6,18,24,5,7,2,8,10,54
John Jenkins,6.0,2013 - 2019,SG,179,2228,315,714,44.11764705882353,119,324,36.7283950617284,196,390,50.256410256410255,52.450980392156865,116,137,84.67153284671532,37,218,255,141,31,14,97,99,865
John Lucas III,8.0,2006 - 2017,PG,249,3029,472,1226,38.499184339314844,168,488,34.42622950819672,304,738,41.19241192411924,45.35073409461664,78,101,77.22772277227723,59,185,244,371,89,2,136,202,1190
John McCullough,1.0,1982 - 1982,SG,8,23,9,13,69.23076923076923,0,0,,9,13,69.23076923076923,69.23076923076923,3,5,60.0,1,3,4,3,2,0,3,3,21
John Morton,3.0,1990 - 1992,SG,131,1890,206,533,38.649155722326455,13,58,22.413793103448278,193,475,40.63157894736842,39.868667917448406,192,243,79.01234567901234,54,107,161,342,92,23,188,166,617
John Paxson,11.0,1984 - 1994,PG,891,19874,2709,5432,49.871134020618555,318,891,35.69023569023569,2391,4541,52.653600528517956,52.798232695139916,572,703,81.3655761024182,178,837,1015,3064,582,47,722,1679,6308
John Pinone,1.0,1984 - 1984,SF,7,65,7,13,53.84615384615385,0,0,,7,13,53.84615384615385,53.84615384615385,6,10,60.0,0,10,10,3,2,1,5,11,20
John Salley,11.0,1987 - 2000,PF,882,19218,2167,4283,50.595377072145695,3,16,18.75,2164,4267,50.71478790719475,50.630399252860144,1748,2460,71.0569105691057,1470,2474,3944,1020,500,1142,1056,2819,6085
John Salmons,13.0,2003 - 2015,SG,923,24367,3099,7213,42.96409261056426,744,2060,36.116504854368934,2355,5153,45.70153308752183,48.12144738666297,1609,2007,80.16940707523668,448,2221,2669,2233,777,250,1212,1715,8551
John Schweitz,2.0,1985 - 1987,SG,22,117,25,75,33.33333333333333,0,4,0.0,25,71,35.2112676056338,33.33333333333333,7,10,70.0,6,16,22,18,0,1,16,14,57
John Shasky,3.0,1989 - 1991,C,136,1505,176,378,46.56084656084656,0,2,0.0,176,376,46.808510638297875,46.56084656084656,165,252,65.47619047619048,158,221,379,34,29,35,75,179,517
John Starks,13.0,1989 - 2002,SG,962,26549,4403,10659,41.30781499202552,1398,4066,34.382685686178064,3005,6593,45.578644016381006,47.865653438408856,1988,2589,76.78640401699498,454,1946,2400,3478,1071,115,1757,2616,12192
John Stockton,19.0,1985 - 2003,PG,1686,54162,7894,15467,51.037693153164795,956,2544,37.57861635220126,6938,12923,53.68722432871624,54.12814379000452,5403,6555,82.42562929061785,1128,3531,4659,17645,3603,365,4761,4481,22147
John Stroeder,2.0,1988 - 1989,PF,47,294,32,85,37.64705882352941,1,3,33.33333333333333,31,82,37.80487804878049,38.23529411764706,20,30,66.66666666666666,29,56,85,23,3,14,27,51,85
John Stroud,1.0,1981 - 1981,SF,9,88,11,34,32.35294117647059,0,0,,11,34,32.35294117647059,32.35294117647059,3,4,75.0,7,6,13,9,1,0,4,7,25
John Thomas,5.0,1998 - 2006,C,217,2310,226,450,50.22222222222222,0,2,0.0,226,448,50.44642857142857,50.22222222222222,115,195,58.97435897435898,203,239,442,62,72,51,112,399,567
John Turner,1.0,1992 - 1992,SF,42,345,43,98,43.87755102040816,0,0,,43,98,43.87755102040816,43.87755102040816,31,59,52.54237288135594,38,40,78,12,6,4,32,40,117
John Wall,9.0,2011 - 2019,PG,610,21979,4228,9789,43.191337215241596,574,1794,31.995540691192865,3654,7995,45.70356472795497,46.123199509653695,2659,3391,78.41344736066057,350,2292,2642,5646,1040,437,2336,1373,11689
John Wallace,7.0,1997 - 2004,SF,386,6187,1156,2513,46.000795861520096,15,51,29.411764705882355,1141,2462,46.34443541835906,46.299243931555914,584,788,74.11167512690355,330,739,1069,286,136,218,473,713,2911
John Williams,8.0,1987 - 1995,SF,448,11284,1804,4001,45.088727818045484,67,294,22.789115646258505,1737,3707,46.85729700566496,45.926018495376155,827,1181,70.02540220152413,652,1603,2255,1292,581,188,704,1058,4502
Johnathan Motley,2.0,2018 - 2019,PF,33,332,79,148,53.37837837837838,1,9,11.11111111111111,78,139,56.11510791366906,53.71621621621622,39,68,57.35294117647059,32,68,100,18,8,5,25,45,198
Johnathan Williams,1.0,2019 - 2019,C,24,372,65,110,59.09090909090909,0,2,0.0,65,108,60.18518518518518,59.09090909090909,27,48,56.25,48,51,99,13,8,7,16,62,157
Johnny Dawkins,9.0,1987 - 1995,PG,554,15298,2420,5313,45.54865424430642,180,554,32.49097472924188,2240,4759,47.0687119142677,47.24261246000376,1121,1309,85.63789152024445,339,1022,1361,3095,637,31,1138,861,6141
Johnny Moore,9.0,1981 - 1990,PG,561,14514,2191,4737,46.252902681021745,104,406,25.615763546798032,2087,4331,48.18748556915262,47.35064386742664,869,1224,70.99673202614379,432,1248,1680,4210,1087,129,1237,1446,5355
Johnny Newman,16.0,1987 - 2002,SF,1198,29286,4607,10006,46.04237457525485,614,1848,33.22510822510822,3993,8158,48.94582005393479,49.11053367979213,3333,4121,80.87842756612473,991,1626,2617,1744,1099,254,1715,3318,13161
Johnny O'Bryant,4.0,2015 - 2018,PF,148,1696,216,538,40.14869888475837,18,50,36.0,198,488,40.57377049180328,41.82156133828997,65,98,66.3265306122449,130,225,355,69,32,19,77,200,515
Johnny Rogers,2.0,1987 - 1988,PF,69,636,116,246,47.15447154471545,0,7,0.0,116,239,48.53556485355649,47.15447154471545,19,28,67.85714285714286,38,66,104,29,13,11,30,89,251
Johnny Taylor,3.0,1998 - 2000,SF,54,866,100,249,40.16064257028113,28,71,39.436619718309856,72,178,40.44943820224719,45.78313253012048,28,39,71.7948717948718,36,84,120,26,32,20,44,124,256
Jon Barry,14.0,1993 - 2006,SG,883,14808,1704,3942,43.22678843226788,717,1825,39.28767123287671,987,2117,46.6225791213982,52.32115677321156,916,1079,84.89341983317887,340,1291,1631,1869,754,114,860,1085,5041
Jon Brockman,3.0,2010 - 2012,PF,150,1570,118,242,48.760330578512395,0,1,0.0,118,241,48.96265560165975,48.760330578512395,84,136,61.76470588235294,212,260,472,49,33,9,57,267,320
Jon Koncak,11.0,1986 - 1996,C,837,17437,1519,3241,46.868250539956804,19,84,22.61904761904762,1500,3157,47.513462147608486,47.16136994754706,683,1135,60.176211453744486,1121,2942,4063,824,569,838,653,2645,3740
Jon Leuer,8.0,2012 - 2019,PF,389,5988,985,2036,48.379174852652255,126,383,32.89817232375979,859,1653,51.966122202056866,51.47347740667977,314,409,76.77261613691931,363,1079,1442,303,139,103,259,587,2410
Jon Sundvold,9.0,1984 - 1992,PG,512,8968,1672,3699,45.20140578534739,230,594,38.72053872053872,1442,3105,46.44122383252818,48.310354149770205,371,437,84.89702517162472,134,427,561,1494,224,5,569,607,3945
Jonah Bolden,1.0,2019 - 2019,PF,44,639,80,162,49.382716049382715,34,96,35.41666666666667,46,66,69.6969696969697,59.876543209876544,13,27,48.148148148148145,47,118,165,40,17,39,36,99,207
Jonas Jerebko,9.0,2010 - 2019,PF,667,11760,1515,3314,45.71514785757393,413,1148,35.97560975609756,1102,2166,50.877192982456144,51.94628847314424,604,782,77.23785166240408,785,1837,2622,551,333,161,453,1271,4047
Jonas Valanciunas,7.0,2013 - 2019,C,532,13398,2541,4552,55.82161687170475,47,132,35.60606060606061,2494,4420,56.425339366515836,56.33787346221442,1318,1683,78.31253713606655,1376,3194,4570,420,202,552,808,1476,6447
Jonathan Bender,8.0,2000 - 2010,SF,296,4151,549,1318,41.65402124430956,114,333,34.234234234234236,435,985,44.16243654822335,45.97875569044006,353,466,75.7510729613734,166,458,624,179,48,188,275,421,1565
Jonathan Gibson,2.0,2017 - 2018,PG,21,271,49,118,41.52542372881356,21,57,36.84210526315789,28,61,45.90163934426229,50.42372881355932,21,29,72.41379310344827,1,24,25,30,8,0,24,26,140
Jonathan Isaac,2.0,2018 - 2019,PF,102,2532,317,756,41.93121693121693,102,312,32.69230769230769,215,444,48.42342342342342,48.67724867724868,129,160,80.625,115,395,510,98,92,128,102,191,865
Jonathan Kerner,1.0,1999 - 1999,C,1,5,0,1,0.0,0,0,,0,1,0.0,0.0,0,0,,0,0,0,0,0,0,0,2,0
Jonathon Simmons,4.0,2016 - 2019,SG,276,5630,852,1920,44.375,160,497,32.19315895372233,692,1423,48.62965565706254,48.541666666666664,447,595,75.12605042016807,136,517,653,514,169,63,355,547,2311
Jonny Flynn,3.0,2010 - 2012,PG,163,3738,551,1379,39.95649021029732,118,349,33.810888252149,433,1030,42.03883495145631,44.23495286439449,284,351,80.91168091168092,44,263,307,634,122,7,382,179,1504
Jordan Adams,2.0,2015 - 2016,SG,36,273,39,95,41.05263157894737,11,27,40.74074074074074,28,68,41.17647058823529,46.8421052631579,19,32,59.375,9,22,31,19,20,7,16,26,108
Jordan Bell,2.0,2018 - 2019,C,142,1770,232,409,56.723716381418086,0,7,0.0,232,402,57.711442786069654,56.723716381418086,62,99,62.62626262626263,130,308,438,193,61,116,99,190,526
Jordan Clarkson,5.0,2015 - 2019,SG,401,10813,2215,5022,44.10593389088013,533,1606,33.18804483188045,1682,3416,49.23887587822014,49.41258462763839,748,918,81.48148148148148,346,923,1269,1041,350,49,670,667,5711
Jordan Crawford,6.0,2011 - 2018,SG,294,6974,1313,3199,41.04407627383557,338,1068,31.647940074906366,975,2131,45.75316752698264,46.326977180368864,542,658,82.37082066869301,157,562,719,886,200,23,540,448,3506
Jordan Farmar,10.0,2007 - 2017,PG,577,10988,1598,3807,41.9753086419753,638,1714,37.222870478413064,960,2093,45.867176301958914,50.35460992907801,431,579,74.43868739205527,175,891,1066,1569,433,65,765,799,4265
Jordan Hamilton,5.0,2012 - 2016,SF,154,2107,344,843,40.80664294187426,137,384,35.67708333333333,207,459,45.09803921568628,48.93238434163701,69,103,66.99029126213593,89,340,429,127,74,34,103,145,894
Jordan Hill,8.0,2010 - 2017,C,429,7955,1385,2799,49.48195784208646,3,22,13.636363636363635,1382,2777,49.765934461649266,49.53554841014648,526,753,69.8539176626826,922,1560,2482,326,153,282,433,910,3299
Jordan Loyd,1.0,2019 - 2019,PG,12,55,8,18,44.44444444444444,4,8,50.0,4,10,40.0,55.55555555555556,9,11,81.81818181818183,1,8,9,6,0,0,2,5,29
Jordan McRae,3.0,2016 - 2019,SG,88,916,157,362,43.370165745856355,39,109,35.77981651376147,118,253,46.6403162055336,48.75690607734807,76,97,78.35051546391753,16,87,103,74,24,14,44,74,429
Jordan Mickey,3.0,2016 - 2018,PF,68,510,66,147,44.89795918367347,2,17,11.76470588235294,64,130,49.23076923076923,45.57823129251701,26,43,60.46511627906976,38,97,135,19,9,29,29,56,160
Jordan Sibert,1.0,2019 - 2019,SG,1,4,1,1,100.0,1,1,100.0,0,0,,150.0,0,0,,0,0,0,0,0,0,0,0,3
Jordan Williams,1.0,2012 - 2012,C,43,635,77,152,50.6578947368421,0,0,,77,152,50.6578947368421,50.6578947368421,43,66,65.15151515151516,66,90,156,11,21,15,23,61,197
Jorge Garbajosa,2.0,2007 - 2008,PF,74,1983,230,554,41.51624548736462,72,209,34.44976076555024,158,345,45.79710144927536,48.014440433213,57,78,73.07692307692307,50,295,345,128,81,15,65,92,589
Jorge Gutierrez,3.0,2014 - 2016,PG,53,509,54,111,48.64864864864865,3,17,17.647058823529413,51,94,54.25531914893617,50.0,30,40,75.0,9,49,58,72,19,1,33,66,141
Jose Calderon,14.0,2006 - 2019,PG,932,24279,3145,6673,47.13022628502922,952,2346,40.57971014492754,2193,4327,50.681765657499426,54.26344972276338,938,1074,87.33705772811918,315,1889,2204,5268,730,72,1376,1543,8180
Jose Ortiz,2.0,1989 - 1990,PF,64,391,74,167,44.31137724550898,1,3,33.33333333333333,73,164,44.51219512195122,44.61077844311377,34,57,59.64912280701754,38,35,73,18,10,8,41,55,183
Jose Slaughter,1.0,1983 - 1983,SG,63,515,89,238,37.39495798319328,9,41,21.951219512195124,80,197,40.609137055837564,39.285714285714285,38,59,64.40677966101694,34,34,68,52,36,7,42,93,225
Joseph Forte,2.0,2002 - 2003,SG,25,125,11,47,23.404255319148938,0,6,0.0,11,41,26.82926829268293,23.404255319148938,8,10,80.0,5,12,17,17,6,0,13,7,30
Josh Akognon,1.0,2013 - 2013,PG,3,9,2,4,50.0,1,2,50.0,1,2,50.0,62.5,0,0,,0,1,1,1,0,0,0,3,5
Josh Boone,4.0,2007 - 2010,PF,268,4600,579,1066,54.315196998123824,0,0,,579,1066,54.315196998123824,54.315196998123824,218,487,44.76386036960985,491,786,1277,128,100,181,172,482,1376
Josh Childress,8.0,2005 - 2014,SF,398,10637,1365,2613,52.23880597014925,99,303,32.67326732673268,1266,2310,54.8051948051948,54.13318025258324,769,992,77.52016129032258,747,1143,1890,620,340,189,441,732,3598
Josh Davis,4.0,2004 - 2012,PF,69,502,56,151,37.086092715231786,23,71,32.3943661971831,33,80,41.25,44.70198675496689,21,29,72.41379310344827,49,67,116,19,17,5,21,71,156
Josh Grant,1.0,1994 - 1994,PF,54,383,59,146,40.41095890410959,17,61,27.86885245901639,42,85,49.411764705882355,46.23287671232877,22,29,75.86206896551724,27,62,89,24,18,8,30,62,157
Josh Gray,1.0,2018 - 2018,PG,5,86,11,41,26.82926829268293,3,13,23.076923076923077,8,28,28.57142857142857,30.48780487804878,7,11,63.63636363636363,2,8,10,12,8,2,7,8,32
Josh Harrellson,3.0,2012 - 2014,C,79,913,109,249,43.77510040160642,33,96,34.375,76,153,49.673202614379086,50.401606425702816,24,37,64.86486486486487,83,152,235,26,30,36,35,102,275
Josh Hart,2.0,2018 - 2019,SG,130,3176,365,839,43.5041716328963,170,471,36.09341825902335,195,368,52.9891304347826,53.63528009535161,121,174,69.54022988505747,77,434,511,173,111,56,105,254,1021
Josh Howard,10.0,2004 - 2013,SF,573,17465,3118,6977,44.68969471119392,388,1177,32.96516567544605,2730,5800,47.06896551724138,47.470259423821126,1622,2101,77.2013326987149,978,2366,3344,918,596,315,854,1513,8246
Josh Huestis,3.0,2016 - 2018,PF,82,1097,73,210,34.76190476190476,40,127,31.496062992125985,33,83,39.75903614457831,44.285714285714285,7,27,25.925925925925924,49,137,186,23,17,49,29,89,193
Josh Jackson,2.0,2018 - 2019,SG,156,3947,736,1773,41.51156232374507,130,442,29.411764705882355,606,1331,45.52967693463561,45.17766497461929,320,492,65.04065040650406,161,537,698,302,154,91,319,427,1922
Josh Magette,1.0,2018 - 2018,PG,18,216,15,46,32.608695652173914,8,22,36.36363636363637,7,24,29.166666666666668,41.30434782608695,8,8,100.0,2,17,19,57,8,1,9,16,46
Josh McRoberts,11.0,2008 - 2018,PF,458,8654,954,2067,46.15384615384615,204,602,33.88704318936877,750,1465,51.19453924914675,51.088534107402026,332,465,71.3978494623656,484,1277,1761,932,235,202,398,868,2444
Josh Okogie,1.0,2019 - 2019,SG,74,1757,196,508,38.582677165354326,60,215,27.906976744186046,136,293,46.41638225255973,44.48818897637795,118,162,72.8395061728395,41,177,218,91,88,33,63,166,570
Josh Powell,7.0,2006 - 2014,PF,362,4158,517,1183,43.70245139475909,8,22,36.36363636363637,509,1161,43.84151593453919,44.04057480980558,233,312,74.67948717948718,346,621,967,168,49,70,262,521,1275
Josh Richardson,4.0,2016 - 2019,SG,278,8466,1195,2825,42.30088495575221,442,1203,36.74147963424772,753,1622,46.42416769420469,50.12389380530974,437,534,81.83520599250936,193,695,888,778,313,191,370,692,3269
Josh Selby,2.0,2012 - 2013,PG,39,296,31,94,32.97872340425532,3,21,14.285714285714285,28,73,38.35616438356164,34.57446808510639,18,25,72.0,2,18,20,34,9,0,36,24,83
Josh Smith,13.0,2005 - 2018,PF,967,31306,5486,12179,45.04474915838739,496,1744,28.440366972477065,4990,10435,47.81983708672736,47.0810411363823,2593,4107,63.13610908205503,1850,5342,7192,2992,1157,1820,2361,2675,14061
Jrue Holiday,10.0,2010 - 2019,PG,682,22671,4202,9286,45.25091535645057,853,2394,35.63074352548037,3349,6892,48.59257109692397,49.84385095843204,1400,1782,78.56341189674522,571,2062,2633,4316,1006,332,1846,1554,10657
Juan Carlos Navarro,1.0,2008 - 2008,SG,82,2117,308,766,40.2088772845953,156,432,36.11111111111111,152,334,45.50898203592814,50.391644908616186,124,146,84.93150684931507,34,176,210,177,48,1,134,94,896
Juan Dixon,7.0,2003 - 2009,SG,454,8798,1449,3517,41.199886266704574,344,1014,33.92504930966469,1105,2503,44.147023571713945,46.090417969860674,568,682,83.28445747800586,158,688,846,791,355,34,574,758,3810
Juan Hernangomez,3.0,2017 - 2019,PF,157,2477,268,613,43.719412724306686,126,344,36.627906976744185,142,269,52.78810408921933,53.996737357259384,133,174,76.4367816091954,125,381,506,96,63,39,77,181,795
Juaquin Hawkins,1.0,2003 - 2003,SG,58,685,57,148,38.513513513513516,10,24,41.66666666666667,47,124,37.903225806451616,41.891891891891895,10,20,50.0,16,62,78,47,29,6,29,57,134
Jud Buechler,12.0,1991 - 2002,SF,791,9005,1010,2344,43.08873720136519,282,771,36.57587548638132,728,1573,46.28099173553719,49.104095563139936,207,329,62.91793313069909,461,887,1348,584,335,151,313,792,2509
Julian Washburn,1.0,2019 - 2019,SF,18,254,16,48,33.33333333333333,5,24,20.833333333333336,11,24,45.83333333333333,38.54166666666667,3,4,75.0,8,33,41,14,13,2,7,16,40
Julian Wright,4.0,2008 - 2011,SF,246,3212,420,846,49.645390070921984,18,70,25.71428571428571,402,776,51.80412371134021,50.70921985815603,104,176,59.09090909090909,190,365,555,189,142,71,170,196,962
Julius Hodge,2.0,2006 - 2007,SG,23,98,11,25,44.0,0,0,,11,25,44.0,44.0,6,12,50.0,7,8,15,18,6,0,11,13,28
Julius Nwosu,1.0,1995 - 1995,C,25,91,9,30,30.0,0,0,,9,30,30.0,30.0,13,17,76.47058823529412,12,14,26,3,0,3,10,21,31
Julius Randle,5.0,2015 - 2019,PF,311,8854,1811,3604,50.249722530521645,104,339,30.678466076696164,1707,3265,52.28177641653905,51.692563817980016,1058,1466,72.16916780354707,665,2088,2753,847,197,156,744,1011,4784
Julyan Stone,4.0,2012 - 2018,SG,74,520,29,65,44.61538461538462,10,32,31.25,19,33,57.57575757575758,52.307692307692314,16,22,72.72727272727273,11,67,78,80,16,8,25,59,84
Jumaine Jones,8.0,2000 - 2007,SF,500,10263,1349,3186,42.34149403640929,433,1254,34.52950558213716,916,1932,47.4120082815735,49.1368487131199,327,464,70.47413793103449,588,1488,2076,427,317,155,402,907,3458
Junior Burrough,1.0,1996 - 1996,PF,61,495,64,170,37.64705882352941,0,0,,64,170,37.64705882352941,37.64705882352941,61,93,65.59139784946237,45,64,109,15,15,10,40,74,189
Junior Harrington,3.0,2003 - 2007,PG,140,3096,290,782,37.084398976982094,20,73,27.397260273972602,270,709,38.081805359661494,38.36317135549872,133,193,68.9119170984456,69,312,381,428,126,25,250,401,733
Justin Anderson,4.0,2016 - 2019,SF,228,2985,428,1018,42.04322200392927,144,477,30.18867924528302,284,541,52.495378927911275,49.115913555992144,209,271,77.12177121771218,146,437,583,150,102,71,136,276,1209
Justin Dentmon,2.0,2012 - 2013,PG,8,95,10,30,33.33333333333333,2,14,14.285714285714285,8,16,50.0,36.666666666666664,4,6,66.66666666666666,0,8,8,10,2,0,7,10,26
Justin Hamilton,3.0,2014 - 2017,C,113,1961,268,577,46.447140381282495,68,220,30.909090909090907,200,357,56.022408963585434,52.33968804159446,83,104,79.8076923076923,132,271,403,91,61,73,73,169,687
Justin Harper,3.0,2012 - 2017,PF,23,155,18,54,33.33333333333333,8,29,27.586206896551722,10,25,40.0,40.74074074074074,1,3,33.33333333333333,5,13,18,4,3,3,12,10,45
Justin Holiday,6.0,2013 - 2019,SG,362,8094,1019,2610,39.04214559386973,496,1418,34.97884344146686,523,1192,43.875838926174495,48.54406130268199,366,440,83.18181818181817,128,889,1017,521,341,135,342,530,2900
Justin Jackson,2.0,2018 - 2019,SF,149,3120,402,904,44.469026548672566,144,430,33.48837209302326,258,474,54.43037974683544,52.43362831858407,88,115,76.52173913043478,71,328,399,170,60,27,69,180,1036
Justin Patton,2.0,2018 - 2019,C,4,25,3,9,33.33333333333333,0,2,0.0,3,7,42.857142857142854,33.33333333333333,1,2,50.0,2,4,6,3,3,0,0,6,7
Justin Reed,3.0,2005 - 2007,SF,142,1458,176,437,40.274599542334094,0,6,0.0,176,431,40.835266821345705,40.274599542334094,127,169,75.14792899408283,76,111,187,68,31,19,81,221,479
Justin Williams,2.0,2007 - 2008,C,49,456,67,117,57.26495726495726,0,1,0.0,67,116,57.758620689655174,57.26495726495726,31,89,34.831460674157306,71,93,164,2,10,21,19,68,165
Justise Winslow,4.0,2016 - 2019,SF,248,6951,853,2040,41.81372549019608,196,573,34.20593368237348,657,1467,44.785276073619634,46.61764705882353,294,452,65.04424778761062,255,1063,1318,634,232,92,367,605,2196
Jusuf Nurkic,5.0,2015 - 2019,C,315,7214,1463,2978,49.12693082605776,3,43,6.976744186046512,1460,2935,49.74446337308348,49.1773002014775,728,1090,66.78899082568807,788,1735,2523,597,267,406,641,971,3657
Juwan Howard,19.0,1995 - 2013,PF,1257,37513,6642,14201,46.77135412999085,6,50,12.0,6636,14151,46.89421242315031,46.79247940285896,3139,4109,76.39328303723534,2408,5179,7587,2695,832,320,2495,3580,16429
K.J. McDaniels,3.0,2015 - 2017,SF,152,2126,282,688,40.98837209302326,71,244,29.098360655737704,211,444,47.52252252252252,46.14825581395349,156,201,77.61194029850746,97,234,331,96,70,97,151,208,791
Kadeem Allen,2.0,2018 - 2019,PG,37,523,71,163,43.558282208588956,17,47,36.17021276595745,54,116,46.55172413793103,48.77300613496933,49,63,77.77777777777779,12,50,62,88,19,6,35,61,208
Kalin Lucas,2.0,2015 - 2019,PG,2,12,0,2,0.0,0,1,0.0,0,1,0.0,0.0,2,2,100.0,0,3,3,1,1,0,0,2,2
Kaniel Dickens,3.0,2004 - 2008,PF,19,85,8,20,40.0,3,9,33.33333333333333,5,11,45.45454545454545,47.5,3,4,75.0,5,7,12,2,2,2,3,9,22
Kannard Johnson,1.0,1988 - 1988,SF,4,12,1,3,33.33333333333333,0,0,,1,3,33.33333333333333,33.33333333333333,0,0,,0,0,0,0,1,0,2,1,2
Kareem Rush,7.0,2003 - 2010,SG,377,6335,917,2296,39.9390243902439,312,866,36.027713625866056,605,1430,42.30769230769231,46.73344947735192,179,253,70.7509881422925,106,485,591,372,161,77,315,494,2325
Karl Malone,19.0,1986 - 2004,PF,1669,62759,15271,29978,50.94068983921542,91,347,26.22478386167147,15180,29631,51.230130606459454,51.09246780972714,11056,14913,74.13665929055186,4064,12966,17030,5858,2343,1280,5074,5240,41689
Karl-Anthony Towns,4.0,2016 - 2019,C,328,11290,2775,5179,53.58177254296196,396,1014,39.053254437869825,2379,4165,57.118847539015604,57.40490442170303,1317,1578,83.46007604562737,1041,2857,3898,850,247,486,806,1077,7263
Kasib Powell,1.0,2008 - 2008,SF,11,304,35,95,36.84210526315789,8,33,24.242424242424242,27,62,43.54838709677419,41.05263157894737,6,9,66.66666666666666,8,36,44,18,9,2,5,18,84
Kawhi Leonard,8.0,2012 - 2019,SF,554,17312,3512,7056,49.77324263038549,766,1965,38.98218829516539,2746,5091,53.93832252995482,55.201247165532884,1892,2248,84.16370106761566,732,2854,3586,1292,976,368,801,982,9682
Kay Felder,2.0,2017 - 2018,PG,58,526,83,228,36.40350877192983,11,41,26.82926829268293,72,187,38.50267379679144,38.81578947368421,46,61,75.40983606557377,6,53,59,78,21,8,46,49,223
Kebu Stewart,1.0,1998 - 1998,PF,15,110,12,26,46.15384615384615,0,0,,12,26,46.15384615384615,46.15384615384615,16,25,64.0,9,22,31,2,5,2,8,13,40
Kedrick Brown,4.0,2002 - 2005,SF,148,1949,206,507,40.63116370808679,47,169,27.810650887573964,159,338,47.0414201183432,45.26627218934911,58,91,63.73626373626373,100,249,349,103,86,29,64,170,517
Keita Bates-Diop,1.0,2019 - 2019,SF,30,503,60,142,42.25352112676056,13,52,25.0,47,90,52.22222222222223,46.83098591549296,18,28,64.28571428571429,16,67,83,17,18,14,14,29,151
Keith Appling,1.0,2016 - 2016,PG,5,27,2,8,25.0,0,3,0.0,2,5,40.0,25.0,2,2,100.0,0,1,1,1,1,0,3,5,6
Keith Askins,9.0,1991 - 1999,SF,513,8316,698,1745,40.0,287,805,35.65217391304348,411,940,43.723404255319146,48.22349570200573,230,320,71.875,547,938,1485,388,287,173,332,1150,1913
Keith Benson,1.0,2012 - 2012,C,3,9,0,1,0.0,0,0,,0,1,0.0,0.0,0,0,,2,1,3,0,0,0,0,0,0
Keith Bogans,11.0,2004 - 2014,SG,707,15205,1537,3907,39.33964678781674,755,2131,35.42937587986861,782,1776,44.031531531531535,49.00179165600205,588,824,71.35922330097088,400,1487,1887,893,445,72,591,1287,4417
Keith Booth,2.0,1998 - 1999,SF,45,449,51,157,32.48407643312102,1,11,9.090909090909092,50,146,34.24657534246575,32.802547770700635,27,48,56.25,27,70,97,39,22,11,42,63,130
Keith Closs,3.0,1998 - 2000,C,130,1647,201,427,47.07259953161593,0,4,0.0,201,423,47.5177304964539,47.07259953161593,100,165,60.60606060606061,133,239,372,44,28,163,78,167,502
Keith Edmonson,2.0,1983 - 1984,SG,88,933,207,461,44.90238611713666,0,2,0.0,207,459,45.09803921568628,44.90238611713666,110,153,71.89542483660131,67,61,128,57,37,13,81,124,524
Keith Herron,2.0,1981 - 1982,SG,110,2539,471,1060,44.43396226415094,2,12,16.666666666666664,469,1048,44.75190839694657,44.528301886792455,235,275,85.45454545454545,108,124,232,171,99,28,165,179,1179
Keith Jennings,3.0,1993 - 1995,PG,167,2994,357,822,43.43065693430657,137,369,37.12737127371274,220,453,48.56512141280353,51.763990267639905,254,298,85.23489932885906,45,208,253,618,165,2,205,224,1105
Keith Langford,1.0,2008 - 2008,SG,2,10,1,4,25.0,0,0,,1,4,25.0,25.0,0,0,,0,2,2,0,0,0,0,1,2
Keith Lee,3.0,1986 - 1989,PF,182,2907,456,1012,45.059288537549406,2,12,16.666666666666664,454,1000,45.4,45.15810276679842,200,268,74.6268656716418,282,579,861,178,74,110,216,489,1114
Keith McCord,1.0,1981 - 1981,SG,2,9,2,4,50.0,0,0,,2,4,50.0,50.0,0,0,,1,1,2,1,0,0,2,0,4
Keith McLeod,4.0,2004 - 2007,PG,200,3723,363,1018,35.65815324165029,59,209,28.22966507177033,304,809,37.57725587144623,38.555992141453835,320,400,80.0,40,228,268,536,145,27,250,359,1105
Keith Owens,1.0,1992 - 1992,SF,20,80,9,32,28.125,0,0,,9,32,28.125,28.125,8,10,80.0,8,7,15,3,5,4,2,11,26
Keith Smart,1.0,1989 - 1989,PG,2,12,0,2,0.0,0,1,0.0,0,1,0.0,0.0,2,2,100.0,0,1,1,2,0,0,2,0,2
Keith Smith,1.0,1987 - 1987,SG,42,461,57,150,38.0,3,9,33.33333333333333,54,141,38.297872340425535,39.0,21,28,75.0,13,19,32,43,25,3,30,74,138
Keith Tower,4.0,1994 - 1997,C,53,416,39,91,42.857142857142854,0,1,0.0,39,90,43.333333333333336,42.857142857142854,20,36,55.55555555555556,25,44,69,7,6,12,19,69,98
Keith Van Horn,9.0,1998 - 2006,SF,632,19614,3591,8161,44.001960544050974,660,1816,36.34361233480176,2931,6345,46.19385342789598,48.04558264918515,1906,2289,83.26780253385758,1196,3006,4202,961,509,313,1342,1885,9748
Kelenna Azubuike,5.0,2007 - 2012,SG,215,5045,804,1754,45.83808437856328,211,516,40.89147286821706,593,1238,47.89983844911147,51.85290763968074,366,475,77.05263157894737,259,575,834,230,132,103,204,409,2185
Kelly McCarty,1.0,1999 - 1999,SG,2,4,2,3,66.66666666666666,0,0,,2,3,66.66666666666666,66.66666666666666,0,0,,2,1,3,0,0,0,2,0,4
Kelly Olynyk,6.0,2014 - 2019,C,464,9924,1668,3485,47.8622668579627,499,1365,36.556776556776555,1169,2120,55.14150943396226,55.02152080344332,701,920,76.19565217391305,563,1642,2205,876,332,222,673,1298,4536
Kelly Oubre,4.0,2016 - 2019,SF,310,6774,1013,2394,42.3141186299081,328,1023,32.06256109481916,685,1371,49.963530269876,49.16457811194653,509,653,77.947932618683,226,907,1133,250,260,126,289,764,2863
Kelly Tripucka,10.0,1982 - 1991,SF,732,21709,4579,9694,47.23540334227357,168,470,35.74468085106383,4411,9224,47.82090199479618,48.10191871260574,3207,3778,84.88618316569614,978,1818,2796,2147,700,142,1758,1699,12533
Kelvin Cato,10.0,1998 - 2007,C,562,10881,1149,2269,50.639048038783606,1,14,7.142857142857142,1148,2255,50.90909090909091,50.66108417805201,728,1135,64.1409691629956,910,2024,2934,249,299,697,459,1392,3027
Kelvin Ransey,6.0,1981 - 1986,PG,488,11892,2252,4979,45.22996585659771,22,157,14.012738853503185,2230,4822,46.24637080049772,45.45089375376581,960,1228,78.17589576547232,235,691,926,2544,481,37,980,956,5486
Kelvin Upshaw,3.0,1989 - 1991,SG,123,1542,272,601,45.25790349417637,14,59,23.728813559322035,258,542,47.601476014760145,46.422628951747086,101,127,79.52755905511812,39,108,147,262,82,9,122,214,659
Kemba Walker,8.0,2012 - 2019,PG,616,21020,4246,10170,41.750245821042284,1309,3656,35.804157549234134,2937,6514,45.087503837887624,48.1858407079646,2445,2924,83.61833105335157,353,2000,2353,3360,816,240,1344,927,12246
Ken Austin,1.0,1984 - 1984,SF,7,28,6,13,46.15384615384615,0,0,,6,13,46.15384615384615,46.15384615384615,0,0,,2,1,3,1,1,1,3,7,12
Ken Bannister,5.0,1985 - 1991,PF,253,3867,586,1202,48.75207986688852,0,4,0.0,586,1198,48.91485809682805,48.75207986688852,329,669,49.17787742899851,276,617,893,111,109,80,347,669,1501
Ken Green,1.0,1986 - 1986,PF,7,72,13,27,48.148148148148145,0,0,,13,27,48.148148148148145,48.148148148148145,5,9,55.55555555555556,12,15,27,2,4,0,1,8,31
Ken Johnson,2.0,1986 - 2003,PF,82,982,128,251,50.99601593625498,0,0,,128,251,50.99601593625498,50.99601593625498,39,91,42.857142857142854,94,183,277,19,16,34,66,168,295
Ken Norman,10.0,1988 - 1997,SF,659,19382,3796,7833,48.46163666539002,235,759,30.96179183135705,3561,7074,50.3392705682782,49.96170049789353,1033,1832,56.38646288209607,1387,2661,4048,1385,525,435,1183,1522,8860
Kendall Gill,15.0,1991 - 2005,SG,993,30277,5196,11986,43.35057567161689,322,1078,29.87012987012987,4874,10908,44.68280161349468,44.69380944435174,2522,3353,75.21622427676708,1317,2785,4102,3001,1558,442,1771,2589,13236
Kendall Marshall,4.0,2013 - 2016,PG,160,3083,315,789,39.92395437262358,128,346,36.99421965317919,187,443,42.21218961625282,48.03548795944233,44,72,61.111111111111114,23,230,253,779,107,10,285,180,802
Kendrick Perkins,14.0,2004 - 2018,C,925,20531,1995,3797,52.54148011588096,0,18,0.0,1995,3779,52.79174384757872,52.54148011588096,959,1587,60.428481411468184,1574,3801,5375,915,316,1059,1451,2595,4949
Kennard Winchester,3.0,1991 - 1993,SG,125,1039,175,419,41.766109785202865,13,41,31.70731707317073,162,378,42.857142857142854,43.31742243436754,60,78,76.92307692307693,57,74,131,48,28,25,48,115,423
Kenneth Faried,8.0,2012 - 2019,PF,490,12065,2242,4101,54.66959278224823,10,45,22.22222222222222,2232,4056,55.02958579881657,54.79151426481346,1060,1617,65.5534941249227,1502,2494,3996,475,361,401,645,1222,5554
Kenny Anderson,14.0,1992 - 2005,PG,894,26872,4134,9837,42.025007624275695,555,1609,34.493474207582345,3579,8228,43.49781234807973,44.84598963098506,2312,2926,79.01572112098428,688,2038,2726,5331,1300,112,1827,2063,11135
Kenny Battle,4.0,1990 - 1993,SG,142,1829,247,495,49.898989898989896,4,30,13.333333333333334,243,465,52.25806451612903,50.303030303030305,138,190,72.63157894736842,139,193,332,106,98,31,93,219,636
Kenny Dennard,3.0,1982 - 1984,PF,95,1244,109,254,42.91338582677165,3,10,30.0,106,244,43.44262295081967,43.503937007874015,47,73,64.38356164383562,104,182,286,93,74,17,69,191,268
Kenny Fields,4.0,1985 - 1988,SF,196,2850,501,1046,47.89674952198853,4,19,21.052631578947366,497,1027,48.393378773125605,48.087954110898664,223,311,71.70418006430869,183,309,492,198,105,38,197,417,1229
Kenny Gattison,9.0,1987 - 1996,PF,507,10172,1563,3010,51.926910299003325,1,12,8.333333333333332,1562,2998,52.101400933955965,51.943521594684384,864,1338,64.57399103139014,768,1610,2378,457,297,328,614,1453,3991
Kenny Green,2.0,1986 - 1987,SF,60,625,108,262,41.221374045801525,0,1,0.0,108,261,41.37931034482759,41.221374045801525,49,68,72.05882352941177,33,68,101,16,9,11,50,61,265
Kenny Higgs,2.0,1981 - 1982,PG,151,3439,419,963,43.509865005192104,8,57,14.035087719298245,411,906,45.36423841059602,43.925233644859816,308,381,80.83989501312337,48,244,292,809,176,12,327,518,1154
Kenny Natt,3.0,1981 - 1985,SG,49,388,65,156,41.66666666666667,2,10,20.0,63,146,43.15068493150685,42.30769230769231,18,29,62.06896551724138,17,23,40,41,12,1,35,57,150
Kenny Payne,4.0,1990 - 1993,SF,147,1177,220,537,40.9683426443203,17,60,28.333333333333332,203,477,42.55765199161425,42.5512104283054,57,66,86.36363636363636,46,126,172,61,38,22,68,132,514
Kenny Satterfield,2.0,2002 - 2003,PG,75,1062,128,382,33.50785340314136,12,55,21.818181818181817,116,327,35.47400611620795,35.07853403141361,53,71,74.64788732394366,33,62,95,176,51,3,96,79,321
Kenny Smith,10.0,1988 - 1997,PG,805,24256,3795,7938,47.80801209372638,781,1926,40.55036344755971,3014,6012,50.133067198935464,52.72738725119678,1806,2176,82.99632352941177,303,1298,1601,4378,813,74,1753,1308,10177
Kenny Thomas,11.0,2000 - 2010,PF,655,17996,2399,5136,46.7095015576324,59,242,24.380165289256198,2340,4894,47.81364936657131,47.2838785046729,1241,1777,69.8368036015757,1518,3006,4524,1006,544,283,1090,1667,6098
Kenny Walker,7.0,1987 - 1995,SF,474,9405,1271,2630,48.32699619771863,7,35,20.0,1264,2595,48.70905587668594,48.460076045627375,668,893,74.80403135498321,759,1091,1850,314,239,310,360,1247,3217
Kenny Williams,4.0,1991 - 1994,SF,277,3023,557,1096,50.82116788321168,0,14,0.0,557,1082,51.478743068391864,50.82116788321168,155,231,67.09956709956711,321,389,710,168,82,171,142,386,1269
Kenrich Williams,1.0,2019 - 2019,SF,46,1079,107,279,38.35125448028674,52,156,33.33333333333333,55,123,44.71544715447154,47.67025089605735,13,19,68.42105263157895,55,164,219,83,45,19,36,95,279
Kent Bazemore,7.0,2013 - 2019,SG,524,10774,1604,3856,41.59751037344399,535,1553,34.44945267224727,1069,2303,46.41771602257924,48.5347510373444,728,1019,71.44259077526988,187,1440,1627,973,521,247,750,971,4471
Kentavious Caldwell-Pope,6.0,2014 - 2019,SG,474,14142,2032,4924,41.26726238830219,801,2312,34.64532871972318,1231,2612,47.12863705972435,49.40089358245329,791,991,79.8183652875883,319,1264,1583,778,553,89,477,880,5656
Kenton Edelin,1.0,1985 - 1985,SF,10,143,4,13,30.76923076923077,0,0,,4,13,30.76923076923077,30.76923076923077,3,8,37.5,8,18,26,10,5,4,3,39,11
Kenyon Martin,15.0,2001 - 2015,PF,869,26723,4454,9264,48.07858376511226,70,313,22.364217252396166,4384,8951,48.97776784716791,48.45639032815199,1788,2809,63.652545389818435,1514,4403,5917,1641,1014,1002,1535,2956,10766
Keon Clark,6.0,1999 - 2004,C,381,8419,1236,2478,49.87893462469734,1,19,5.263157894736842,1235,2459,50.22366815778771,49.89911218724778,566,868,65.2073732718894,690,1513,2203,340,191,590,501,1078,3039
Kerry Kittles,8.0,1997 - 2005,SG,561,18663,3029,6927,43.72744333766421,760,2034,37.364798426745324,2269,4893,46.372368689965256,49.21322361772773,1011,1303,77.59017651573292,561,1617,2178,1411,898,247,673,1009,7829
Kevin Brooks,3.0,1992 - 1994,SF,128,1036,174,436,39.908256880733944,12,61,19.672131147540984,162,375,43.2,41.284403669724774,62,73,84.93150684931507,41,102,143,48,18,6,69,84,422
Kevin Burleson,1.0,2006 - 2006,PG,39,340,22,88,25.0,10,54,18.51851851851852,12,34,35.294117647058826,30.681818181818183,16,17,94.11764705882352,4,22,26,48,26,2,25,63,70
Kevin Duckworth,11.0,1987 - 1997,C,751,19418,3539,7593,46.60871855656526,5,25,20.0,3534,7568,46.696617336152215,46.641643619122874,1787,2437,73.32786212556421,1512,2826,4338,682,359,350,1392,2441,8870
Kevin Durant,12.0,2008 - 2019,SF,976,36461,9052,18488,48.96148853310255,1839,4905,37.49235474006116,7213,13583,53.10314363542664,53.934984855041115,6653,7565,87.94448116325182,730,6274,7004,3989,1074,1092,3048,1924,26596
Kevin Edwards,11.0,1989 - 2001,SG,611,15535,2673,6322,42.28092375830433,176,527,33.396584440227706,2497,5795,43.08886971527179,43.67288832647896,1138,1417,80.3105151729005,525,1151,1676,1625,832,198,1152,1040,6660
Kevin Gamble,10.0,1988 - 1997,SF,680,15263,2683,5355,50.10270774976657,233,649,35.901386748844374,2450,4706,52.06119847003825,52.278244631185814,826,1023,80.74291300097751,391,1132,1523,1356,493,185,610,1291,6425
Kevin Garnett,21.0,1996 - 2016,PF,1605,55701,11564,23358,49.50766332733967,189,687,27.510917030567683,11375,22671,50.174231396938815,49.91223563661272,5355,6783,78.94736842105263,3529,12667,16196,5916,2037,2223,3521,3992,28672
Kevin Henderson,2.0,1987 - 1988,PG,22,235,24,61,39.34426229508197,0,1,0.0,24,60,40.0,39.34426229508197,17,28,60.71428571428571,10,14,24,34,9,0,21,35,65
Kevin Huerter,1.0,2019 - 2019,SG,75,2048,275,657,41.856925418569254,136,353,38.52691218130311,139,304,45.723684210526315,52.207001522070016,41,56,73.21428571428571,60,185,245,214,65,25,109,155,727
Kevin Johnson,12.0,1988 - 2000,PG,840,28940,5217,10664,48.92160540135034,182,614,29.64169381107492,5035,10050,50.099502487562184,49.77494373593399,4537,5404,83.95632864544783,557,2196,2753,7646,1214,206,2612,1774,15153
Kevin Jones,1.0,2013 - 2013,PF,32,334,43,107,40.18691588785047,0,0,,43,107,40.18691588785047,40.18691588785047,9,15,60.0,38,40,78,10,9,5,8,25,95
Kevin Knox,1.0,2019 - 2019,PF,75,2158,338,914,36.98030634573304,125,364,34.34065934065934,213,550,38.72727272727273,43.818380743982495,162,226,71.68141592920354,61,274,335,82,43,24,114,175,963
Kevin Loder,3.0,1982 - 1984,SF,148,2094,365,791,46.144121365360306,6,23,26.08695652173913,359,768,46.74479166666667,46.523388116308475,139,200,69.5,113,225,338,174,67,43,143,261,875
Kevin Love,11.0,2009 - 2019,PF,720,22981,4266,9722,43.879860111088256,1218,3261,37.35050597976081,3048,6461,47.17535985141619,50.1440032915038,3222,3889,82.84906145538699,2043,5963,8006,1635,499,337,1376,1559,12972
Kevin Lynch,2.0,1992 - 1993,SG,96,1146,123,282,43.61702127659575,3,9,33.33333333333333,120,273,43.956043956043956,44.148936170212764,61,84,72.61904761904762,42,78,120,109,48,15,68,151,310
Kevin Martin,12.0,2005 - 2016,SG,736,22128,3926,9000,43.62222222222222,1168,3042,38.39579224194608,2758,5958,46.29070157771064,50.11111111111111,3631,4166,87.15794527124339,413,1933,2346,1372,654,83,1219,1395,12651
Kevin McHale,13.0,1981 - 1993,PF,1140,35834,8034,14479,55.487257407279515,49,178,27.52808988764045,7985,14301,55.83525627578491,55.65646798812073,4400,5526,79.62359753890699,2814,5561,8375,1944,409,1971,2219,3329,20517
Kevin McKenna,6.0,1982 - 1988,SG,244,3462,498,1204,41.36212624584717,103,281,36.654804270462634,395,923,42.79523293607801,45.63953488372093,221,270,81.85185185185185,102,215,317,342,184,25,204,491,1320
Kevin Murphy,1.0,2013 - 2013,SG,17,52,7,28,25.0,1,5,20.0,6,23,26.08695652173913,26.785714285714285,0,0,,0,4,4,2,1,0,3,4,15
Kevin Ollie,13.0,1998 - 2010,PG,704,10627,873,2130,40.985915492957744,10,31,32.25806451612903,863,2099,41.11481657932349,41.220657276995304,826,1037,79.65284474445517,148,897,1045,1562,342,25,508,831,2582
Kevin Pritchard,4.0,1991 - 1996,PG,94,1125,119,298,39.93288590604027,8,43,18.6046511627907,111,255,43.529411764705884,41.2751677852349,94,119,78.99159663865547,17,73,90,152,37,13,82,146,340
Kevin Salvadori,2.0,1997 - 1998,C,39,241,13,46,28.26086956521739,0,0,,13,46,28.26086956521739,28.26086956521739,16,24,66.66666666666666,11,34,45,13,2,24,17,29,42
Kevin Seraphin,7.0,2011 - 2017,C,437,6567,1161,2378,48.82253994953742,0,7,0.0,1161,2371,48.966680725432305,48.82253994953742,256,360,71.11111111111111,514,983,1497,252,90,307,458,924,2578
Kevin Stacom,1.0,1982 - 1982,SG,7,90,14,34,41.17647058823529,1,2,50.0,13,32,40.625,42.64705882352941,1,2,50.0,2,5,7,7,1,0,9,6,30
Kevin Thompson,1.0,1994 - 1994,C,14,58,6,14,42.857142857142854,0,1,0.0,6,13,46.15384615384615,42.857142857142854,1,2,50.0,7,6,13,3,0,2,5,11,13
Kevin Williams,5.0,1984 - 1989,SG,281,3279,548,1250,43.84,2,30,6.666666666666667,546,1220,44.75409836065574,43.919999999999995,306,383,79.89556135770235,184,214,398,359,186,35,268,640,1404
Kevin Willis,21.0,1985 - 2007,PF,1522,40739,7493,15395,48.671646638519,43,204,21.07843137254902,7450,15191,49.04219603712725,48.81130237089965,3194,4485,71.21516164994426,4366,8172,12538,1388,1018,789,2649,4466,18223
Kevinn Pinkney,1.0,2007 - 2007,PF,6,100,12,27,44.44444444444444,1,2,50.0,11,25,44.0,46.2962962962963,6,9,66.66666666666666,7,8,15,5,3,3,4,12,31
Kevon Looney,4.0,2016 - 2019,C,225,3246,428,726,58.95316804407713,5,28,17.857142857142858,423,698,60.60171919770774,59.29752066115702,136,237,57.383966244725734,367,488,855,213,109,134,108,433,997
Keyon Dooling,13.0,2001 - 2013,PG,791,14937,1916,4596,41.688424717145345,479,1363,35.143066764490094,1437,3233,44.44788122486854,46.89947780678851,1043,1304,79.98466257668711,138,879,1017,1656,484,82,831,1328,5354
Khalid El-Amin,1.0,2001 - 2001,PG,50,936,115,311,36.97749196141479,28,84,33.33333333333333,87,227,38.32599118942731,41.47909967845659,56,72,77.77777777777779,21,60,81,145,48,2,54,99,314
Khalid Reeves,6.0,1995 - 2000,PG,277,5837,744,1788,41.61073825503356,235,647,36.321483771251934,509,1141,44.60999123575811,48.182326621923934,444,597,74.37185929648241,163,417,580,886,234,32,446,629,2167
Khem Birch,2.0,2018 - 2019,C,92,1221,159,277,57.400722021660656,0,1,0.0,159,276,57.608695652173914,57.400722021660656,100,144,69.44444444444444,149,221,370,72,33,50,41,128,418
Khris Middleton,7.0,2013 - 2019,SF,474,15167,2733,6041,45.24085416321801,799,2043,39.10915320606951,1934,3998,48.37418709354677,51.85399768250289,1219,1405,86.76156583629894,270,1838,2108,1534,623,97,894,1265,7484
Khyri Thomas,1.0,2019 - 2019,SG,26,195,22,69,31.88405797101449,10,35,28.57142857142857,12,34,35.294117647058826,39.130434782608695,7,11,63.63636363636363,4,16,20,8,7,5,4,22,61
Kiki Vandeweghe,13.0,1981 - 1993,SF,878,26411,6558,12521,52.37600830604584,238,650,36.61538461538461,6320,11871,53.23898576362565,53.32641162846418,3719,4256,87.38251879699249,946,2027,2973,1802,507,270,1399,1692,17073
Kim English,1.0,2013 - 2013,SG,41,407,42,112,37.5,14,50,28.000000000000004,28,62,45.16129032258064,43.75,21,29,72.41379310344827,8,29,37,26,16,3,19,46,119
Kirk Haston,2.0,2002 - 2003,SF,29,138,14,57,24.561403508771928,0,6,0.0,14,51,27.450980392156865,24.561403508771928,6,12,50.0,5,23,28,8,1,6,10,20,34
Kirk Hinrich,13.0,2004 - 2016,PG,950,29026,3771,9148,41.22212505465676,1264,3348,37.753882915173236,2507,5800,43.224137931034484,48.130738959335375,1535,1930,79.53367875647669,328,2434,2762,4522,1046,260,1714,2678,10341
Kirk Penney,2.0,2004 - 2005,SG,6,30,2,9,22.22222222222222,1,4,25.0,1,5,20.0,27.77777777777778,0,0,,0,2,2,2,1,0,5,1,5
Kirk Snyder,4.0,2005 - 2008,SG,214,3549,490,1119,43.78909740840036,92,283,32.50883392226148,398,836,47.60765550239234,47.899910634495086,263,376,69.9468085106383,152,340,492,241,86,69,207,328,1335
Kiwane Garris,2.0,1998 - 2000,SG,31,248,24,75,32.0,5,15,33.33333333333333,19,60,31.666666666666664,35.333333333333336,19,25,76.0,3,17,20,30,7,1,16,22,72
Klay Thompson,8.0,2012 - 2019,SG,717,24092,5231,11462,45.63775955330658,2102,5034,41.75605880015892,3129,6428,48.677660236465464,54.80718897225615,1368,1619,84.49660284126004,332,2198,2530,1644,652,383,1235,1590,13932
Kobe Bryant,20.0,1997 - 2016,SG,1566,57278,13733,30699,44.73435616795335,2119,6428,32.96515245799627,11614,24271,47.85134522681389,48.185608651747614,9698,11628,83.40213278293773,1729,6437,8166,7346,2254,784,4657,4013,39283
Kobi Simmons,2.0,2018 - 2019,PG,33,645,80,189,42.32804232804233,11,39,28.205128205128204,69,150,46.0,45.23809523809524,25,25,100.0,14,36,50,68,18,5,44,61,196
Korleone Young,1.0,1999 - 1999,SF,3,15,5,10,50.0,1,4,25.0,4,6,66.66666666666666,55.00000000000001,2,2,100.0,2,2,4,1,0,0,1,3,13
Kornel David,3.0,1999 - 2001,SF,109,1585,201,451,44.567627494456765,0,4,0.0,201,447,44.966442953020135,44.567627494456765,147,180,81.66666666666667,111,195,306,64,46,24,92,172,549
Kosta Koufos,11.0,2009 - 2019,C,723,11602,1787,3357,53.23205242776289,1,5,20.0,1786,3352,53.28162291169451,53.24694667858206,425,725,58.620689655172406,1241,2306,3547,368,300,521,490,1439,4000
Kosta Perovic,1.0,2008 - 2008,C,7,38,3,10,30.0,0,0,,3,10,30.0,30.0,4,6,66.66666666666666,6,7,13,1,0,2,1,6,10
Kostas Antetokounmpo,1.0,2019 - 2019,PF,2,11,0,3,0.0,0,0,,0,3,0.0,0.0,2,4,50.0,0,1,1,0,2,0,1,0,2
Kostas Papanikolaou,2.0,2015 - 2016,SF,77,1110,94,267,35.2059925093633,41,141,29.078014184397162,53,126,42.06349206349206,42.88389513108614,23,34,67.64705882352942,47,113,160,101,42,18,81,99,252
Kris Dunn,3.0,2017 - 2019,PG,176,4247,619,1485,41.68350168350168,98,303,32.34323432343234,521,1182,44.077834179357026,44.98316498316498,175,242,72.31404958677686,67,507,574,775,250,84,343,518,1511
Kris Humphries,13.0,2005 - 2017,PF,822,14450,2109,4555,46.30076838638858,60,198,30.303030303030305,2049,4357,47.02777140234106,46.95938529088913,1151,1647,69.88463873709775,1412,2969,4381,562,330,465,698,1492,5429
Kris Joseph,1.0,2013 - 2013,SF,10,54,2,14,14.285714285714285,0,3,0.0,2,11,18.181818181818183,14.285714285714285,5,8,62.5,1,6,7,1,3,0,2,3,9
Kristaps Porzingis,3.0,2016 - 2018,PF,186,5764,1206,2760,43.69565217391304,283,785,36.05095541401273,923,1975,46.734177215189874,48.822463768115945,617,767,80.4432855280313,305,1012,1317,248,136,378,332,590,3312
Kurk Lee,1.0,1991 - 1991,PG,48,265,19,71,26.76056338028169,3,15,20.0,16,56,28.57142857142857,28.87323943661972,25,28,89.28571428571429,7,23,30,34,11,2,20,39,66
Kurt Nimphius,8.0,1982 - 1990,C,589,11747,1477,3046,48.48982271831911,2,20,10.0,1475,3026,48.74421678783873,48.522652659225216,716,1068,67.04119850187266,917,1638,2555,699,193,715,573,1683,3672
Kurt Rambis,14.0,1982 - 1995,PF,1019,18864,2086,3871,53.8878842676311,0,15,0.0,2086,3856,54.09751037344398,53.8878842676311,1150,1665,69.06906906906907,1876,3849,5725,1050,846,524,1174,2409,5322
Kurt Thomas,18.0,1996 - 2013,PF,1206,29054,4060,8378,48.46025304368584,9,34,26.47058823529412,4051,8344,48.54985618408437,48.513965146813085,1378,1816,75.88105726872246,2070,5772,7842,1268,766,892,1335,3879,9507
Kwame Brown,12.0,2002 - 2013,C,625,13855,1579,3210,49.190031152647975,1,9,11.11111111111111,1578,3201,49.2970946579194,49.205607476635514,1033,1803,57.29339988907377,1125,2312,3437,565,327,391,797,1439,4192
Kyle Anderson,5.0,2015 - 2019,SF,330,6279,699,1416,49.36440677966102,62,196,31.63265306122449,637,1220,52.213114754098356,51.55367231638418,274,386,70.98445595854922,214,1040,1254,607,317,165,274,443,1734
Kyle Collinsworth,1.0,2018 - 2018,SF,32,480,38,99,38.38383838383838,4,17,23.52941176470588,34,82,41.46341463414634,40.4040404040404,21,40,52.5,32,75,107,56,17,9,24,44,101
Kyle Korver,16.0,2004 - 2019,SG,1305,33445,4341,9856,44.04423701298701,2588,6084,42.537804076265616,1753,3772,46.474019088016966,57.17329545454546,1381,1571,87.9057924888606,356,3512,3868,2197,856,446,1355,2711,12651
Kyle Kuzma,2.0,2018 - 2019,PF,147,4715,964,2126,45.34336782690499,287,856,33.52803738317757,677,1270,53.30708661417323,52.09313264346191,335,458,73.14410480349345,148,717,865,319,90,60,273,330,2550
Kyle Lowry,13.0,2007 - 2019,PG,918,28864,4297,10165,42.272503689129366,1641,4491,36.539746158984634,2656,5674,46.81001057455058,50.34431874077717,3068,3818,80.35620743844945,751,3158,3909,5559,1238,249,2107,2500,13303
Kyle Macy,7.0,1981 - 1987,PG,595,15504,2344,4702,49.85112717992344,212,622,34.08360128617363,2132,4080,52.254901960784316,52.10548702679711,761,874,87.07093821510298,345,981,1326,2368,675,52,768,1180,5661
Kyle O'Quinn,7.0,2013 - 2019,C,443,6401,1043,2014,51.78748758689176,24,115,20.869565217391305,1019,1899,53.659820958399166,52.38331678252235,356,476,74.78991596638656,594,1456,2050,592,182,429,438,923,2466
Kyle Singler,6.0,2013 - 2018,SF,363,7855,846,2025,41.77777777777778,301,830,36.265060240963855,545,1195,45.60669456066946,49.20987654320987,341,436,78.21100917431193,318,716,1034,272,204,110,278,740,2334
Kyle Weaver,3.0,2009 - 2011,SG,74,1391,135,308,43.83116883116883,42,120,35.0,93,188,49.46808510638298,50.649350649350644,53,72,73.61111111111111,34,126,160,121,55,33,80,99,365
Kyle Wiltjer,1.0,2017 - 2017,PF,15,49,5,15,33.33333333333333,5,14,35.714285714285715,0,1,0.0,50.0,1,2,50.0,4,6,10,2,3,1,5,4,16
Kyrie Irving,8.0,2012 - 2019,PG,560,19060,4602,9894,46.51303820497271,1185,3022,39.212442091330246,3417,6872,49.72351571594878,52.501516070345666,2148,2455,87.4949083503055,423,1589,2012,3127,748,209,1459,1231,12537
Kyrylo Fesenko,5.0,2008 - 2012,C,145,1288,138,282,48.93617021276596,0,2,0.0,138,280,49.28571428571429,48.93617021276596,62,155,40.0,105,203,308,52,19,58,80,254,338
LaBradford Smith,3.0,1992 - 1994,SG,183,3131,485,1122,43.22638146167558,31,104,29.807692307692307,454,1018,44.59724950884086,44.6078431372549,217,267,81.27340823970037,90,181,271,394,142,15,216,372,1218
LaMarcus Aldridge,13.0,2007 - 2019,PF,1015,35188,8057,16488,48.86584182435711,135,468,28.846153846153843,7922,16020,49.45068664169788,49.27523047064532,3703,4565,81.1171960569551,2745,5770,8515,1956,741,1117,1603,2520,19952
LaMark Baker,1.0,1999 - 1999,PG,1,2,0,1,0.0,0,0,,0,1,0.0,0.0,0,0,,0,0,0,0,0,0,1,0,0
LaPhonso Ellis,11.0,1993 - 2003,PF,640,18129,2972,6574,45.208396714329176,244,804,30.34825870646766,2728,5770,47.2790294627383,47.06419227258899,1423,1950,72.97435897435898,1354,2789,4143,1007,443,491,1025,1993,7611
LaSalle Thompson,15.0,1983 - 1997,C,1013,21785,3207,6539,49.04419636029974,4,26,15.384615384615385,3203,6513,49.17856594503301,49.07478207677015,1566,2120,73.86792452830188,2172,4665,6837,1167,757,997,1683,3222,7984
Lamar Odom,14.0,2000 - 2013,PF,1069,35730,5344,11505,46.44936983920035,721,2314,31.15816767502161,4623,9191,50.299205744750296,49.58279009126467,2779,4041,68.77010640930463,2076,6938,9014,3818,920,1004,2467,3286,14188
Lamar Patterson,2.0,2016 - 2017,SG,44,455,33,102,32.35294117647059,14,58,24.137931034482758,19,44,43.18181818181818,39.21568627450981,19,26,73.07692307692307,5,57,62,48,11,2,31,52,99
Lamond Murray,11.0,1995 - 2006,SF,750,18739,3164,7375,42.90169491525423,542,1508,35.94164456233422,2622,5867,44.6906425771263,46.57627118644068,1500,1973,76.02635580334515,947,2135,3082,983,689,322,1214,1503,8370
Lamont Strothers,2.0,1992 - 1993,SG,13,155,24,73,32.87671232876712,2,15,13.333333333333334,22,58,37.93103448275862,34.24657534246575,10,14,71.42857142857143,9,6,15,14,9,1,17,15,60
Lanard Copeland,2.0,1990 - 1992,SG,37,167,40,97,41.23711340206185,1,7,14.285714285714285,39,90,43.333333333333336,41.75257731958763,13,16,81.25,5,13,18,14,3,1,24,18,94
Lancaster Gordon,4.0,1985 - 1988,SG,201,2581,472,1208,39.0728476821192,23,85,27.058823529411764,449,1123,39.982190560997324,40.02483443708609,158,206,76.69902912621359,116,143,259,294,128,31,237,266,1125
Lance Allred,1.0,2008 - 2008,C,3,10,1,4,25.0,0,0,,1,4,25.0,25.0,1,2,50.0,0,1,1,0,0,0,0,1,3
Lance Blanks,3.0,1991 - 1993,SG,143,1055,117,268,43.656716417910445,19,75,25.333333333333336,98,193,50.77720207253886,47.201492537313435,38,57,66.66666666666666,31,80,111,120,42,8,64,124,291
Lance Stephenson,9.0,2011 - 2019,SG,565,13607,1989,4477,44.42707169979897,406,1281,31.693989071038253,1583,3196,49.53066332916145,48.961358052267144,603,883,68.28992072480182,375,2070,2445,1638,377,79,936,1135,4987
Lance Thomas,8.0,2012 - 2019,PF,392,7225,740,1773,41.73716864072194,161,420,38.333333333333336,579,1353,42.793791574279375,46.277495769881554,385,483,79.71014492753623,291,717,1008,260,148,55,260,672,2026
Landry Fields,5.0,2011 - 2015,SF,267,6222,702,1494,46.98795180722892,121,370,32.7027027027027,581,1124,51.69039145907474,51.03748326639893,249,378,65.87301587301587,255,864,1119,432,221,49,284,317,1774
Landry Shamet,1.0,2019 - 2019,SG,79,1802,240,557,43.08797127468581,167,396,42.17171717171717,73,161,45.3416149068323,58.07899461400359,75,93,80.64516129032258,21,113,134,117,37,10,45,155,722
Langston Galloway,5.0,2015 - 2019,PG,339,7593,996,2571,38.739789964994166,469,1306,35.91117917304747,527,1265,41.6600790513834,47.86075457020614,314,393,79.89821882951654,169,728,897,593,247,53,210,576,2775
Lari Ketner,2.0,2000 - 2001,PF,25,139,13,32,40.625,0,0,,13,32,40.625,40.625,8,12,66.66666666666666,12,22,34,2,4,3,12,20,34
Laron Profit,4.0,2000 - 2006,SG,138,1542,173,415,41.68674698795181,21,89,23.595505617977526,152,326,46.62576687116564,44.21686746987952,74,104,71.15384615384616,52,158,210,167,70,25,116,138,441
Larry Drew,12.0,1981 - 2018,PG,767,18952,3373,7252,46.511307225592944,130,458,28.38427947598253,3243,6794,47.73329408301443,47.40761169332598,1392,1744,79.81651376146789,263,1035,1298,3807,808,45,1611,1338,8268
Larry Hughes,13.0,1999 - 2012,SG,776,24000,3950,9787,40.35966077449678,559,1818,30.748074807480748,3391,7969,42.552390513238805,43.215489935628895,2400,3165,75.82938388625593,791,2467,3258,2429,1172,280,1652,1778,10859
Larry Johnson,10.0,1992 - 2001,PF,773,28082,4752,9813,48.425557933353716,414,1259,32.88324066719619,4338,8554,50.71311667056347,50.5350045857536,2469,3223,76.60564691281415,1896,3755,5651,2432,570,269,1556,2095,12387
Larry Krystkowiak,9.0,1987 - 1997,PF,440,9624,1344,2952,45.52845528455284,5,38,13.157894736842104,1339,2914,45.95058339052848,45.613143631436316,879,1099,79.98180163785258,678,1482,2160,543,274,65,546,1101,3572
Larry Micheaux,2.0,1984 - 1985,PF,104,1019,158,284,55.633802816901415,0,4,0.0,158,280,56.42857142857143,55.633802816901415,60,102,58.82352941176471,126,172,298,52,41,39,62,139,376
Larry Nance,17.0,1982 - 2019,PF,1267,39356,7688,14090,54.563520227111425,54,213,25.352112676056336,7634,13877,55.01189017799236,54.75514549325763,3421,4577,74.7432816255189,3068,6594,9662,3007,1271,2325,2076,3595,18851
Larry Owens,2.0,2011 - 2012,SF,19,218,19,43,44.18604651162791,8,18,44.44444444444444,11,25,44.0,53.48837209302325,7,13,53.84615384615385,3,25,28,12,9,6,7,28,53
Larry Robinson,7.0,1991 - 2002,SG,89,1202,153,398,38.44221105527638,50,134,37.3134328358209,103,264,39.015151515151516,44.72361809045226,44,66,66.66666666666666,61,106,167,82,56,4,66,107,400
Larry Sanders,6.0,2011 - 2017,C,242,4748,688,1428,48.17927170868347,0,5,0.0,688,1423,48.348559381588196,48.17927170868347,187,340,55.00000000000001,486,892,1378,179,155,434,236,684,1563
Larry Smith,13.0,1981 - 1993,PF,914,23536,2575,4855,53.03810504634397,0,8,0.0,2575,4847,53.12564472869816,53.03810504634397,886,1659,53.40566606389391,3500,4844,8344,984,726,477,1308,3067,6036
Larry Spriggs,5.0,1982 - 1986,SF,199,2499,396,765,51.76470588235295,0,8,0.0,396,757,52.3117569352708,51.76470588235295,230,305,75.40983606557377,146,306,452,258,85,34,242,388,1022
Larry Stewart,5.0,1992 - 1997,SF,274,5431,770,1509,51.027170311464545,10,46,21.73913043478261,760,1463,51.94805194805194,51.3585155732273,468,621,75.36231884057972,444,634,1078,340,149,107,348,584,2018
Larry Sykes,1.0,1996 - 1996,PF,1,2,0,0,,0,0,,0,0,,,0,0,,1,1,2,0,0,0,1,0,0
Latrell Sprewell,13.0,1993 - 2005,SF,975,37818,6522,15361,42.45817329600937,1166,3460,33.699421965317924,5356,11901,45.004621460381486,46.253499121150966,3725,4633,80.40146773149146,821,3172,3993,3875,1367,426,2621,1824,17935
Lauri Markkanen,2.0,2018 - 2019,PF,120,3702,716,1657,43.2106216053108,265,733,36.15279672578445,451,924,48.80952380952381,51.2070006035003,310,361,85.87257617728532,153,825,978,154,76,73,168,225,2007
Lavor Postell,3.0,2001 - 2003,SG,61,446,59,176,33.52272727272727,11,44,25.0,48,132,36.36363636363637,36.64772727272727,66,83,79.51807228915662,11,34,45,13,12,2,35,28,195
Lavoy Allen,6.0,2012 - 2017,PF,413,7218,867,1833,47.299509001636665,2,15,13.333333333333334,865,1818,47.579757975797584,47.35406437534097,196,289,67.82006920415225,741,1182,1923,390,131,226,264,739,1932
Lawrence Funderburke,7.0,1998 - 2005,PF,344,4871,830,1648,50.36407766990292,2,17,11.76470588235294,828,1631,50.766400980993254,50.4247572815534,414,613,67.53670473083197,461,715,1176,185,100,102,230,382,2076
Lawrence Moten,3.0,1996 - 1998,SG,119,1814,286,701,40.798858773181166,59,197,29.949238578680205,227,504,45.03968253968254,45.00713266761769,116,178,65.1685393258427,80,101,181,182,77,32,126,143,747
Lawrence Roberts,2.0,2006 - 2007,PF,87,1150,114,252,45.23809523809524,0,4,0.0,114,248,45.96774193548387,45.23809523809524,106,154,68.83116883116884,127,183,310,35,44,15,41,163,334
Lazar Hayward,3.0,2011 - 2013,SF,77,609,72,205,35.12195121951219,21,78,26.923076923076923,51,127,40.15748031496063,40.243902439024396,46,60,76.66666666666667,25,69,94,35,17,8,29,67,211
Lazaro Borrell,1.0,2000 - 2000,SF,19,193,32,70,45.714285714285715,0,3,0.0,32,67,47.76119402985074,45.714285714285715,8,15,53.333333333333336,17,34,51,11,6,3,7,11,72
LeBron James,16.0,2004 - 2019,SF,1437,56284,14295,28484,50.18606937227917,2097,6144,34.130859375,12198,22340,54.60161145926589,53.86708327482095,8767,11892,73.72182980154726,1809,9193,11002,10349,2356,1153,5029,2776,39454
LeRon Ellis,3.0,1992 - 1996,C,92,859,110,254,43.30708661417323,0,0,,110,254,43.30708661417323,43.30708661417323,57,93,61.29032258064516,87,133,220,29,25,37,35,105,277
Leandro Barbosa,14.0,2004 - 2017,SG,969,20582,3761,8228,45.70977151191055,1075,2818,38.14762242725337,2686,5410,49.64879852125693,52.24234321827905,1388,1702,81.55111633372502,364,1562,1926,1941,753,132,1172,1869,9985
Ledell Eackles,7.0,1989 - 1998,SG,441,8917,1810,4071,44.46082043723901,137,408,33.57843137254902,1673,3663,45.67294567294567,46.14345369688037,1026,1338,76.68161434977578,362,617,979,740,249,31,600,794,4783
Lee Johnson,1.0,1981 - 1981,PF,12,90,7,25,28.000000000000004,0,0,,7,25,28.000000000000004,28.000000000000004,3,5,60.0,6,16,22,1,0,5,7,18,17
Lee Mayberry,7.0,1993 - 1999,PG,496,10337,950,2287,41.53913423699169,379,1006,37.67395626242545,571,1281,44.57455113192818,49.825098382160036,267,405,65.92592592592592,142,500,642,1767,352,43,591,865,2546
Lee Nailon,6.0,2001 - 2006,SF,315,5980,1148,2425,47.340206185567006,1,10,10.0,1147,2415,47.49482401656315,47.36082474226804,394,501,78.64271457085829,389,571,960,304,136,53,327,613,2691
Leo Rautins,2.0,1984 - 1985,SF,35,213,22,63,34.92063492063492,1,2,50.0,21,61,34.42622950819672,35.714285714285715,6,10,60.0,12,25,37,33,10,2,20,36,51
Leon Powe,5.0,2007 - 2011,C,271,3637,532,1044,50.95785440613027,0,5,0.0,532,1039,51.203079884504334,50.95785440613027,558,819,68.13186813186813,416,572,988,82,69,85,203,554,1622
Leon Smith,2.0,2002 - 2004,C,15,104,11,28,39.285714285714285,0,0,,11,28,39.285714285714285,39.285714285714285,11,17,64.70588235294117,11,22,33,3,5,1,3,13,33
Leon Wood,6.0,1985 - 1991,PG,284,4552,604,1540,39.22077922077922,175,533,32.833020637898684,429,1007,42.60178748758689,44.90259740259741,381,481,79.20997920997921,74,243,317,870,127,4,269,289,1764
Leonard Taylor,1.0,1990 - 1990,PF,10,37,0,6,0.0,0,1,0.0,0,5,0.0,0.0,11,16,68.75,4,8,12,1,0,0,5,4,11
Leroy Combs,1.0,1984 - 1984,SF,48,446,81,163,49.693251533742334,0,3,0.0,81,160,50.625,49.693251533742334,56,91,61.53846153846154,19,37,56,38,23,18,46,49,218
Les Jepsen,2.0,1991 - 1992,C,52,192,20,60,33.33333333333333,0,2,0.0,20,58,34.48275862068966,33.33333333333333,13,20,65.0,29,38,67,2,2,8,6,33,53
Lester Conner,12.0,1983 - 1995,PG,700,15064,1651,3636,45.407040704070404,23,110,20.909090909090907,1628,3526,46.17129892229155,45.723322332233224,1043,1385,75.30685920577618,638,1236,1874,2682,1090,65,915,1044,4368
Lester Hudson,4.0,2010 - 2015,PG,64,632,101,267,37.82771535580524,30,108,27.77777777777778,71,159,44.65408805031446,43.445692883895134,50,62,80.64516129032258,16,62,78,78,34,9,59,60,282
Lewis Brown,1.0,1981 - 1981,C,2,5,0,3,0.0,0,0,,0,3,0.0,0.0,2,5,40.0,1,1,2,0,0,0,1,2,2
Lewis Lloyd,7.0,1982 - 1990,SG,413,10169,2326,4462,52.129090094128195,12,52,23.076923076923077,2314,4410,52.471655328798185,52.2635589421784,833,1078,77.27272727272727,537,750,1287,1249,388,147,877,892,5497
Linas Kleiza,7.0,2006 - 2013,SF,435,8597,1327,3040,43.651315789473685,408,1215,33.58024691358025,919,1825,50.35616438356164,50.36184210526316,666,875,76.11428571428571,405,1148,1553,335,165,74,416,923,3728
Lindsey Hunter,17.0,1994 - 2010,PG,1084,25320,3160,8277,38.1780838468044,1147,3261,35.17325973627722,2013,5016,40.131578947368425,45.10692279811526,1009,1345,75.0185873605948,479,1739,2218,2698,1226,183,1247,2100,8476
Linton Johnson,6.0,2004 - 2009,SF,154,2121,240,576,41.66666666666667,32,105,30.476190476190478,208,471,44.161358811040344,44.44444444444444,74,105,70.47619047619048,161,336,497,66,84,63,100,272,586
Linton Townes,3.0,1983 - 1985,SF,68,609,126,283,44.522968197879855,10,29,34.48275862068966,116,254,45.66929133858268,46.28975265017668,36,47,76.59574468085107,35,38,73,37,20,7,37,98,298
Lionel Chalmers,1.0,2005 - 2005,PG,36,433,42,125,33.6,12,49,24.489795918367346,30,76,39.473684210526315,38.4,15,24,62.5,4,27,31,51,13,0,24,30,111
Lionel Simmons,7.0,1991 - 1997,SF,458,13549,2257,5212,43.303914044512666,46,150,30.666666666666664,2211,5062,43.67838798893718,43.745203376822715,1311,1701,77.07231040564373,802,2043,2845,1506,520,363,988,1118,5871
Litterial Green,5.0,1993 - 1999,PG,148,1189,144,343,41.98250728862974,2,26,7.6923076923076925,142,317,44.79495268138801,42.27405247813411,133,200,66.5,24,51,75,182,49,6,78,124,423
Lloyd Daniels,5.0,1993 - 1998,SG,212,3689,572,1423,40.196767392832044,157,496,31.653225806451612,415,927,44.7680690399137,45.713281799016166,160,214,74.76635514018692,194,270,464,317,105,62,218,310,1461
Logan Vander Velden,1.0,1996 - 1996,SF,15,31,3,14,21.428571428571427,0,5,0.0,3,9,33.33333333333333,21.428571428571427,3,4,75.0,1,5,6,1,0,0,0,4,9
London Perrantes,1.0,2018 - 2018,PG,14,66,2,13,15.384615384615385,0,3,0.0,2,10,20.0,15.384615384615385,3,5,60.0,1,3,4,5,2,1,1,6,7
Lonnie Walker,1.0,2019 - 2019,SG,17,118,16,46,34.78260869565217,5,13,38.46153846153847,11,33,33.33333333333333,40.21739130434783,8,10,80.0,0,17,17,9,7,3,4,7,45
Lonny Baxter,4.0,2003 - 2006,C-PF,162,1884,247,530,46.60377358490566,1,5,20.0,246,525,46.85714285714286,46.69811320754717,142,216,65.74074074074075,178,299,477,40,37,59,108,324,637
Lonzo Ball,2.0,2018 - 2019,PG,99,3203,388,1020,38.03921568627451,165,523,31.54875717017208,223,497,44.8692152917505,46.12745098039216,52,119,43.69747899159664,123,488,611,631,157,62,239,231,993
Loren Meyer,3.0,1996 - 1999,C,143,2058,260,606,42.9042904290429,8,24,33.33333333333333,252,582,43.29896907216495,43.56435643564357,117,168,69.64285714285714,173,313,486,78,31,52,136,371,645
Loren Woods,6.0,2002 - 2008,C,219,2433,210,500,42.0,1,7,14.285714285714285,209,493,42.393509127789045,42.1,138,215,64.18604651162791,265,419,684,74,55,128,138,278,559
Lorenzen Wright,13.0,1997 - 2009,C,793,18898,2606,5674,45.92879802608389,2,29,6.896551724137931,2604,5645,46.129317980513726,45.94642227705322,1092,1693,64.50088600118133,1717,3305,5022,638,479,581,890,2316,6306
Lorenzo Brown,5.0,2014 - 2019,PG,107,1214,126,348,36.206896551724135,20,111,18.01801801801802,106,237,44.72573839662447,39.08045977011494,30,43,69.76744186046511,29,128,157,185,61,16,75,103,302
Lorenzo Charles,1.0,1986 - 1986,SF,40,288,52,92,56.52173913043478,0,0,,52,92,56.52173913043478,56.52173913043478,25,37,67.56756756756756,13,28,41,10,2,6,18,38,129
Lorenzo Romar,5.0,1981 - 1985,PG,304,5255,729,1573,46.34456452638271,19,93,20.43010752688172,710,1480,47.97297297297297,46.94850603941513,279,374,74.59893048128342,66,322,388,1037,244,29,355,402,1756
Lorenzo Williams,7.0,1993 - 2000,PF,256,5543,339,722,46.95290858725762,0,2,0.0,339,720,47.083333333333336,46.95290858725762,81,215,37.67441860465116,694,910,1604,247,134,350,236,733,759
Lou Amundson,10.0,2007 - 2016,PF,457,5805,681,1431,47.58909853249476,0,3,0.0,681,1428,47.689075630252105,47.58909853249476,281,632,44.462025316455694,685,942,1627,193,160,318,309,884,1643
Lou Roe,2.0,1996 - 1997,SF,68,486,46,139,33.093525179856115,5,20,25.0,41,119,34.45378151260504,34.89208633093525,33,51,64.70588235294117,38,56,94,21,14,9,28,53,130
Lou Williams,14.0,2006 - 2019,SG,988,24297,4463,10667,41.83931752132746,1283,3725,34.442953020134226,3180,6942,45.808124459809854,47.85319208774726,3676,4392,83.6976320582878,380,1793,2173,3204,881,174,1632,1329,13885
Louis Orr,8.0,1981 - 1988,SF,591,13746,2181,4682,46.582656984194784,3,36,8.333333333333332,2178,4646,46.879035729659925,46.61469457496796,1324,1680,78.80952380952381,940,1260,2200,866,469,169,812,1179,5689
Lowes Moore,3.0,1981 - 1983,PG,112,2118,312,706,44.19263456090651,11,55,20.0,301,651,46.236559139784944,44.97167138810198,117,156,75.0,59,168,227,316,89,19,159,266,752
Loy Vaught,11.0,1991 - 2001,PF,704,17200,3095,6138,50.423590746171385,23,90,25.555555555555554,3072,6048,50.79365079365079,50.61094819159335,853,1188,71.8013468013468,1494,3451,4945,658,521,232,833,1648,7066
Luc Longley,10.0,1992 - 2001,C,654,13920,1926,4164,46.2536023054755,0,5,0.0,1926,4159,46.3092089444578,46.2536023054755,815,1080,75.46296296296296,1012,2154,3166,972,324,622,1087,2068,4667
Luc Mbah a Moute,11.0,2009 - 2019,PF,718,16778,1749,3861,45.2991452991453,215,654,32.87461773700306,1534,3207,47.83286560648581,48.08339808339808,846,1282,65.99063962558502,994,1924,2918,611,633,271,668,1299,4559
Lucas Nogueira,4.0,2015 - 2018,C,154,1814,186,295,63.05084745762712,9,34,26.47058823529412,177,261,67.81609195402298,64.57627118644068,75,118,63.559322033898304,123,279,402,73,89,144,78,231,456
Lucious Harris,12.0,1994 - 2005,SG,854,16788,2334,5477,42.61457002008399,424,1224,34.64052287581699,1910,4253,44.90947566423701,46.48530217272229,1088,1375,79.12727272727273,597,1403,2000,1191,587,87,639,1108,6180
Luigi Datome,2.0,2014 - 2015,SF,58,461,79,192,41.14583333333333,25,81,30.864197530864196,54,111,48.64864864864865,47.65625,9,11,81.81818181818183,17,59,76,21,8,8,20,39,192
Luis Flores,1.0,2005 - 2005,PG,16,77,14,29,48.275862068965516,5,10,50.0,9,19,47.368421052631575,56.896551724137936,2,2,100.0,1,2,3,11,2,0,11,9,35
Luis Montero,2.0,2016 - 2018,SG,20,58,8,23,34.78260869565217,3,11,27.27272727272727,5,12,41.66666666666667,41.30434782608695,3,4,75.0,0,6,6,1,0,0,6,2,22
Luis Scola,10.0,2008 - 2017,PF,791,20028,3832,7801,49.12190744776311,97,296,32.77027027027027,3735,7505,49.766822118587605,49.74362261248558,1530,2078,73.62848893166506,1400,3766,5166,1241,494,231,1167,2163,9291
Luka Doncic,1.0,2019 - 2019,SG,72,2318,506,1186,42.66441821247892,168,514,32.68482490272373,338,672,50.297619047619044,49.747048903878586,346,485,71.34020618556701,86,477,563,429,77,25,247,137,1526
Luke Babbitt,8.0,2011 - 2018,SF,383,5335,650,1594,40.777917189460474,394,979,40.24514811031665,256,615,41.6260162601626,53.13676286072773,124,166,74.69879518072288,111,735,846,224,89,58,165,520,1818
Luke Harangody,2.0,2011 - 2012,PF,70,871,102,271,37.63837638376384,21,87,24.137931034482758,81,184,44.02173913043478,41.51291512915129,28,38,73.68421052631578,60,136,196,36,21,20,20,97,253
Luke Jackson,4.0,2005 - 2008,SF,76,735,84,235,35.74468085106383,32,89,35.95505617977528,52,146,35.61643835616438,42.5531914893617,58,77,75.32467532467533,28,66,94,59,25,3,50,74,258
Luke Kennard,2.0,2018 - 2019,SG,136,2900,434,985,44.06091370558375,187,464,40.30172413793103,247,521,47.408829174664106,53.55329949238579,116,137,84.67153284671532,33,326,359,238,70,23,126,178,1171
Luke Kornet,2.0,2018 - 2019,PF,66,1110,156,408,38.23529411764706,98,272,36.029411764705884,58,136,42.64705882352941,50.245098039215684,46,57,80.7017543859649,39,160,199,80,33,58,37,69,456
Luke Ridnour,12.0,2004 - 2015,PG,852,22158,3000,6968,43.05396096440873,595,1711,34.7749853886616,2405,5257,45.748525775156935,47.32347876004592,1319,1528,86.32198952879581,377,1553,1930,3785,831,171,1381,1816,7914
Luke Schenscher,2.0,2006 - 2007,C,34,284,25,51,49.01960784313725,0,0,,25,51,49.01960784313725,49.01960784313725,12,24,50.0,21,40,61,8,3,7,10,48,62
Luke Walton,10.0,2004 - 2013,SF,652,10967,1195,2794,42.770221904080174,214,647,33.07573415765069,981,2147,45.69166278528179,46.59985683607731,421,590,71.35593220338983,534,1258,1792,1468,360,115,683,966,3025
Luke Zeller,1.0,2013 - 2013,C,16,58,9,26,34.61538461538461,1,5,20.0,8,21,38.095238095238095,36.53846153846153,0,0,,1,9,10,3,0,0,0,5,19
Luol Deng,15.0,2005 - 2019,SF,964,33368,5510,12092,45.56731723453523,715,2165,33.02540415704388,4795,9927,48.30260904603607,48.52381739993384,2612,3396,76.91401648998823,1567,4319,5886,2169,948,490,1561,1635,14347
Luther Head,6.0,2006 - 2011,SG,360,7982,1037,2476,41.882067851373186,457,1191,38.371116708648195,580,1285,45.13618677042802,51.110662358642976,347,451,76.94013303769401,113,753,866,759,259,46,448,529,2878
Luther Wright,1.0,1994 - 1994,C,15,92,8,23,34.78260869565217,0,1,0.0,8,22,36.36363636363637,34.78260869565217,3,4,75.0,6,4,10,0,1,2,6,21,19
Lynn Greer,1.0,2007 - 2007,SG,41,432,61,141,43.262411347517734,18,52,34.61538461538461,43,89,48.31460674157304,49.645390070921984,27,32,84.375,2,25,27,53,17,1,18,32,167
Maalik Wayns,2.0,2013 - 2014,PG,29,211,27,90,30.0,7,31,22.58064516129032,20,59,33.89830508474576,33.88888888888889,17,19,89.47368421052632,1,8,9,29,8,0,15,30,78
Maceo Baston,4.0,2003 - 2009,PF,106,832,106,172,61.627906976744185,3,8,37.5,103,164,62.80487804878049,62.5,71,96,73.95833333333334,56,119,175,26,25,43,54,140,286
Maciej Lampe,3.0,2004 - 2006,C,64,632,94,231,40.692640692640694,2,8,25.0,92,223,41.25560538116592,41.125541125541126,25,37,67.56756756756756,37,105,142,22,8,10,35,81,215
Mahmoud Abdul-Rauf,9.0,1991 - 2001,PG,601,16043,3583,8130,44.07134071340714,488,1388,35.158501440922194,3095,6742,45.90625927024622,47.07257072570726,1094,1206,90.71310116086235,224,886,1110,2114,494,47,985,1143,8748
Makhtar N'Diaye,1.0,1999 - 1999,PF,4,27,1,4,25.0,0,0,,1,4,25.0,25.0,3,4,75.0,3,2,5,1,0,1,1,9,5
Malachi Richardson,3.0,2017 - 2019,SG,70,625,67,187,35.82887700534759,28,93,30.107526881720432,39,94,41.48936170212766,43.31550802139038,36,46,78.26086956521739,10,60,70,24,16,2,26,63,198
Malcolm Brogdon,3.0,2017 - 2019,SG,200,5619,958,1996,47.99599198396793,259,638,40.59561128526646,699,1358,51.47275405007363,54.483967935871746,333,373,89.27613941018767,141,566,707,712,175,40,294,396,2508
Malcolm Delaney,2.0,2017 - 2018,PG,128,2265,257,676,38.01775147928994,73,235,31.06382978723404,184,441,41.723356009070294,43.41715976331361,150,187,80.21390374331551,19,205,224,356,74,7,161,194,737
Malcolm Lee,3.0,2012 - 2015,SG,36,534,52,136,38.23529411764706,10,34,29.411764705882355,42,102,41.17647058823529,41.911764705882355,26,37,70.27027027027027,24,41,65,51,20,10,27,52,140
Malcolm Mackey,1.0,1994 - 1994,C,22,69,14,37,37.83783783783784,0,2,0.0,14,35,40.0,37.83783783783784,4,8,50.0,12,12,24,1,0,3,2,9,32
Malcolm Miller,2.0,2018 - 2019,SF,25,193,24,54,44.44444444444444,18,42,42.857142857142854,6,12,50.0,61.111111111111114,7,8,87.5,5,15,20,4,2,3,6,15,73
Malcolm Thomas,4.0,2012 - 2015,PF,43,335,31,71,43.66197183098591,1,11,9.090909090909092,30,60,50.0,44.36619718309859,16,30,53.333333333333336,31,69,100,14,6,7,25,30,79
Malik Allen,10.0,2002 - 2011,PF,507,7586,1077,2459,43.79829198861326,3,16,18.75,1074,2443,43.962341383544825,43.85929239528264,260,337,77.1513353115727,489,923,1412,240,136,236,337,949,2417
Malik Beasley,3.0,2017 - 2019,SG,165,2627,455,988,46.05263157894737,200,515,38.83495145631068,255,473,53.911205073995774,56.174089068825914,86,109,78.89908256880734,54,234,288,139,77,17,87,162,1196
Malik Hairston,2.0,2009 - 2010,SG,62,472,64,125,51.2,2,12,16.666666666666664,62,113,54.86725663716814,52.0,19,37,51.35135135135135,24,53,77,29,10,16,23,48,149
Malik Monk,2.0,2018 - 2019,SG,136,2112,380,1011,37.58654797230465,192,573,33.50785340314136,188,438,42.922374429223744,47.08209693372898,122,140,87.14285714285714,24,179,203,208,57,28,135,166,1074
Malik Rose,13.0,1997 - 2009,PF,895,14836,1968,4516,43.57838795394154,15,88,17.045454545454543,1953,4428,44.105691056910565,43.7444641275465,1558,2099,74.22582181991424,1299,2425,3724,738,530,319,1155,2111,5509
Malik Sealy,8.0,1993 - 2000,SF,507,12009,1904,4469,42.60460953233385,160,550,29.09090909090909,1744,3919,44.501148252105125,44.394719176549565,1095,1357,80.69270449521002,515,1099,1614,829,521,158,697,1112,5063
Mamadou N'Diaye,5.0,2001 - 2005,C,69,858,85,199,42.71356783919598,0,1,0.0,85,198,42.92929292929293,42.71356783919598,92,125,73.6,88,137,225,8,17,64,40,146,262
Mangok Mathiang,1.0,2018 - 2018,C,4,20,4,7,57.14285714285714,0,0,,4,7,57.14285714285714,57.14285714285714,0,1,0.0,3,7,10,0,1,0,0,5,8
Manny Harris,4.0,2011 - 2017,SG,93,1594,199,524,37.97709923664122,53,150,35.333333333333336,146,374,39.037433155080215,43.034351145038165,124,168,73.80952380952381,57,196,253,129,48,14,101,104,575
Manu Ginobili,16.0,2003 - 2018,SG,1275,32934,5540,12471,44.42306150268623,1819,4960,36.6733870967742,3721,7511,49.54067367860471,51.71598107609654,4198,5090,82.475442043222,840,3731,4571,4828,1684,380,2597,2800,17097
Manute Bol,10.0,1986 - 1995,C,653,12194,699,1723,40.568775391758564,45,228,19.736842105263158,654,1495,43.745819397993316,41.87463726059199,238,430,55.348837209302324,633,2123,2756,174,132,2163,464,1518,1681
MarShon Brooks,5.0,2012 - 2019,SG,207,3496,616,1379,44.67005076142132,109,317,34.38485804416404,507,1062,47.740112994350284,48.62218999274837,259,344,75.29069767441861,133,296,429,285,120,42,251,272,1600
Marc Gasol,11.0,2009 - 2019,C,854,28909,4786,9959,48.057033838738825,331,945,35.026455026455025,4455,9014,49.42311959174617,49.718847273822675,3031,3887,77.97787496784152,1463,5177,6640,2944,785,1261,1743,2516,12934
Marc Iavaroni,7.0,1983 - 1989,PF,574,9092,975,2110,46.208530805687204,1,21,4.761904761904762,974,2089,46.6251795117281,46.232227488151665,578,813,71.09471094710948,615,1242,1857,573,202,215,688,1381,2529
Marc Jackson,7.0,2001 - 2007,C,399,7748,1216,2732,44.5095168374817,7,32,21.875,1209,2700,44.77777777777778,44.63762811127379,866,1066,81.23827392120076,643,1053,1696,319,151,105,482,804,3305
Marcelo Huertas,2.0,2016 - 2017,PG,76,1106,122,298,40.939597315436245,20,80,25.0,102,218,46.788990825688074,44.29530201342282,36,46,78.26086956521739,20,94,114,234,36,9,99,92,300
Marcin Gortat,12.0,2008 - 2019,C,892,22480,3640,6592,55.21844660194175,3,20,15.0,3637,6572,55.34083992696287,55.241201456310684,1222,1803,67.7759290072102,1931,5000,6931,995,411,955,1034,1954,8505
Marco Belinelli,12.0,2008 - 2019,SG,861,19908,3000,7059,42.49893752656184,1219,3239,37.635072553257174,1781,3820,46.62303664921466,51.13330500070832,1300,1530,84.9673202614379,187,1609,1796,1444,498,64,871,1268,8519
Marcus Banks,8.0,2004 - 2011,PG,361,5744,761,1762,43.18955732122588,130,394,32.99492385786802,631,1368,46.12573099415205,46.878547105561864,463,603,76.78275290215588,102,435,537,743,272,58,445,699,2115
Marcus Brown,2.0,1997 - 2000,PG,27,229,32,84,38.095238095238095,13,39,33.33333333333333,19,45,42.22222222222222,45.83333333333333,15,21,71.42857142857143,7,15,22,23,8,2,16,34,92
Marcus Camby,17.0,1997 - 2013,C,1052,30929,4006,8617,46.48949750493211,21,95,22.105263157894736,3985,8522,46.76132363295002,46.61134965765348,1818,2738,66.39883126369612,2790,7435,10225,1932,1028,2482,1441,2946,9851
Marcus Cousin,1.0,2011 - 2011,C,4,18,2,3,66.66666666666666,0,0,,2,3,66.66666666666666,66.66666666666666,0,0,,0,3,3,0,0,1,1,1,4
Marcus Derrickson,1.0,2019 - 2019,PF,11,67,16,33,48.484848484848484,10,20,50.0,6,13,46.15384615384615,63.63636363636363,4,5,80.0,8,5,13,1,0,1,3,9,46
Marcus Fizer,6.0,2001 - 2006,PF,289,6032,1103,2536,43.49369085173502,21,110,19.090909090909093,1082,2426,44.60016488046167,43.9077287066246,555,803,69.11581569115816,375,965,1340,352,134,81,428,648,2782
Marcus Georges-Hunt,2.0,2017 - 2018,SG,49,275,23,56,41.07142857142857,5,17,29.411764705882355,18,39,46.15384615384615,45.535714285714285,22,31,70.96774193548387,9,17,26,10,7,0,5,37,73
Marcus Haislip,4.0,2003 - 2010,PF,92,881,130,293,44.36860068259386,7,20,35.0,123,273,45.05494505494506,45.563139931740615,56,86,65.11627906976744,54,82,136,18,17,35,40,105,323
Marcus Landry,1.0,2010 - 2010,SF,18,111,16,43,37.2093023255814,9,28,32.142857142857146,7,15,46.666666666666664,47.674418604651166,3,5,60.0,5,14,19,0,1,2,6,14,44
Marcus Liberty,4.0,1991 - 1994,SF,267,4568,783,1877,41.71550346297283,66,194,34.02061855670103,717,1683,42.60249554367201,43.47362812999467,310,467,66.38115631691649,418,507,925,244,189,73,264,495,1942
Marcus Morris,8.0,2012 - 2019,PF,568,15160,2431,5671,42.867219185328864,794,2191,36.239160200821544,1637,3480,47.04022988505747,49.86774819255863,944,1262,74.80190174326465,551,2079,2630,859,388,146,657,1213,6600
Marcus Paige,1.0,2018 - 2018,PG,5,28,4,14,28.57142857142857,2,8,25.0,2,6,33.33333333333333,35.714285714285715,2,2,100.0,0,4,4,3,0,0,0,0,12
Marcus Smart,5.0,2015 - 2019,SG,384,10958,1187,3203,37.05900718076803,505,1626,31.057810578105784,682,1577,43.24667089410273,44.94224164845457,708,940,75.31914893617021,365,1019,1384,1525,593,153,674,1009,3587
Marcus Thornton,8.0,2010 - 2017,SG,493,11423,2145,5057,42.41645244215938,740,2072,35.714285714285715,1405,2985,47.06867671691792,49.73304330630809,779,942,82.6963906581741,414,953,1367,678,407,62,493,743,5809
Marcus Vinicius,2.0,2007 - 2008,SF,26,172,16,35,45.714285714285715,8,19,42.10526315789473,8,16,50.0,57.14285714285714,10,18,55.55555555555556,3,16,19,7,3,2,9,14,50
Marcus Webb,1.0,1993 - 1993,PF,9,51,13,25,52.0,0,1,0.0,13,24,54.166666666666664,52.0,13,21,61.904761904761905,5,5,10,2,1,2,5,11,39
Marcus Williams,4.0,2007 - 2010,PG,215,3173,439,1143,38.4076990376203,127,405,31.35802469135803,312,738,42.27642276422765,43.963254593175854,152,198,76.76767676767676,59,312,371,587,88,7,307,201,1157
Mardy Collins,4.0,2007 - 2010,SG,189,2771,296,778,38.04627249357326,38,127,29.92125984251969,258,651,39.63133640552996,40.48843187660668,112,187,59.893048128342244,91,245,336,327,110,22,203,256,742
Mario Bennett,4.0,1996 - 2000,PF,74,624,114,214,53.271028037383175,1,3,33.33333333333333,113,211,53.55450236966824,53.50467289719626,48,92,52.17391304347826,88,103,191,24,31,23,35,114,277
Mario Chalmers,9.0,2009 - 2018,PG,745,20122,2243,5357,41.87044987866343,872,2481,35.147118097541316,1371,2876,47.670375521557716,50.009333582228855,1257,1597,78.71008140262992,246,1590,1836,2733,1068,118,1369,2030,6615
Mario Elie,11.0,1991 - 2001,SF,848,21708,2448,5211,46.97754749568221,664,1817,36.54375343973582,1784,3394,52.5633470830878,53.348685473037804,1690,1985,85.13853904282117,622,1737,2359,2139,765,145,1102,1698,7250
Mario Hezonja,4.0,2016 - 2019,SF,277,5236,762,1829,41.66211044286495,242,755,32.05298013245033,520,1074,48.4171322160149,48.27774740295243,262,323,81.11455108359134,117,725,842,365,207,71,329,442,2028
Mario Kasun,2.0,2005 - 2006,C,73,569,78,167,46.706586826347305,0,1,0.0,78,166,46.98795180722892,46.706586826347305,42,66,63.63636363636363,76,112,188,11,10,16,41,155,198
Mario West,4.0,2008 - 2011,SG,186,868,62,142,43.66197183098591,2,12,16.666666666666664,60,130,46.15384615384615,44.36619718309859,41,76,53.94736842105263,62,89,151,54,48,8,32,143,167
Mark Acres,6.0,1988 - 1993,C,394,6142,528,1043,50.62320230105465,7,14,50.0,521,1029,50.63168124392614,50.95877277085331,317,481,65.9043659043659,595,967,1562,182,138,105,241,965,1380
Mark Aguirre,13.0,1982 - 1994,SF,1025,30688,7897,16300,48.4478527607362,437,1400,31.214285714285715,7460,14900,50.06711409395973,49.78834355828221,3974,5361,74.12796120126842,1885,3230,5115,3133,758,318,2504,2880,20205
Mark Alarie,5.0,1987 - 1991,PF,329,5545,1047,2201,47.56928668786915,35,137,25.547445255474454,1012,2064,49.031007751937985,48.36437982735121,326,420,77.61904761904762,438,688,1126,364,134,111,313,721,2455
Mark Blount,9.0,2001 - 2009,C,627,14352,2055,4086,50.293685756240826,37,103,35.92233009708738,2018,3983,50.66532764248054,50.746451297112095,887,1228,72.23127035830619,923,1947,2870,521,346,526,956,1604,5034
Mark Bradtke,1.0,1997 - 1997,C,36,251,25,58,43.103448275862064,0,0,,25,58,43.103448275862064,43.103448275862064,9,13,69.23076923076923,26,42,68,7,5,5,9,34,59
Mark Bryant,15.0,1989 - 2003,PF,876,14446,1852,3722,49.758194519075765,1,14,7.142857142857142,1851,3708,49.919093851132686,49.77162815690489,886,1267,69.92896606156275,1199,1987,3186,505,347,209,705,2175,4591
Mark Davis,6.0,1989 - 2000,SF,263,3939,522,1173,44.50127877237852,29,124,23.387096774193548,493,1049,46.99714013346044,45.73742540494459,315,472,66.73728813559322,307,427,734,308,213,80,336,520,1388
Mark Eaton,11.0,1983 - 1993,C,949,27464,2252,4894,46.01552921945239,0,2,0.0,2252,4892,46.03434178250204,46.01552921945239,1166,1800,64.77777777777777,2026,5470,7496,892,403,3274,1374,3205,5670
Mark Hendrickson,4.0,1997 - 2000,PF,114,1508,134,322,41.61490683229814,3,18,16.666666666666664,131,304,43.09210526315789,42.08074534161491,110,137,80.2919708029197,98,218,316,63,50,15,63,139,381
Mark Jackson,17.0,1988 - 2004,PG,1427,42897,5231,11744,44.54189373297003,831,2494,33.319967923015234,4400,9250,47.56756756756757,48.079870572207085,2381,3091,77.03008735037204,1394,4046,5440,11239,1739,125,3447,2455,13674
Mark Jones,2.0,1984 - 2005,PG,16,132,12,37,32.432432432432435,0,5,0.0,12,32,37.5,32.432432432432435,6,12,50.0,8,7,15,11,5,2,5,18,30
Mark Macon,6.0,1992 - 1999,SG,251,5018,694,1806,38.42746400885936,34,126,26.984126984126984,660,1680,39.285714285714285,39.3687707641196,263,358,73.46368715083798,173,294,467,428,349,20,323,587,1685
Mark Madsen,9.0,2001 - 2009,C,502,5784,412,911,45.225027442371015,1,18,5.555555555555555,411,893,46.02463605823068,45.27991218441274,235,452,51.991150442477874,607,648,1255,199,124,110,224,946,1060
Mark McNamara,8.0,1983 - 1991,C,286,2723,367,716,51.25698324022346,0,0,,367,716,51.25698324022346,51.25698324022346,257,469,54.79744136460555,345,486,831,77,35,39,223,375,991
Mark Pope,6.0,1998 - 2005,PF,166,1722,125,305,40.98360655737705,10,58,17.24137931034483,115,247,46.558704453441294,42.62295081967213,44,76,57.89473684210527,99,179,278,66,35,45,48,256,304
Mark Price,12.0,1987 - 1998,PG,769,23251,4219,8948,47.150201162270896,1032,2594,39.784117193523514,3187,6354,50.1573811772112,52.91685292802861,2337,2576,90.722049689441,430,1542,1972,5190,924,81,1948,1045,11807
Mark Radford,2.0,1982 - 1983,SG,97,808,138,272,50.73529411764706,6,21,28.57142857142857,132,251,52.589641434262944,51.83823529411765,65,142,45.774647887323944,25,51,76,161,50,6,116,143,347
Mark Randall,4.0,1992 - 1995,PF,129,889,128,290,44.13793103448276,6,39,15.384615384615385,122,251,48.60557768924303,45.17241379310345,70,97,72.16494845360825,80,85,165,56,24,9,54,96,332
Mark Strickland,8.0,1995 - 2003,SF,291,3477,549,1123,48.88691006233304,2,9,22.22222222222222,547,1114,49.10233393177738,48.975957257346394,204,309,66.01941747572816,271,513,784,103,83,111,167,325,1304
Mark Wade,2.0,1988 - 1990,PG,12,126,3,20,15.0,0,2,0.0,3,18,16.666666666666664,15.0,2,4,50.0,3,12,15,36,7,1,13,13,8
Mark West,17.0,1984 - 2000,C,1185,21968,2729,4711,57.9282530248355,0,4,0.0,2729,4707,57.97748034841725,57.9282530248355,1297,2280,56.885964912280706,1937,3832,5769,464,350,1522,1289,3429,6755
Markel Brown,3.0,2015 - 2018,SG,115,1804,207,544,38.05147058823529,56,192,29.166666666666668,151,352,42.89772727272727,43.19852941176471,120,153,78.43137254901961,42,194,236,133,69,27,85,157,590
Markelle Fultz,2.0,2018 - 2019,SG,36,703,111,273,40.65934065934066,4,15,26.666666666666668,107,258,41.47286821705426,41.39194139194139,34,62,54.83870967741935,37,79,116,117,31,9,43,78,260
Markieff Morris,8.0,2012 - 2019,PF,598,15593,2691,6006,44.8051948051948,457,1356,33.70206489675516,2234,4650,48.04301075268817,48.60972360972361,1103,1415,77.95053003533569,797,2516,3313,1012,535,354,963,1762,6942
Marko Jaric,7.0,2003 - 2009,PG,447,11246,1190,2944,40.421195652173914,289,840,34.404761904761905,901,2104,42.82319391634981,45.32948369565217,524,718,72.98050139275766,274,926,1200,1600,583,128,708,967,3193
Marko Milic,2.0,1998 - 1999,SG,46,220,49,87,56.32183908045977,3,7,42.857142857142854,46,80,57.49999999999999,58.04597701149425,11,17,64.70588235294117,13,18,31,14,14,1,27,25,112
Marlon Garnett,1.0,1999 - 1999,PG,24,205,15,51,29.411764705882355,6,23,26.08695652173913,9,28,32.142857142857146,35.294117647058826,15,20,75.0,3,18,21,18,5,1,12,18,51
Marlon Maxey,2.0,1993 - 1994,PF,98,1146,182,336,54.166666666666664,0,3,0.0,182,333,54.65465465465466,54.166666666666664,115,168,68.45238095238095,141,222,363,22,27,51,78,188,479
Marques Bragg,1.0,1996 - 1996,PF,53,369,54,120,45.0,0,0,,54,120,45.0,45.0,23,41,56.09756097560976,38,41,79,8,17,8,26,71,131
Marquese Chriss,3.0,2017 - 2019,PF,197,3769,553,1289,42.901474010861136,144,486,29.629629629629626,409,803,50.93399750933998,48.48719937936385,241,384,62.760416666666664,212,673,885,165,135,151,251,549,1491
Marquis Daniels,10.0,2004 - 2013,SG,613,12440,1877,4167,45.04439644828413,108,463,23.326133909287257,1769,3704,47.759179265658744,46.340292776577876,735,1018,72.20039292730844,562,1100,1662,1029,533,145,690,957,4597
Marquis Teague,3.0,2013 - 2018,PG,99,981,90,265,33.9622641509434,10,50,20.0,80,215,37.2093023255814,35.84905660377358,37,56,66.07142857142857,5,88,93,146,25,13,79,108,227
Marreese Speights,10.0,2009 - 2018,C,765,11224,2301,5043,45.627602617489586,257,714,35.99439775910364,2044,4329,47.216447216447214,48.17568907396391,1053,1334,78.93553223388305,1000,2027,3027,485,203,378,648,1668,5912
Marshall Plumlee,2.0,2017 - 2018,C,29,222,17,33,51.515151515151516,0,0,,17,33,51.515151515151516,51.515151515151516,20,35,57.14285714285714,27,41,68,12,4,5,15,33,54
Martell Webster,10.0,2006 - 2015,SF,598,14265,1734,4157,41.712773634832814,801,2111,37.944102321174796,933,2046,45.60117302052786,51.34712533076738,890,1132,78.62190812720848,363,1499,1862,597,308,168,543,1082,5159
Martin Lewis,2.0,1996 - 1997,SF,25,239,35,74,47.2972972972973,3,10,30.0,32,64,50.0,49.32432432432432,16,27,59.25925925925925,19,16,35,7,9,5,15,29,89
Martin Muursepp,2.0,1997 - 1998,PF,83,951,137,322,42.54658385093168,20,62,32.25806451612903,117,260,45.0,45.65217391304348,95,137,69.34306569343066,81,100,181,50,41,25,47,154,389
Martin Nessley,1.0,1988 - 1988,C,44,336,20,52,38.46153846153847,0,0,,20,52,38.46153846153847,38.46153846153847,8,18,44.44444444444444,23,59,82,16,8,12,23,89,48
Marty Conlon,9.0,1992 - 2000,C,383,6363,970,1950,49.743589743589745,15,75,20.0,955,1875,50.93333333333333,50.128205128205124,508,691,73.51664254703329,499,816,1315,381,149,74,419,691,2463
Martynas Andriuskevicius,1.0,2006 - 2006,C,6,9,0,1,0.0,0,0,,0,1,0.0,0.0,0,0,,1,3,4,0,2,0,0,1,0
Marvin Bagley,1.0,2019 - 2019,PF,62,1567,356,706,50.42492917847026,30,96,31.25,326,610,53.442622950819676,52.54957507082153,181,262,69.08396946564885,162,309,471,62,33,59,98,120,923
Marvin Williams,14.0,2006 - 2019,PF,1063,30260,3926,8923,43.998655160820356,1009,2790,36.16487455197132,2917,6133,47.56236751997391,49.65258321192424,2103,2604,80.76036866359448,1305,4266,5571,1349,819,569,1029,2139,10964
Mason Plumlee,6.0,2014 - 2019,C,498,10889,1602,2833,56.54782915637134,2,27,7.4074074074074066,1600,2806,57.02066999287242,56.583127426756086,894,1586,56.36822194199244,986,2152,3138,1086,380,472,737,1369,4100
Mateen Cleaves,6.0,2001 - 2006,PG,167,1863,233,599,38.898163606010016,12,45,26.666666666666668,221,554,39.891696750902526,39.89983305509182,131,180,72.77777777777777,33,142,175,310,67,5,201,213,609
Matt Barnes,14.0,2004 - 2017,SF,1024,24114,3021,6972,43.33046471600689,1066,3214,33.16739265712508,1955,3758,52.022352315061205,50.97532989099254,1119,1501,74.55029980013325,1178,3493,4671,1823,799,474,1277,2617,8227
Matt Bonner,12.0,2005 - 2016,PF,886,14390,1839,3992,46.067134268537075,846,2061,41.04803493449782,993,1931,51.42413257379596,56.66332665330661,367,469,78.25159914712152,657,1870,2527,587,301,230,320,1442,4891
Matt Bullard,11.0,1991 - 2002,PF,650,9244,1253,3002,41.73884077281812,626,1620,38.641975308641975,627,1382,45.36903039073806,52.16522318454364,259,336,77.08333333333334,288,984,1272,554,192,128,330,804,3391
Matt Carroll,10.0,2004 - 2013,SG,464,7609,1032,2499,41.29651860744298,344,896,38.392857142857146,688,1603,42.919525888958205,48.17927170868347,609,724,84.11602209944752,147,719,866,313,223,60,298,705,3017
Matt Costello,1.0,2018 - 2018,C,4,32,2,4,50.0,0,0,,2,4,50.0,50.0,0,0,,1,8,9,2,2,2,1,7,4
Matt Fish,3.0,1995 - 1997,C,50,512,71,142,50.0,0,1,0.0,71,141,50.35460992907801,50.0,35,56,62.5,43,67,110,25,19,14,33,91,177
Matt Freije,2.0,2005 - 2007,PF,42,588,53,181,29.2817679558011,17,76,22.36842105263158,36,105,34.285714285714285,33.97790055248619,10,14,71.42857142857143,24,61,85,27,16,3,20,53,133
Matt Geiger,10.0,1993 - 2002,C,589,12752,2126,4269,49.800890138205666,16,70,22.857142857142858,2110,4199,50.25005953798524,49.98828765518857,1016,1387,73.25162220620042,1209,2085,3294,406,324,356,770,1719,5284
Matt Harpring,11.0,1999 - 2009,SF,713,18632,3062,6386,47.948637644848105,161,494,32.59109311740891,2901,5892,49.23625254582485,49.209207641716254,1779,2359,75.41331072488342,1363,2201,3564,961,524,121,1053,1880,8064
Matt Maloney,6.0,1997 - 2003,PG,316,8161,854,2103,40.60865430337613,447,1201,37.218984179850125,407,902,45.1219512195122,51.23632905373277,234,296,79.05405405405406,63,464,527,920,252,19,423,418,2389
Matt Othick,1.0,1993 - 1993,PG,4,39,3,5,60.0,2,4,50.0,1,1,100.0,80.0,0,2,0.0,1,1,2,7,1,0,4,7,8
Matt Steigenga,1.0,1997 - 1997,SF,2,12,1,4,25.0,0,2,0.0,1,2,50.0,25.0,1,2,50.0,0,3,3,2,1,1,2,1,3
Matt Walsh,1.0,2006 - 2006,SG,2,3,1,1,100.0,0,0,,1,1,100.0,100.0,0,2,0.0,0,0,0,0,0,0,1,0,2
Matt Wenstrom,1.0,1994 - 1994,C,11,37,6,10,60.0,0,0,,6,10,60.0,60.0,6,10,60.0,6,6,12,0,0,2,4,7,18
Matt Williams,1.0,2018 - 2018,SG,3,11,2,6,33.33333333333333,1,5,20.0,1,1,100.0,41.66666666666667,0,0,,0,1,1,0,0,0,1,1,5
Matthew Dellavedova,6.0,2014 - 2019,PG,429,9003,894,2305,38.78524945770065,415,1116,37.18637992831541,479,1189,40.28595458368377,47.78741865509761,326,395,82.53164556962025,159,613,772,1548,195,19,549,840,2529
Maurice Ager,4.0,2007 - 2011,SG,85,529,69,198,34.84848484848485,13,47,27.659574468085108,56,151,37.086092715231786,38.131313131313135,33,59,55.932203389830505,9,40,49,19,6,6,29,68,184
Maurice Baker,1.0,2005 - 2005,PG,5,19,0,1,0.0,0,0,,0,1,0.0,0.0,0,0,,1,1,2,1,1,0,1,3,0
Maurice Carter,1.0,2004 - 2004,SG,11,112,11,36,30.555555555555557,4,11,36.36363636363637,7,25,28.000000000000004,36.11111111111111,16,20,80.0,2,9,11,4,0,0,9,10,42
Maurice Evans,9.0,2002 - 2012,SG,618,11852,1535,3468,44.26182237600923,466,1274,36.57770800627944,1069,2194,48.723792160437554,50.98039215686274,490,625,78.4,589,878,1467,448,322,93,298,1036,4026
Maurice Harkless,7.0,2013 - 2019,SF,492,11381,1456,3082,47.24205061648281,309,961,32.154006243496355,1147,2121,54.07826496935407,52.255029201817,436,712,61.23595505617978,610,1224,1834,451,481,331,428,1010,3657
Maurice Martin,2.0,1987 - 1988,SF,75,485,87,230,37.826086956521735,4,21,19.047619047619047,83,209,39.71291866028708,38.69565217391304,64,105,60.952380952380956,29,46,75,59,19,11,49,82,242
Maurice Ndour,1.0,2017 - 2017,PF,32,331,39,86,45.348837209302324,1,7,14.285714285714285,38,79,48.10126582278481,45.93023255813954,19,26,73.07692307692307,22,42,64,8,15,8,12,30,98
Maurice Taylor,9.0,1998 - 2007,PF,539,13439,2489,5336,46.64542728635682,5,33,15.151515151515152,2484,5303,46.841410522345846,46.692278860569715,955,1341,71.21551081282624,796,1672,2468,628,246,260,980,1623,5938
Maxi Kleber,2.0,2018 - 2019,PF,143,2708,326,695,46.906474820143885,117,346,33.81502890173411,209,349,59.885386819484246,55.32374100719425,102,133,76.69172932330827,161,402,563,121,62,125,84,257,871
McKinley Singleton,1.0,1987 - 1987,PG,2,10,2,3,66.66666666666666,0,1,0.0,2,2,100.0,66.66666666666666,0,0,,0,0,0,1,0,0,0,1,4
Mehmet Okur,10.0,2003 - 2012,C,705,20105,3235,7114,45.47371380376722,651,1742,37.37083811710677,2584,5372,48.10126582278481,50.049198763002536,2016,2546,79.18303220738413,1375,3477,4852,1167,378,499,1066,1982,9137
Mel Bennett,2.0,1981 - 1982,PF,31,336,28,64,43.75,0,2,0.0,28,62,45.16129032258064,43.75,54,87,62.06896551724138,34,62,96,15,4,11,35,58,110
Mel McCants,1.0,1990 - 1990,SF,15,70,8,26,30.76923076923077,0,0,,8,26,30.76923076923077,30.76923076923077,6,8,75.0,1,5,6,2,3,1,1,12,22
Melvin Booker,2.0,1996 - 1997,PG,32,561,62,155,40.0,15,56,26.785714285714285,47,99,47.474747474747474,44.83870967741935,27,31,87.09677419354838,8,30,38,74,8,3,39,46,166
Melvin Ely,9.0,2003 - 2014,C,382,6064,787,1717,45.835760046592895,0,3,0.0,787,1714,45.915985997666276,45.835760046592895,433,692,62.57225433526011,453,773,1226,262,99,209,396,778,2007
Melvin Frazier,1.0,2019 - 2019,SG,10,44,7,21,33.33333333333333,0,6,0.0,7,15,46.666666666666664,33.33333333333333,1,4,25.0,3,2,5,1,1,0,1,6,15
Melvin Newbern,1.0,1993 - 1993,SG,33,311,42,113,37.16814159292036,1,8,12.5,41,105,39.04761904761905,37.610619469026545,34,60,56.666666666666664,19,18,37,57,23,1,32,42,119
Melvin Sanders,1.0,2006 - 2006,SG,16,113,16,33,48.484848484848484,2,3,66.66666666666666,14,30,46.666666666666664,51.515151515151516,7,10,70.0,4,19,23,3,5,0,8,20,41
Melvin Turpin,5.0,1985 - 1990,C,372,6947,1312,2541,51.633215269578905,1,9,11.11111111111111,1311,2532,51.77725118483413,51.652892561983464,479,617,77.63371150729336,581,1088,1669,185,160,353,438,861,3104
Mengke Bateer,3.0,2002 - 2004,C,46,494,61,156,39.1025641025641,5,15,33.33333333333333,56,141,39.71631205673759,40.705128205128204,29,39,74.35897435897436,39,75,114,27,11,5,40,118,156
Metta World Peace,17.0,2000 - 2017,SF,1076,34575,5097,12374,41.191207370292545,1282,3817,33.586586324338484,3815,8557,44.58338202641113,46.37142395345079,2762,3862,71.51734852408079,1279,3577,4856,2865,1852,578,1932,2830,14238
Meyers Leonard,7.0,2013 - 2019,C,407,6249,855,1778,48.087739032620924,281,720,39.02777777777778,574,1058,54.25330812854442,55.98987626546682,241,292,82.53424657534246,299,1218,1517,344,71,114,275,877,2232
Michael Adams,11.0,1986 - 1996,PG,673,21125,3342,8079,41.36650575566283,984,2964,33.198380566801625,2358,5115,46.09970674486804,47.456368362421095,2209,2603,84.86361890126777,430,1537,1967,4312,1113,69,1446,1234,9877
Michael Anderson,1.0,1989 - 1989,PG,36,730,73,175,41.714285714285715,1,7,14.285714285714285,72,168,42.857142857142854,42.0,57,82,69.51219512195121,44,45,89,153,44,3,84,64,204
Michael Ansley,3.0,1990 - 1992,SF,149,2143,383,746,51.34048257372654,0,0,,383,746,51.34048257372654,51.34048257372654,260,360,72.22222222222221,311,310,621,67,51,24,85,284,1026
Michael Beasley,11.0,2009 - 2019,PF,634,14367,3178,6857,46.34679889164357,301,861,34.959349593495936,2877,5996,47.981987991994664,48.54163628408925,1128,1490,75.70469798657719,692,2283,2975,804,353,322,1059,1337,7785
Michael Bradley,5.0,2002 - 2006,PF,174,2019,218,457,47.70240700218819,2,14,14.285714285714285,216,443,48.75846501128668,47.921225382932164,45,88,51.13636363636363,223,369,592,94,25,47,113,201,483
Michael Brooks,6.0,1981 - 1988,SF,323,9383,1674,3448,48.54988399071926,6,35,17.142857142857142,1668,3413,48.87196015235863,48.6368909512761,735,1029,71.42857142857143,827,1178,2005,820,387,124,638,982,4089
Michael Cage,15.0,1985 - 2000,C,1193,30821,3430,6661,51.49376970424861,0,27,0.0,3430,6634,51.703346397347005,51.49376970424861,1679,2547,65.92069100903024,3354,5594,8948,1087,1087,759,1200,2701,8539
Michael Carter-Williams,6.0,2014 - 2019,PG,326,8509,1315,3279,40.103690149435806,145,583,24.871355060034304,1170,2696,43.397626112759646,42.31473010064044,738,1055,69.95260663507109,295,1163,1458,1498,432,182,813,811,3513
Michael Curry,11.0,1994 - 2005,SG,703,13891,1155,2575,44.85436893203884,87,289,30.103806228373703,1068,2286,46.71916010498688,46.543689320388346,743,903,82.281284606866,204,882,1086,840,348,71,473,1609,3140
Michael Dickerson,5.0,1999 - 2003,SG,216,7572,1225,2846,43.042867182009836,291,725,40.13793103448276,934,2121,44.035832154644034,48.155305692199576,533,681,78.26725403817915,180,433,613,556,215,88,409,559,3274
Michael Doleac,10.0,1999 - 2008,C,618,9064,1276,2911,43.83373411198901,1,9,11.11111111111111,1275,2902,43.935217091660924,43.850910340089314,400,505,79.20792079207921,601,1423,2024,347,205,211,388,1364,2953
Michael Finley,15.0,1996 - 2010,SF,1232,41903,7245,16409,44.15259918337498,1654,4395,37.63367463026166,5591,12014,46.53737306475778,49.192516302029375,2687,3294,81.5725561627201,1205,4055,5260,3474,1096,355,1753,2029,18831
Michael Gbinije,1.0,2017 - 2017,SG,9,32,1,10,10.0,0,4,0.0,1,6,16.666666666666664,10.0,2,2,100.0,2,1,3,2,0,0,0,2,4
Michael Hawkins,4.0,1997 - 2001,PG,77,651,49,131,37.404580152671755,18,60,30.0,31,71,43.66197183098591,44.274809160305345,18,22,81.81818181818183,21,47,68,117,21,2,50,70,134
Michael Jackson,3.0,1988 - 1990,PG,89,888,76,206,36.89320388349515,9,33,27.27272727272727,67,173,38.72832369942196,39.07766990291262,27,40,67.5,20,50,70,198,28,5,66,96,188
Michael Jordan,15.0,1985 - 2003,SG,1251,48485,14380,29034,49.528139422745745,729,2224,32.77877697841727,13651,26810,50.91756807161507,50.78356409726528,8790,10538,83.41241222243309,1973,5851,7824,6655,2890,1051,3470,3324,38279
Michael Kidd-Gilchrist,7.0,2013 - 2019,SF,425,10788,1454,3046,47.73473407747866,23,84,27.380952380952383,1431,2962,48.311951384199865,48.11227839789888,793,1112,71.31294964028777,697,1682,2379,507,294,300,392,932,3724
Michael McDonald,1.0,1998 - 1998,C,1,4,0,0,,0,0,,0,0,,,0,0,,1,0,1,0,0,0,2,1,0
Michael Olowokandi,9.0,1999 - 2007,C,515,13353,1800,4146,43.41534008683068,0,1,0.0,1800,4145,43.42581423401688,43.41534008683068,566,944,59.95762711864406,967,2499,3466,329,228,708,915,1568,4166
Michael Phelps,3.0,1986 - 1988,SG,132,1372,195,469,41.57782515991471,2,22,9.090909090909092,193,447,43.17673378076063,41.7910447761194,78,122,63.934426229508205,45,96,141,138,71,3,96,147,470
Michael Redd,12.0,2001 - 2012,SG,645,20609,4306,9624,44.74231088944306,1061,2798,37.91994281629735,3245,6826,47.538822150600645,50.254571903574394,2583,3079,83.89087366027931,653,1831,2484,1370,585,67,999,1044,12256
Michael Ruffin,9.0,2000 - 2009,PF,434,6225,267,650,41.07692307692308,0,4,0.0,267,646,41.3312693498452,41.07692307692308,210,456,46.05263157894737,758,941,1699,263,206,198,280,988,744
Michael Smith,9.0,1990 - 2001,PF,518,10253,1037,2003,51.772341487768344,10,68,14.705882352941178,1027,1935,53.0749354005168,52.02196704942587,612,1060,57.73584905660377,1029,1912,2941,745,323,206,532,1038,2696
Michael Stewart,8.0,1998 - 2005,C,290,3317,248,559,44.364937388193205,0,0,,248,559,44.364937388193205,44.364937388193205,131,251,52.191235059760956,350,561,911,88,56,279,143,561,627
Michael Wiley,2.0,1981 - 1982,PF,97,1289,279,498,56.024096385542165,0,7,0.0,279,491,56.82281059063137,56.024096385542165,136,191,71.20418848167539,89,157,246,63,48,22,99,167,694
Michael Wilson,3.0,1984 - 1987,PG,32,338,39,89,43.82022471910113,0,1,0.0,39,88,44.31818181818182,43.82022471910113,30,40,75.0,16,20,36,45,15,5,28,36,108
Michael Young,3.0,1985 - 1990,SF,52,475,95,206,46.116504854368934,8,27,29.629629629629626,87,179,48.60335195530726,48.05825242718447,27,38,71.05263157894737,38,51,89,24,25,3,15,47,225
Micheal Williams,10.0,1989 - 1999,PG,429,10756,1524,3293,46.27998785302156,52,223,23.318385650224215,1472,3070,47.94788273615635,47.06954145156392,1608,1854,86.73139158576052,311,774,1085,2464,744,96,960,1123,4708
Mickael Gelabale,3.0,2007 - 2013,SF,145,2348,263,560,46.964285714285715,43,136,31.61764705882353,220,424,51.886792452830186,50.80357142857142,101,124,81.45161290322581,107,223,330,115,50,35,92,186,670
Mickael Pietrus,10.0,2004 - 2013,SF,626,13452,1785,4197,42.53037884203002,763,2148,35.52141527001862,1022,2049,49.87798926305515,51.62020490826781,801,1200,66.75,486,1402,1888,477,417,263,620,1456,5134
Mickell Gladness,1.0,2012 - 2012,PF,26,252,25,59,42.3728813559322,0,0,,25,59,42.3728813559322,42.3728813559322,6,12,50.0,14,44,58,5,4,20,7,32,56
Mickey Dillard,1.0,1982 - 1982,PG,33,221,29,79,36.708860759493675,0,4,0.0,29,75,38.666666666666664,36.708860759493675,15,23,65.21739130434783,6,9,15,34,8,2,17,40,73
Mikal Bridges,1.0,2019 - 2019,SF,82,2417,242,563,42.98401420959148,105,313,33.54632587859425,137,250,54.800000000000004,52.30905861456483,95,118,80.50847457627118,56,208,264,173,129,38,70,201,684
Mike Batiste,1.0,2003 - 2003,PF,75,1248,197,467,42.184154175588866,18,81,22.22222222222222,179,386,46.373056994818654,44.11134903640257,69,88,78.4090909090909,82,175,257,52,42,16,69,120,481
Mike Bibby,14.0,1999 - 2012,PG,1106,37446,5876,13554,43.35251586247602,1662,4390,37.85876993166287,4214,9164,45.98428633784374,49.48354729231223,2608,3246,80.34504004929144,593,2840,3433,5937,1283,174,2325,2169,16022
Mike Brittain,2.0,1986 - 1987,C,39,250,27,54,50.0,0,0,,27,54,50.0,50.0,11,21,52.38095238095239,13,41,54,7,4,13,22,57,65
Mike Brown,11.0,1987 - 1997,C,670,11664,1205,2655,45.38606403013183,1,8,12.5,1204,2647,45.485455232338495,45.40489642184558,960,1376,69.76744186046511,987,1938,2925,447,261,174,683,1481,3371
Mike Champion,1.0,1989 - 1989,SF,2,4,0,3,0.0,0,1,0.0,0,2,0.0,0.0,0,0,,0,0,0,0,0,0,1,2,0
Mike Conley,12.0,2008 - 2019,PG,844,27793,4503,10260,43.888888888888886,1156,3115,37.1107544141252,3347,7145,46.84394681595521,49.5224171539961,2496,3057,81.648675171737,369,2163,2532,4886,1242,174,1705,1675,12658
Mike Davis,1.0,1983 - 1983,PF,9,29,4,10,40.0,0,0,,4,10,40.0,40.0,6,10,60.0,3,7,10,0,0,4,0,4,14
Mike Gibson,2.0,1984 - 1986,PF,64,390,41,106,38.67924528301887,0,0,,41,106,38.67924528301887,38.67924528301887,19,28,67.85714285714286,44,62,106,14,13,11,20,65,101
Mike Gminski,14.0,1981 - 1994,C,973,24975,4356,9352,46.57827202737382,6,54,11.11111111111111,4350,9298,46.78425467842547,46.61035072711719,2628,3124,84.12291933418695,2137,4536,6673,1232,529,1046,1416,1646,11346
Mike Hall,1.0,2007 - 2007,SF,2,13,1,4,25.0,0,0,,1,4,25.0,25.0,0,0,,1,1,2,1,0,0,0,1,2
Mike Harper,2.0,1981 - 1982,PF,124,1900,241,507,47.53451676528599,0,4,0.0,241,503,47.912524850894634,47.53451676528599,134,239,56.06694560669456,155,278,433,71,78,102,124,302,616
Mike Harris,4.0,2008 - 2014,PF,57,505,71,153,46.40522875816993,0,5,0.0,71,148,47.97297297297297,46.40522875816993,44,57,77.19298245614034,52,66,118,12,27,12,30,68,186
Mike Higgins,2.0,1990 - 1991,SF,18,111,9,18,50.0,0,0,,9,18,50.0,50.0,12,17,70.58823529411765,6,3,9,5,2,4,5,21,30
Mike Holton,6.0,1985 - 1990,PG,334,5934,809,1839,43.99129961935835,28,114,24.561403508771928,781,1725,45.27536231884058,44.75258292550299,400,495,80.8080808080808,132,335,467,992,210,30,413,592,2046
Mike Iuzzolino,2.0,1992 - 1993,PG,122,3049,381,833,45.73829531812726,113,280,40.35714285714286,268,553,48.4629294755877,52.52100840336135,221,277,79.78339350180505,58,180,238,522,82,7,221,180,1096
Mike James,13.0,2002 - 2018,PG,664,15445,2316,5580,41.50537634408602,721,1939,37.18411552346571,1595,3641,43.80664652567976,47.96594982078853,996,1246,79.93579454253612,234,1220,1454,2242,499,47,970,1289,6349
Mike McGee,9.0,1982 - 1990,SF,588,10109,2288,4686,48.82629107981221,327,926,35.313174946004324,1961,3760,52.15425531914894,52.31540759709774,551,920,59.89130434782609,605,616,1221,684,394,52,684,1112,5454
Mike Miller,17.0,2001 - 2017,SF,1126,29364,4181,9161,45.63912236655387,1687,4156,40.59191530317613,2494,5005,49.83016983016983,54.846632463704836,1388,1801,77.0682953914492,661,3951,4612,2753,615,243,1617,2201,11437
Mike Morrison,1.0,1990 - 1990,SG,36,153,23,68,33.82352941176471,2,7,28.57142857142857,21,61,34.42622950819672,35.294117647058826,24,30,80.0,7,13,20,11,2,0,23,20,72
Mike Muscala,6.0,2014 - 2019,PF,334,5140,683,1459,46.81288553803976,222,615,36.09756097560975,461,844,54.62085308056872,54.420836189170664,252,299,84.2809364548495,317,736,1053,294,117,169,213,491,1840
Mike Niles,1.0,1981 - 1981,SF,46,235,48,143,33.56643356643357,2,4,50.0,46,139,33.093525179856115,34.26573426573427,17,37,45.94594594594595,26,32,58,15,9,1,25,41,115
Mike O'Koren,8.0,1981 - 1988,SF,427,9143,1483,3051,48.60701409373976,35,132,26.515151515151516,1448,2919,49.60602946214457,49.18059652572927,428,658,65.04559270516718,510,942,1452,889,317,94,561,953,3429
Mike Penberthy,2.0,2001 - 2002,PG,56,863,93,224,41.517857142857146,55,139,39.568345323741006,38,85,44.70588235294118,53.79464285714286,31,35,88.57142857142857,10,55,65,73,24,2,34,57,272
Mike Peplowski,3.0,1994 - 1996,C,68,705,84,151,55.62913907284768,0,1,0.0,84,150,56.00000000000001,55.62913907284768,26,49,53.06122448979592,51,125,176,26,19,27,38,151,194
Mike Sanders,11.0,1983 - 1993,SF,715,13508,2348,4861,48.30281835013372,22,95,23.157894736842106,2326,4766,48.8040285354595,48.52910923678255,869,1129,76.97077059344552,750,1345,2095,965,507,228,804,1841,5587
Mike Scott,7.0,2013 - 2019,PF,474,7748,1309,2816,46.484375,390,1078,36.178107606679035,919,1738,52.87686996547756,53.40909090909091,366,481,76.0914760914761,333,1150,1483,421,148,59,334,713,3374
Mike Smith,1.0,2001 - 2001,SF,17,180,19,59,32.20338983050847,3,18,16.666666666666664,16,41,39.02439024390244,34.74576271186441,10,16,62.5,10,12,22,10,5,3,7,8,51
Mike Smrek,7.0,1986 - 1992,C,215,1962,214,505,42.37623762376238,0,2,0.0,214,503,42.54473161033797,42.37623762376238,137,223,61.43497757847533,150,285,435,49,38,160,141,438,565
Mike Sweetney,4.0,2004 - 2007,C,244,3790,585,1211,48.30718414533444,0,2,0.0,585,1209,48.38709677419355,48.30718414533444,407,590,68.98305084745763,420,668,1088,152,76,114,284,601,1577
Mike Taylor,1.0,2009 - 2009,PG,51,771,110,267,41.19850187265918,13,40,32.5,97,227,42.731277533039645,43.63295880149813,56,81,69.1358024691358,22,65,87,106,36,0,73,84,289
Mike Tobey,1.0,2017 - 2017,C,2,25,1,4,25.0,0,0,,1,4,25.0,25.0,0,0,,2,1,3,1,0,0,1,2,2
Mike Wilks,7.0,2003 - 2010,PG,239,2252,218,542,40.22140221402214,35,107,32.71028037383177,183,435,42.06896551724138,43.450184501845015,123,166,74.09638554216868,57,171,228,272,82,10,118,215,594
Mike Williams,1.0,1990 - 1990,PF-SF,21,102,6,18,33.33333333333333,0,1,0.0,6,17,35.294117647058826,33.33333333333333,3,6,50.0,5,18,23,2,3,7,3,30,15
Mike Woodson,11.0,1981 - 1991,SG,799,20369,4427,9512,46.54121110176619,123,456,26.973684210526315,4304,9056,47.52650176678445,47.18776282590412,2162,2656,81.40060240963855,672,1196,1868,1856,962,279,1354,1882,11139
Mikki Moore,13.0,1999 - 2012,C,589,10764,1335,2426,55.028854080791426,2,13,15.384615384615385,1333,2413,55.24243680066307,55.070074196207756,753,1008,74.70238095238095,813,1477,2290,430,192,318,562,1608,3425
Mile Ilic,1.0,2007 - 2007,C,5,6,0,3,0.0,0,0,,0,3,0.0,0.0,0,0,,0,1,1,0,0,0,3,1,0
Miles Bridges,1.0,2019 - 2019,SF,80,1696,237,511,46.37964774951076,65,200,32.5,172,311,55.30546623794213,52.73972602739726,58,77,75.32467532467533,67,256,323,95,55,49,50,111,597
Miles Plumlee,7.0,2013 - 2019,C,347,5674,749,1389,53.92368610511159,0,0,,749,1389,53.92368610511159,53.92368610511159,202,372,54.3010752688172,550,1018,1568,179,153,257,309,541,1700
Miles Simon,1.0,1999 - 1999,SG,5,19,1,5,20.0,0,2,0.0,1,3,33.33333333333333,20.0,0,0,,1,1,2,0,1,0,3,1,2
Milos Babic,2.0,1991 - 1992,PF,21,87,12,32,37.5,0,0,,12,32,37.5,37.5,13,20,65.0,8,12,20,10,2,1,10,7,37
Milos Teodosic,2.0,2018 - 2019,PG,60,1284,168,400,42.0,98,259,37.83783783783784,70,141,49.645390070921984,54.25,43,53,81.13207547169812,19,123,142,241,26,6,118,130,477
Milt Palacio,7.0,2000 - 2006,PG,470,8421,863,2060,41.89320388349515,40,170,23.52941176470588,823,1890,43.544973544973544,42.86407766990291,477,663,71.94570135746606,159,672,831,1194,302,58,596,685,2243
Milt Wagner,2.0,1988 - 1991,SG,58,510,88,209,42.10526315789473,8,28,28.57142857142857,80,181,44.19889502762431,44.01913875598086,37,42,88.09523809523809,4,33,37,79,8,8,34,59,221
Milton Doyle,1.0,2018 - 2018,SG,10,125,13,47,27.659574468085108,4,23,17.391304347826086,9,24,37.5,31.914893617021278,4,8,50.0,3,15,18,10,6,2,2,13,34
Mindaugas Kuzminskas,2.0,2017 - 2018,SF,69,1018,158,371,42.58760107816711,54,168,32.142857142857146,104,203,51.231527093596064,49.865229110512125,55,68,80.88235294117648,47,79,126,69,29,11,51,79,425
Miroslav Raduljica,2.0,2014 - 2015,C,53,488,71,134,52.98507462686567,0,0,,71,134,52.98507462686567,52.98507462686567,47,57,82.45614035087719,56,57,113,23,8,13,30,92,189
Mirsad Turkcan,1.0,2000 - 2000,PF,19,100,15,43,34.883720930232556,0,7,0.0,15,36,41.66666666666667,34.883720930232556,7,10,70.0,13,22,35,5,3,1,11,15,37
Mirza Teletovic,6.0,2013 - 2018,PF,343,6029,964,2378,40.53826745164003,561,1524,36.811023622047244,403,854,47.18969555035129,52.33389402859546,249,331,75.22658610271903,204,885,1089,276,111,84,262,570,2738
Mitch Creek,1.0,2019 - 2019,SF,5,48,8,16,50.0,0,2,0.0,8,14,57.14285714285714,50.0,5,7,71.42857142857143,6,6,12,6,2,0,1,3,21
Mitch McGary,2.0,2015 - 2016,PF,52,557,99,188,52.659574468085104,0,6,0.0,99,182,54.395604395604394,52.659574468085104,29,50,57.99999999999999,57,126,183,17,17,18,38,82,227
Mitch Richmond,14.0,1989 - 2002,SG,999,35145,7477,16397,45.599804842349215,1345,3480,38.64942528735632,6132,12917,47.47232329488271,49.70116484722815,4647,5464,85.04758418740849,904,3020,3924,3467,1233,261,2636,2567,20946
Mitchell Butler,8.0,1994 - 2004,SG,364,5468,708,1615,43.8390092879257,95,313,30.35143769968051,613,1302,47.08141321044547,46.78018575851393,359,576,62.326388888888886,246,472,718,342,214,53,353,576,1870
Mitchell Robinson,1.0,2019 - 2019,C,66,1360,202,291,69.41580756013745,0,0,,202,291,69.41580756013745,69.41580756013745,81,135,60.0,177,246,423,37,52,161,35,217,485
Mitchell Wiggins,6.0,1984 - 1992,SG,418,8644,1701,3680,46.22282608695652,14,76,18.421052631578945,1687,3604,46.80910099889012,46.41304347826087,694,920,75.43478260869566,630,698,1328,643,416,37,487,997,4110
Mo Williams,13.0,2004 - 2016,PG,880,25383,4271,9864,43.29886455798865,1168,3115,37.495987158908505,3103,6749,45.97718180471181,49.219383617193834,1656,1910,86.70157068062827,422,1951,2373,4150,751,129,1944,2143,11366
Mohamed Bamba,1.0,2019 - 2019,C,47,766,117,243,48.148148148148145,21,70,30.0,96,173,55.49132947976878,52.46913580246913,37,63,58.730158730158735,64,169,233,39,13,64,43,102,292
Monta Ellis,12.0,2006 - 2017,SG,871,30148,5924,13159,45.01861843605137,773,2470,31.29554655870445,5151,10689,48.18972775750772,47.95577171517593,2758,3573,77.19003638399104,545,2435,2980,3969,1465,289,2332,2040,15379
Monte Morris,2.0,2018 - 2019,PG,85,1995,350,708,49.43502824858757,94,228,41.228070175438596,256,480,53.333333333333336,56.07344632768362,67,83,80.72289156626506,35,161,196,304,76,4,53,103,861
Monti Davis,1.0,1981 - 1981,PF,2,10,1,5,20.0,0,0,,1,5,20.0,20.0,1,5,20.0,2,2,4,0,0,1,0,0,3
Montrezl Harrell,4.0,2016 - 2019,C,262,4927,1179,1877,62.81299946723495,5,33,15.151515151515152,1174,1844,63.66594360086768,62.946190729888116,509,811,62.76202219482121,394,739,1133,319,138,215,264,580,2872
Monty Williams,9.0,1995 - 2003,SF,486,7888,1177,2448,48.080065359477125,4,38,10.526315789473683,1173,2410,48.67219917012448,48.161764705882355,609,919,66.2676822633297,524,828,1352,554,256,139,572,926,2967
Moochie Norris,9.0,1997 - 2006,PG,447,7647,816,2034,40.117994100294986,116,406,28.57142857142857,700,1628,42.997542997543,42.96951819075713,524,708,74.01129943502825,209,659,868,1233,321,19,524,484,2272
Mookie Blaylock,13.0,1990 - 2002,PG,943,33187,4985,12256,40.67395561357702,1408,4173,33.74071411454589,3577,8083,44.253371273042184,46.41808093994778,1353,1847,73.25392528424473,1084,2841,3925,6329,2191,324,2229,1789,12731
Moritz Wagner,1.0,2019 - 2019,C,43,446,71,171,41.52046783625731,22,77,28.57142857142857,49,94,52.12765957446809,47.953216374269005,43,53,81.13207547169812,17,68,85,24,11,13,39,57,207
Morlon Wiley,7.0,1989 - 1995,PG,295,3843,421,1023,41.15347018572825,130,367,35.42234332425068,291,656,44.359756097560975,47.50733137829912,106,150,70.66666666666667,89,252,341,722,243,17,311,444,1078
Morris Almond,3.0,2008 - 2012,SG,38,361,43,113,38.05309734513274,7,24,29.166666666666668,36,89,40.44943820224719,41.150442477876105,26,35,74.28571428571429,10,36,46,12,12,4,19,42,119
Morris Peterson,11.0,2001 - 2011,SG,744,20111,2832,6753,41.93691692581075,1038,2777,37.37846597047173,1794,3976,45.12072434607646,49.622390048867175,1148,1486,77.25437415881561,583,1987,2570,1126,659,144,740,1685,7850
Mouhamed Sene,3.0,2007 - 2009,C,47,260,35,82,42.68292682926829,0,0,,35,82,42.68292682926829,42.68292682926829,33,56,58.92857142857143,28,47,75,1,4,22,15,44,103
Muggsy Bogues,14.0,1988 - 2001,PG,908,26067,2915,6377,45.7111494433119,116,402,28.855721393034827,2799,5975,46.84518828451883,46.62066802571742,1082,1310,82.59541984732824,547,1822,2369,6833,1402,39,1470,1618,7028
Mustafa Shakur,2.0,2011 - 2014,PG,25,170,21,62,33.87096774193548,1,11,9.090909090909092,20,51,39.21568627450981,34.67741935483871,9,17,52.94117647058824,7,15,22,29,5,3,20,17,52
Mychal Thompson,11.0,1981 - 1991,C,963,28207,5153,10211,50.46518460483792,1,12,8.333333333333332,5152,10199,50.514756348661635,50.47008128488885,2502,3789,66.0332541567696,2246,4697,6943,2085,688,1040,2050,2720,12809
Mychel Thompson,1.0,2012 - 2012,SG,5,95,7,24,29.166666666666668,4,11,36.36363636363637,3,13,23.076923076923077,37.5,0,0,,0,5,5,7,2,1,5,8,18
Myke Henry,1.0,2018 - 2018,SF,20,378,41,109,37.61467889908257,19,58,32.758620689655174,22,51,43.13725490196079,46.330275229357795,6,10,60.0,10,28,38,22,31,6,19,28,107
Myles Patrick,1.0,1981 - 1981,SF,3,9,2,5,40.0,0,0,,2,5,40.0,40.0,1,2,50.0,1,1,2,1,0,0,1,3,5
Myles Turner,4.0,2016 - 2019,C,298,8389,1479,2987,49.51456310679612,181,503,35.984095427435385,1298,2484,52.25442834138486,52.5443588885169,667,867,76.93194925028835,429,1548,1977,359,208,607,397,865,3806
Myron Brown,1.0,1992 - 1992,PG,4,23,4,6,66.66666666666666,1,3,33.33333333333333,3,3,100.0,75.0,0,0,,0,3,3,6,1,0,4,2,9
Myron Jackson,1.0,1987 - 1987,PG,8,22,2,9,22.22222222222222,0,0,,2,9,22.22222222222222,22.22222222222222,7,8,87.5,1,2,3,6,1,0,5,1,11
Nando De Colo,2.0,2013 - 2014,SG,125,1432,170,398,42.71356783919598,49,138,35.507246376811594,121,260,46.53846153846154,48.86934673366834,68,81,83.9506172839506,39,177,216,205,63,12,116,138,457
Nate Blackwell,1.0,1988 - 1988,PG,10,112,15,41,36.58536585365854,2,11,18.181818181818183,13,30,43.333333333333336,39.02439024390244,5,6,83.33333333333334,2,4,6,18,3,0,8,16,37
Nate Driggers,1.0,1997 - 1997,SG,15,132,13,43,30.23255813953488,0,9,0.0,13,34,38.23529411764706,30.23255813953488,10,14,71.42857142857143,12,10,22,6,3,2,6,10,36
Nate Huffman,1.0,2003 - 2003,C,7,76,9,25,36.0,0,0,,9,25,36.0,36.0,5,8,62.5,9,14,23,5,1,3,3,13,23
Nate Johnston,1.0,1990 - 1990,PF-SF,24,106,24,59,40.67796610169492,1,4,25.0,23,55,41.81818181818181,41.52542372881356,10,14,71.42857142857143,15,14,29,2,4,9,6,16,59
Nate McMillan,12.0,1987 - 1998,PG,894,22648,2017,4619,43.66746048928339,335,998,33.567134268537075,1682,3621,46.45125655896161,47.29378653388179,853,1316,64.8176291793313,1017,2548,3565,5398,1675,399,1625,2679,5222
Nate Robinson,11.0,2006 - 2016,PG,650,14422,2555,6045,42.26633581472291,846,2359,35.86265366680797,1709,3686,46.364622897449806,49.26385442514475,1125,1415,79.50530035335689,395,1097,1492,1898,561,45,915,1537,7081
Nate Wolters,3.0,2014 - 2018,PG,84,1575,191,452,42.256637168141594,18,69,26.08695652173913,173,383,45.16971279373368,44.24778761061947,61,96,63.541666666666664,42,143,185,209,43,17,70,86,461
Nathan Jawai,2.0,2009 - 2010,PF,45,431,50,115,43.47826086956522,0,1,0.0,50,114,43.859649122807014,43.47826086956522,26,38,68.42105263157895,50,56,106,24,10,9,29,61,126
Naz Mitrou-Long,2.0,2018 - 2019,SG,15,85,7,21,33.33333333333333,3,12,25.0,4,9,44.44444444444444,40.476190476190474,2,2,100.0,1,5,6,15,1,1,8,10,19
Nazr Mohammed,18.0,1999 - 2016,C,1093,17041,2552,5231,48.78608296692793,2,11,18.181818181818183,2550,5220,48.85057471264368,48.80519977059836,1092,1707,63.971880492091394,1949,3068,5017,392,462,691,971,2335,6198
Ndudi Ebi,2.0,2004 - 2005,SG,19,86,17,35,48.57142857142857,0,1,0.0,17,34,50.0,48.57142857142857,6,13,46.15384615384615,8,11,19,4,1,5,6,13,40
Negele Knight,6.0,1991 - 1999,PG,293,4711,706,1622,43.526510480887794,26,101,25.742574257425744,680,1521,44.707429322813944,44.32799013563502,348,474,73.41772151898735,119,245,364,808,127,31,371,420,1786
Nemanja Bjelica,4.0,2016 - 2019,PF,274,5471,723,1571,46.02164226607257,287,749,38.31775700934579,436,822,53.04136253041363,55.155951623169955,196,260,75.38461538461539,288,899,1187,398,173,113,241,652,1929
Nemanja Nedovic,1.0,2014 - 2014,SG,25,142,8,39,20.51282051282051,3,18,16.666666666666664,5,21,23.809523809523807,24.358974358974358,7,8,87.5,3,12,15,13,0,1,13,14,26
Nenad Krstic,7.0,2005 - 2011,C,447,11252,1836,3715,49.421265141318976,2,14,14.285714285714285,1834,3701,49.55417454741961,49.44818304172274,826,1127,73.29192546583852,827,1586,2413,367,171,306,533,1340,4500
Nene Hilario,17.0,2003 - 2019,C,1049,27385,4491,8226,54.59518599562363,7,54,12.962962962962962,4484,8172,54.87028879099364,54.637734014101625,2730,4166,65.5304848775804,1843,4464,6307,1861,1110,768,1808,3210,11719
Nerlens Noel,5.0,2015 - 2019,C,300,6850,1009,1930,52.27979274611398,1,4,25.0,1008,1926,52.336448598130836,52.30569948186529,426,675,63.11111111111111,607,1333,1940,365,413,410,429,751,2445
Nick Anderson,13.0,1990 - 2002,SG,849,26688,4643,10440,44.47318007662835,1144,3231,35.406994738471056,3499,7209,48.536551532806214,49.952107279693486,1743,2610,66.7816091954023,1064,3238,4302,2197,1186,393,1434,1610,12173
Nick Calathes,2.0,2014 - 2015,SG,138,2137,258,594,43.43434343434344,36,117,30.76923076923077,222,477,46.540880503144656,46.464646464646464,71,125,56.8,43,216,259,369,138,14,172,232,623
Nick Collison,14.0,2005 - 2018,PF,1001,20135,2376,4440,53.51351351351351,24,108,22.22222222222222,2352,4332,54.29362880886427,53.783783783783775,974,1353,71.98817442719881,1917,3132,5049,1010,498,513,930,2763,5750
Nick Fazekas,1.0,2008 - 2008,PF,26,269,46,82,56.09756097560976,0,2,0.0,46,80,57.49999999999999,56.09756097560976,15,22,68.18181818181817,34,55,89,11,8,11,13,25,107
Nick Johnson,1.0,2015 - 2015,SG,37,311,30,92,32.608695652173914,6,28,21.428571428571427,24,64,37.5,35.869565217391305,20,28,71.42857142857143,14,29,43,15,7,4,23,41,86
Nick Van Exel,13.0,1994 - 2006,PG,956,31359,5008,12403,40.377328065790536,1642,4630,35.46436285097192,3366,7773,43.303743728290236,46.996694348141574,2032,2572,79.00466562986003,429,2337,2766,6119,790,98,1979,1559,13690
Nick Vanos,2.0,1986 - 1987,C,68,842,88,230,38.26086956521739,0,2,0.0,88,228,38.59649122807017,38.26086956521739,46,82,56.09756097560976,88,152,240,59,21,28,68,128,222
Nick Young,12.0,2008 - 2019,SG,755,16841,2940,7049,41.70804369414101,1070,2846,37.596626844694306,1870,4203,44.492029502736145,49.2977727337211,1392,1666,83.55342136854742,263,1190,1453,695,400,139,721,1355,8342
Nicolas Batum,11.0,2009 - 2019,SF,806,25393,3366,7738,43.49961230292065,1291,3619,35.672837800497376,2075,4119,50.37630492838068,51.84156112690618,1420,1692,83.92434988179669,834,3380,4214,3004,755,505,1489,1429,9443
Nicolas Brussino,2.0,2017 - 2018,SG,58,531,52,143,36.36363636363637,29,97,29.896907216494846,23,46,50.0,46.50349650349651,17,22,77.27272727272727,26,72,98,47,17,8,26,43,150
Nicolas Laprovittola,1.0,2017 - 2017,PG,18,174,20,47,42.5531914893617,10,27,37.03703703703704,10,20,50.0,53.191489361702125,9,9,100.0,1,9,10,28,4,1,19,19,59
Nigel Hayes,1.0,2018 - 2018,SF,9,122,11,33,33.33333333333333,4,16,25.0,7,17,41.17647058823529,39.39393939393939,1,3,33.33333333333333,4,18,22,6,2,3,2,8,27
Nik Stauskas,5.0,2015 - 2019,SG,335,6662,765,1967,38.891713268937465,396,1121,35.325602140945584,369,846,43.61702127659575,48.95780376207423,346,425,81.41176470588235,77,611,688,513,139,80,339,425,2272
Nikita Wilson,1.0,1988 - 1988,SF,15,54,7,23,30.434782608695656,0,0,,7,23,30.434782608695656,30.434782608695656,5,6,83.33333333333334,2,9,11,3,0,0,5,7,19
Nikola Jokic,4.0,2016 - 2019,C,308,8718,1921,3670,52.3433242506812,267,773,34.54075032341527,1654,2897,57.093545046599935,55.980926430517705,897,1083,82.82548476454294,816,2130,2946,1586,338,221,733,862,5006
Nikola Mirotic,5.0,2015 - 2019,PF,345,8364,1389,3302,42.065414900060574,653,1828,35.72210065645514,736,1474,49.93215739484396,51.95336159903089,729,903,80.73089700996677,321,1719,2040,440,260,249,403,728,4160
Nikola Pekovic,6.0,2011 - 2016,C,271,6744,1314,2537,51.793456838785964,0,0,,1314,2537,51.793456838785964,51.793456838785964,777,1023,75.95307917888563,803,1004,1807,199,140,151,414,632,3405
Nikola Vucevic,8.0,2012 - 2019,C,537,16108,3692,7354,50.203970628229534,178,536,33.2089552238806,3514,6818,51.54004106776181,51.41419635572477,850,1148,74.0418118466899,1459,3979,5438,1310,461,509,942,1372,8412
Nikoloz Tskitishvili,4.0,2003 - 2006,PF,176,1954,190,629,30.206677265500797,43,184,23.369565217391305,147,445,33.03370786516854,33.62480127186009,85,117,72.64957264957265,109,199,308,116,46,50,127,228,508
Noah Vonleh,5.0,2015 - 2019,PF,309,5407,596,1319,45.185746777862015,89,282,31.560283687943265,507,1037,48.89103182256509,48.55951478392721,265,390,67.94871794871796,443,1207,1650,238,129,133,250,580,1546
Noel Felix,1.0,2006 - 2006,SF,12,82,6,25,24.0,1,3,33.33333333333333,5,22,22.727272727272727,26.0,5,8,62.5,3,10,13,2,2,3,8,13,18
Nolan Smith,2.0,2012 - 2013,PG,84,829,109,294,37.07482993197279,19,73,26.027397260273972,90,221,40.723981900452486,40.30612244897959,40,56,71.42857142857143,24,59,83,97,25,4,71,81,277
Norm Richardson,1.0,2002 - 2002,SG,11,67,10,26,38.46153846153847,4,8,50.0,6,18,33.33333333333333,46.15384615384615,6,9,66.66666666666666,3,5,8,2,0,0,3,5,30
Norman Black,1.0,1981 - 1981,SG,3,28,3,10,30.0,0,0,,3,10,30.0,30.0,2,8,25.0,0,2,2,2,1,0,1,2,8
Norman Powell,4.0,2016 - 2019,SG,288,4754,733,1675,43.76119402985075,236,685,34.45255474452555,497,990,50.2020202020202,50.80597014925373,293,362,80.93922651933701,81,514,595,331,180,58,254,440,1995
Norris Cole,6.0,2012 - 2017,PG,428,9141,1115,2730,40.84249084249084,246,741,33.198380566801625,869,1989,43.6902966314731,45.34798534798535,325,435,74.71264367816092,88,693,781,1079,311,39,574,796,2801
Norris Coleman,1.0,1988 - 1988,SF,29,431,66,191,34.55497382198953,1,2,50.0,65,189,34.39153439153439,34.81675392670157,20,36,55.55555555555556,36,45,81,13,11,6,16,51,153
O.J. Mayo,8.0,2009 - 2016,SG,573,17600,2895,6797,42.59232014123878,887,2379,37.28457335014712,2008,4418,45.45043005885016,49.11725761365308,1160,1414,82.03677510608203,298,1494,1792,1671,586,147,1174,1313,7837
OG Anunoby,2.0,2018 - 2019,SF,151,3071,375,802,46.758104738154614,153,428,35.74766355140187,222,374,59.35828877005348,56.29675810473815,83,135,61.48148148148148,111,291,402,109,104,40,106,293,986
Obinna Ekezie,4.0,2000 - 2005,PF,143,1516,165,390,42.30769230769231,0,1,0.0,165,389,42.41645244215938,42.30769230769231,180,250,72.0,146,237,383,31,38,27,95,254,510
Ognjen Kuzmic,2.0,2014 - 2015,C,40,172,13,25,52.0,0,0,,13,25,52.0,52.0,9,15,60.0,18,24,42,8,5,5,15,32,35
Okaro White,3.0,2017 - 2019,PF,44,557,40,105,38.095238095238095,16,47,34.04255319148936,24,58,41.37931034482759,45.714285714285715,22,25,88.0,29,66,95,23,11,11,19,58,118
Olden Polynice,15.0,1988 - 2004,C,1095,25654,3662,7229,50.65707566745055,6,28,21.428571428571427,3656,7201,50.77072628801555,50.69857518328953,1171,2187,53.54366712391404,2817,4514,7331,756,531,673,1199,2947,8501
Oleksiy Pecherov,3.0,2008 - 2010,C,114,1052,160,415,38.55421686746988,45,155,29.03225806451613,115,260,44.230769230769226,43.97590361445783,75,94,79.7872340425532,88,179,267,20,22,23,59,119,440
Oliver Lafayette,1.0,2010 - 2010,SG,1,22,3,6,50.0,1,2,50.0,2,4,50.0,58.333333333333336,0,0,,1,3,4,2,0,0,1,0,7
Oliver Miller,9.0,1993 - 2004,C,542,12065,1626,3035,53.57495881383855,5,48,10.416666666666668,1621,2987,54.268496819551395,53.65733113673805,585,926,63.17494600431965,989,2085,3074,1127,482,834,981,1579,3842
Oliver Robinson,1.0,1983 - 1983,SG,35,147,35,97,36.08247422680412,1,11,9.090909090909092,34,86,39.53488372093023,36.597938144329895,30,45,66.66666666666666,6,11,17,21,4,2,13,18,101
Olumide Oyedeji,3.0,2001 - 2003,C,96,604,54,106,50.943396226415096,0,0,,54,106,50.943396226415096,50.943396226415096,28,46,60.86956521739131,65,137,202,12,16,15,31,108,136
Omar Cook,2.0,2004 - 2005,PG,22,213,17,51,33.33333333333333,0,5,0.0,17,46,36.95652173913043,33.33333333333333,3,6,50.0,5,8,13,46,16,1,16,20,37
Omari Johnson,1.0,2018 - 2018,PF,4,75,9,21,42.857142857142854,4,12,33.33333333333333,5,9,55.55555555555556,52.38095238095239,0,0,,4,7,11,7,2,0,3,6,22
Omari Spellman,1.0,2019 - 2019,PF,46,805,98,244,40.16393442622951,44,128,34.375,54,116,46.55172413793103,49.18032786885246,32,45,71.11111111111111,72,122,194,47,26,25,31,67,272
Omer Asik,8.0,2011 - 2018,C,508,9942,1000,1904,52.52100840336135,0,1,0.0,1000,1903,52.548607461902265,52.52100840336135,631,1146,55.06108202443281,1108,2458,3566,302,181,371,585,1024,2631
Omri Casspi,10.0,2010 - 2019,SF,588,11959,1718,3781,45.43771489024068,493,1339,36.8185212845407,1225,2442,50.16380016380017,51.9571541920127,713,1052,67.77566539923954,473,1882,2355,662,362,134,595,917,4642
Orien Greene,4.0,2006 - 2011,SG,131,1555,127,328,38.71951219512195,11,52,21.153846153846153,116,276,42.028985507246375,40.396341463414636,61,95,64.21052631578948,49,146,195,155,98,15,144,228,326
Orlando Graham,1.0,1989 - 1989,PF,9,30,4,12,33.33333333333333,0,0,,4,12,33.33333333333333,33.33333333333333,3,6,50.0,8,4,12,0,0,0,3,6,11
Orlando Johnson,3.0,2013 - 2016,SG,115,1140,119,338,35.20710059171598,48,154,31.16883116883117,71,184,38.58695652173913,42.30769230769231,53,75,70.66666666666667,33,150,183,70,20,14,49,86,339
Orlando Woolridge,13.0,1982 - 1994,SF,887,24946,5311,10364,51.244693168660746,8,90,8.88888888888889,5303,10274,51.6157290247226,51.28328830567348,3421,4649,73.58571735857173,1404,2422,3826,1651,573,595,1802,2271,14051
Oscar Torres,2.0,2002 - 2003,SG,82,1184,151,377,40.05305039787798,44,139,31.654676258992804,107,238,44.957983193277315,45.88859416445623,96,125,76.8,50,84,134,43,29,11,57,73,442
Othell Wilson,2.0,1985 - 1987,PG,127,2049,216,476,45.378151260504204,6,34,17.647058823529413,210,442,47.511312217194565,46.008403361344534,97,130,74.61538461538461,63,149,212,424,119,16,172,189,535
Othella Harrington,12.0,1997 - 2008,PF,737,14199,2065,4088,50.513698630136986,0,12,0.0,2065,4076,50.66241413150148,50.513698630136986,1195,1622,73.67447595561035,1109,2078,3187,449,191,290,964,1909,5325
Othello Hunter,2.0,2009 - 2010,SF,27,139,17,35,48.57142857142857,0,0,,17,35,48.57142857142857,48.57142857142857,3,9,33.33333333333333,18,24,42,1,3,7,5,17,37
Othyus Jeffers,3.0,2010 - 2014,SG,43,452,47,106,44.339622641509436,1,6,16.666666666666664,46,100,46.0,44.81132075471698,46,70,65.71428571428571,35,61,96,22,21,0,22,45,141
Otis Smith,6.0,1987 - 1992,SG,382,7788,1551,3414,45.430579964850615,47,187,25.13368983957219,1504,3227,46.60675550046483,46.118922085530166,831,1093,76.02927721866422,611,823,1434,700,379,191,565,810,3980
Otis Thorpe,17.0,1985 - 2001,PF,1335,42074,7193,13157,54.67051759519648,4,67,5.970149253731343,7189,13090,54.919786096256686,54.685718628866766,4000,5845,68.43455945252353,3628,7289,10917,2858,873,516,2891,4387,18390
Otto Porter,6.0,2014 - 2019,SF,430,11670,1824,3771,48.36913285600637,555,1386,40.04329004329004,1269,2385,53.20754716981132,55.72792362768496,490,624,78.52564102564102,503,1681,2184,642,510,191,339,786,4693
Ozell Jones,2.0,1985 - 1986,C,75,979,114,193,59.067357512953365,0,1,0.0,114,192,59.375,59.067357512953365,34,89,38.20224719101123,70,187,257,60,33,62,71,162,262
P.J. Brown,15.0,1994 - 2008,PF,1195,36706,4137,9021,45.85966079148653,8,61,13.114754098360656,4129,8960,46.082589285714285,45.90400177363929,2345,2967,79.03606336366701,3263,5846,9109,1764,979,1199,1439,3545,10627
P.J. Hairston,2.0,2015 - 2016,SG,113,2022,234,683,34.2606149341142,120,407,29.484029484029485,114,276,41.30434782608695,43.04538799414349,81,102,79.41176470588235,47,219,266,59,54,24,64,199,669
P.J. Tucker,8.0,2007 - 2019,SF,609,17545,1634,3862,42.30968410150181,626,1715,36.501457725947525,1008,2147,46.94923148579413,50.41429311237701,611,824,74.1504854368932,952,2539,3491,857,730,185,607,1468,4505
PJ Dozier,2.0,2018 - 2019,PG,8,54,9,23,39.130434782608695,2,8,25.0,7,15,46.666666666666664,43.47826086956522,1,2,50.0,6,12,18,5,2,0,1,3,21
Pablo Prigioni,4.0,2013 - 2016,PG,303,5115,370,891,41.52637485970819,228,608,37.5,142,283,50.17667844522968,54.32098765432099,80,94,85.1063829787234,155,389,544,846,297,7,278,498,1048
Pace Mannion,6.0,1984 - 1989,SF,224,2166,261,635,41.10236220472441,16,80,20.0,245,555,44.14414414414414,42.362204724409445,140,208,67.3076923076923,91,175,266,235,108,23,139,243,678
Pape Sow,3.0,2005 - 2007,C,76,879,79,190,41.578947368421055,0,0,,79,190,41.578947368421055,41.578947368421055,61,90,67.77777777777779,78,136,214,12,34,24,41,166,219
Pape Sy,1.0,2011 - 2011,SF,7,32,4,9,44.44444444444444,0,1,0.0,4,8,50.0,44.44444444444444,5,7,71.42857142857143,3,1,4,5,2,0,4,2,13
Pascal Siakam,3.0,2017 - 2019,PF,228,5275,900,1691,53.222945002956834,112,357,31.372549019607842,788,1334,59.070464767616194,56.534594914251926,326,441,73.92290249433107,278,859,1137,433,163,145,261,544,2238
Pat Burke,3.0,2003 - 2007,C,139,1350,208,504,41.269841269841265,10,38,26.31578947368421,198,466,42.48927038626609,42.26190476190476,66,99,66.66666666666666,92,189,281,45,29,42,91,192,492
Pat Connaughton,4.0,2016 - 2019,SG,229,3299,389,890,43.70786516853933,166,483,34.368530020703936,223,407,54.791154791154796,53.033707865168545,83,103,80.58252427184466,121,394,515,261,65,50,104,239,1027
Pat Durham,2.0,1993 - 1995,SF,64,930,123,262,46.94656488549619,5,26,19.230769230769234,118,236,50.0,47.900763358778626,72,108,66.66666666666666,42,66,108,57,37,33,52,120,323
Pat Garrity,10.0,1999 - 2008,PF,572,11547,1527,3665,41.66439290586631,655,1646,39.79343863912515,872,2019,43.18969787023279,50.60027285129605,446,552,80.79710144927536,358,1163,1521,460,251,110,430,1336,4155
Patricio Garino,1.0,2017 - 2017,SG,5,43,0,7,0.0,0,5,0.0,0,2,0.0,0.0,0,0,,1,6,7,0,0,0,3,4,0
Patrick Beverley,7.0,2013 - 2019,PG,408,11617,1312,3196,41.05131414267834,652,1726,37.77520278099652,660,1470,44.89795918367347,51.251564455569465,436,563,77.44227353463587,493,1266,1759,1384,480,176,526,1294,3712
Patrick Christopher,1.0,2015 - 2015,SG,4,29,3,12,25.0,0,4,0.0,3,8,37.5,25.0,0,0,,2,4,6,0,1,0,1,6,6
Patrick Eddie,1.0,1992 - 1992,C,4,13,2,9,22.22222222222222,0,0,,2,9,22.22222222222222,22.22222222222222,0,0,,0,1,1,0,0,0,0,3,4
Patrick Ewing,18.0,1986 - 2011,C,1331,45822,10807,21600,50.03240740740741,28,151,18.543046357615893,10779,21449,50.254091099818176,50.09722222222223,5992,8124,73.75677006400788,3090,9954,13044,2492,1258,3198,3883,4557,27634
Patrick McCaw,3.0,2017 - 2019,SG,178,2629,246,583,42.19554030874786,77,255,30.19607843137255,169,328,51.52439024390244,48.79931389365352,81,101,80.19801980198021,55,211,266,203,109,30,97,182,650
Patrick O'Bryant,4.0,2007 - 2010,C,90,524,79,160,49.375,0,3,0.0,79,157,50.318471337579616,49.375,28,48,58.333333333333336,32,95,127,25,18,40,42,126,186
Patrick Patterson,9.0,2011 - 2019,PF,669,14696,1813,4040,44.87623762376238,568,1558,36.45699614890886,1245,2482,50.16116035455278,51.90594059405941,408,537,75.97765363128491,815,1927,2742,727,368,299,454,1078,4602
Patty Mills,10.0,2010 - 2019,PG,688,12787,2055,4763,43.145076632374554,1017,2597,39.16056988833269,1038,2166,47.92243767313019,53.82112114213731,537,634,84.70031545741324,205,924,1129,1558,430,50,668,880,5664
Pau Gasol,18.0,2002 - 2019,C,1362,45826,8792,17329,50.73576086329275,190,523,36.32887189292543,8602,16806,51.1841009163394,51.28397483986381,5218,6936,75.23068050749711,3458,9093,12551,4363,677,2174,2888,2988,22992
Paul Davis,4.0,2007 - 2010,PF,82,702,88,219,40.182648401826484,0,1,0.0,88,218,40.36697247706422,40.182648401826484,41,56,73.21428571428571,74,84,158,32,22,15,30,105,217
Paul George,9.0,2011 - 2019,SF,675,23187,4501,10423,43.183344526527875,1588,4215,37.67497034400949,2913,6208,46.92332474226804,50.80111292334261,2775,3307,83.91291200483822,630,3769,4399,2275,1191,308,1770,1862,13365
Paul Graham,3.0,1992 - 1994,SG,182,3383,585,1309,44.690603514132924,100,298,33.557046979865774,485,1011,47.97230464886251,48.51031321619557,235,318,73.89937106918238,138,298,436,354,190,32,218,391,1505
Paul Grant,2.0,1999 - 2004,C,16,111,13,29,44.827586206896555,0,0,,13,29,44.827586206896555,44.827586206896555,3,8,37.5,8,10,18,3,2,1,9,21,29
Paul McPherson,1.0,2001 - 2001,PG,55,595,109,216,50.46296296296296,2,12,16.666666666666664,107,204,52.450980392156865,50.92592592592593,42,58,72.41379310344827,40,39,79,38,25,4,47,80,262
Paul Millsap,13.0,2007 - 2019,PF,1032,30228,5432,11119,48.85331414695566,465,1419,32.76955602536998,4967,9700,51.20618556701031,50.94432952603651,3155,4310,73.20185614849188,2354,5309,7663,2340,1314,1074,1842,3185,14484
Paul Pierce,19.0,1999 - 2017,SF,1513,52109,9690,21880,44.28702010968921,2419,6593,36.690429243136656,7271,15287,47.563289069143714,49.81489945155393,7778,9614,80.9028500104015,1217,7295,8512,5287,1956,850,4008,4190,29577
Paul Pressey,11.0,1983 - 1993,SG,799,21928,3176,6572,48.3262325015216,90,401,22.443890274314214,3086,6171,50.00810241451953,49.01095556908095,2103,2816,74.68039772727273,1014,2100,3114,4135,1113,477,1907,2293,8545
Paul Shirley,3.0,2003 - 2005,PF,18,121,15,38,39.473684210526315,0,1,0.0,15,37,40.54054054054054,39.473684210526315,3,7,42.857142857142854,9,10,19,7,1,1,10,12,33
Paul Thompson,3.0,1984 - 1986,SF,157,3139,573,1327,43.18010550113037,17,83,20.481927710843372,556,1244,44.69453376205787,43.82064807837227,224,284,78.87323943661971,205,333,538,226,145,80,164,363,1387
Paul Zipser,2.0,2017 - 2018,SF,104,1803,184,488,37.704918032786885,76,225,33.77777777777778,108,263,41.06463878326996,45.49180327868852,58,73,79.45205479452055,31,246,277,85,36,32,90,176,502
Pavel Podkolzin,2.0,2005 - 2006,C,6,28,0,2,0.0,0,0,,0,2,0.0,0.0,4,8,50.0,0,9,9,0,0,1,4,4,4
Pearl Washington,3.0,1987 - 1989,PG,194,4044,666,1472,45.244565217391305,16,87,18.39080459770115,650,1385,46.931407942238266,45.78804347826087,312,418,74.64114832535886,140,230,370,733,256,15,438,448,1660
Peja Stojakovic,13.0,1999 - 2011,SF,899,30072,5297,11849,44.70419444678876,1922,4823,39.850715322413436,3375,7026,48.03586678052946,52.81458350915689,2498,2790,89.53405017921146,845,3400,4245,1500,823,123,1190,1587,15014
Pepe Sanchez,2.0,2001 - 2003,PG,38,187,9,33,27.27272727272727,0,1,0.0,9,32,28.125,27.27272727272727,2,2,100.0,7,14,21,49,16,1,8,24,20
Pero Antic,2.0,2014 - 2015,C,135,2331,254,682,37.24340175953079,122,401,30.423940149625935,132,281,46.97508896797153,46.18768328445748,163,222,73.42342342342343,134,334,468,116,44,32,117,322,793
Perry Jones,3.0,2013 - 2015,SF,155,1735,202,483,41.821946169772254,39,133,29.32330827067669,163,350,46.57142857142857,45.8592132505176,62,94,65.95744680851064,49,213,262,55,36,34,61,144,505
Perry Moss,2.0,1986 - 1987,PG,151,1783,217,521,41.65067178502879,9,48,18.75,208,473,43.97463002114165,42.51439539347409,123,168,73.21428571428571,65,153,218,205,104,19,143,239,566
Perry Young,1.0,1987 - 1987,SG,9,72,6,21,28.57142857142857,0,0,,6,21,28.57142857142857,28.57142857142857,1,2,50.0,3,5,8,7,5,1,4,14,13
Pervis Ellison,11.0,1990 - 2001,C,478,11661,1837,3598,51.056142301278484,1,20,5.0,1836,3578,51.31358300726663,51.07003891050583,843,1223,68.92886345053148,1098,2089,3187,693,295,757,802,1510,4518
Pete Chilcutt,9.0,1992 - 2000,PF,605,8727,1076,2436,44.17077175697865,202,531,38.04143126177024,874,1905,45.879265091863516,48.31691297208538,232,332,69.87951807228916,680,1316,1996,506,274,214,402,892,2586
Pete Myers,9.0,1987 - 1998,SG,401,6368,694,1639,42.34289200732154,33,152,21.710526315789476,661,1487,44.45191661062542,43.34960341671751,470,710,66.19718309859155,237,466,703,844,275,82,486,714,1891
Pete Verhoeven,6.0,1982 - 1987,PF,285,3239,432,856,50.467289719626166,1,4,25.0,431,852,50.5868544600939,50.52570093457944,137,198,69.1919191919192,272,369,641,152,129,67,167,632,1002
Pete Williams,2.0,1986 - 1987,PF,62,601,70,117,59.82905982905983,0,1,0.0,70,116,60.3448275862069,59.82905982905983,17,40,42.5,48,103,151,18,19,23,20,71,157
Peter Aluma,1.0,1999 - 1999,C,2,5,1,2,50.0,0,0,,1,2,50.0,50.0,0,0,,1,1,2,0,1,1,2,4,2
Peter John Ramos,1.0,2005 - 2005,C,6,20,5,10,50.0,0,0,,5,10,50.0,50.0,1,2,50.0,1,3,4,0,0,1,3,4,11
Peter Thibeaux,2.0,1985 - 1986,SF,93,992,194,428,45.32710280373832,2,7,28.57142857142857,192,421,45.605700712589076,45.5607476635514,72,115,62.60869565217392,57,87,144,45,34,32,73,167,462
Petur Gudmundsson,4.0,1982 - 1989,C,164,2177,267,537,49.72067039106145,1,4,25.0,266,533,49.906191369606,49.81378026070764,200,267,74.90636704119851,174,415,589,157,38,100,208,423,735
Peyton Siva,1.0,2014 - 2014,SG,24,224,18,57,31.57894736842105,7,25,28.000000000000004,11,32,34.375,37.719298245614034,11,15,73.33333333333333,2,12,14,34,9,1,18,27,54
Phil Pressey,3.0,2014 - 2016,PG,150,2020,172,508,33.85826771653544,48,190,25.263157894736842,124,318,38.9937106918239,38.582677165354326,75,119,63.02521008403361,37,180,217,433,116,16,161,180,467
Phil Zevenbergen,1.0,1988 - 1988,C,9,59,15,27,55.55555555555556,0,0,,15,27,55.55555555555556,55.55555555555556,0,2,0.0,4,9,13,3,3,1,4,12,30
Pierre Jackson,1.0,2017 - 2017,PG,8,84,13,39,33.33333333333333,3,11,27.27272727272727,10,28,35.714285714285715,37.17948717948718,6,7,85.71428571428571,1,8,9,19,2,0,3,5,35
Pooh Richardson,10.0,1990 - 1999,PG,645,19512,3054,6886,44.35085681092071,359,1089,32.966023875114786,2695,5797,46.48956356736243,46.95759512053442,637,978,65.13292433537833,436,1382,1818,4206,820,111,1172,1140,7104
Popeye Jones,11.0,1994 - 2004,PF,535,12579,1574,3523,44.677831393698554,25,89,28.08988764044944,1549,3434,45.107746068724516,45.032642634118645,553,736,75.13586956521739,1623,2358,3981,696,300,161,603,1501,3726
Pops Mensah-Bonsu,4.0,2007 - 2011,PF,61,509,64,156,41.02564102564102,0,2,0.0,64,154,41.55844155844156,41.02564102564102,53,90,58.88888888888889,83,97,180,11,14,14,40,82,181
Predrag Drobnjak,4.0,2002 - 2005,C,281,5580,907,2137,42.44267664950866,66,194,34.02061855670103,841,1943,43.28358208955223,43.98689751988769,317,398,79.64824120603015,316,665,981,227,133,117,243,514,2197
Predrag Savovic,1.0,2003 - 2003,SG,27,256,29,93,31.182795698924732,4,26,15.384615384615385,25,67,37.3134328358209,33.33333333333333,21,29,72.41379310344827,9,16,25,22,14,1,21,33,83
Priest Lauderdale,2.0,1997 - 1998,C,77,532,102,219,46.57534246575342,0,1,0.0,102,218,46.788990825688074,46.57534246575342,51,92,55.434782608695656,44,101,145,33,8,26,86,103,255
Primoz Brezec,8.0,2002 - 2010,C,346,6217,1016,2041,49.77951984321411,1,6,16.666666666666664,1015,2035,49.877149877149876,49.804017638412546,428,611,70.04909983633388,564,766,1330,179,70,134,274,735,2461
Quentin Richardson,13.0,2001 - 2013,SF,819,21684,3018,7595,39.736668861092824,1217,3414,35.6473345049795,1801,4181,43.07581918201387,47.74851876234364,1048,1463,71.63362952836637,962,2840,3802,1175,636,153,896,1615,8301
Quincy Acy,7.0,2013 - 2019,PF,337,5392,583,1314,44.36834094368341,183,523,34.990439770554495,400,791,50.56890012642224,51.331811263318116,293,386,75.90673575129534,309,870,1179,217,140,135,219,665,1642
Quincy Douby,3.0,2007 - 2009,PG,143,1535,222,571,38.879159369527144,68,218,31.19266055045872,154,353,43.626062322946176,44.833625218914186,76,86,88.37209302325581,34,118,152,93,50,21,87,128,588
Quincy Lewis,4.0,2000 - 2004,SG,171,2015,250,634,39.43217665615142,40,122,32.78688524590164,210,512,41.015625,42.586750788643535,70,102,68.62745098039215,74,154,228,100,64,44,104,369,610
Quincy Miller,3.0,2013 - 2015,PF,69,934,107,306,34.967320261437905,33,113,29.20353982300885,74,193,38.34196891191709,40.35947712418301,48,68,70.58823529411765,41,128,169,37,30,37,54,82,295
Quincy Pondexter,7.0,2011 - 2019,SF,384,6134,640,1497,42.75217100868404,240,663,36.199095022624434,400,834,47.961630695443645,50.76820307281229,286,387,73.90180878552972,215,500,715,289,144,51,193,522,1806
Quinn Cook,3.0,2017 - 2019,PG,138,2162,389,824,47.20873786407767,145,361,40.16620498614959,244,463,52.69978401727862,56.00728155339806,58,73,79.45205479452055,35,234,269,242,40,6,100,177,981
Quintin Dailey,10.0,1983 - 1992,SG,532,12299,2962,6522,45.415516712664825,22,140,15.714285714285714,2940,6382,46.06706361642118,45.58417663293468,1585,2036,77.84872298624754,426,894,1320,1199,504,51,1030,1240,7531
Quinton Ross,7.0,2005 - 2011,SG,470,8752,803,1897,42.32999472851871,49,154,31.818181818181817,754,1743,43.25874928284567,43.62150764364787,300,418,71.77033492822966,275,704,979,440,270,137,226,890,1955
Qyntel Woods,4.0,2003 - 2006,SF,171,2078,284,630,45.07936507936508,35,99,35.35353535353536,249,531,46.89265536723164,47.85714285714286,95,158,60.12658227848101,108,279,387,105,71,28,139,229,698
R.J. Hunter,4.0,2016 - 2019,SG,50,436,51,141,36.17021276595745,27,93,29.03225806451613,24,48,50.0,45.744680851063826,9,11,81.81818181818183,4,48,52,22,18,5,14,42,138
Radisav Curcic,1.0,1993 - 1993,C,20,166,16,41,39.02439024390244,0,0,,16,41,39.02439024390244,39.02439024390244,26,36,72.22222222222221,17,32,49,12,7,2,8,30,58
Raef LaFrentz,10.0,1999 - 2008,C,598,15466,2350,5057,46.47023927229583,500,1389,35.99712023038157,1850,3668,50.4362050163577,51.41388174807198,788,1106,71.24773960216999,1054,2552,3606,624,295,996,538,2015,5988
Rafael Addison,6.0,1987 - 1997,SF,385,5759,929,2075,44.7710843373494,70,247,28.34008097165992,859,1828,46.991247264770244,46.4578313253012,280,362,77.34806629834254,265,521,786,345,151,83,287,674,2208
Rafael Araujo,3.0,2005 - 2007,C,144,1613,159,393,40.458015267175576,1,4,25.0,158,389,40.616966580976865,40.5852417302799,81,124,65.32258064516128,127,279,406,42,52,16,111,308,400
Rafer Alston,11.0,2000 - 2010,PG,727,20886,2631,6887,38.20241033831857,1071,3056,35.04581151832461,1560,3831,40.72043852779953,45.977929432263686,971,1327,73.172569706104,262,1768,2030,3373,868,113,1271,1513,7304
Raja Bell,12.0,2001 - 2012,SG,774,21576,2774,6341,43.74704305314619,1037,2531,40.97194784670091,1737,3810,45.59055118110236,51.92398675287809,958,1206,79.43615257048093,446,1696,2142,1310,527,137,736,2030,7543
Rajon Rondo,13.0,2007 - 2019,PG,930,30063,4187,9155,45.734571272528676,378,1210,31.239669421487605,3809,7945,47.94210195091252,47.79901693063899,1286,2101,61.20894811994289,1026,3604,4630,7956,1612,132,2649,2096,10038
Rakeem Christmas,2.0,2016 - 2017,PF,30,225,21,45,46.666666666666664,0,0,,21,45,46.666666666666664,46.666666666666664,21,29,72.41379310344827,27,30,57,4,3,6,8,38,63
Ralph Drollinger,1.0,1981 - 1981,C,6,67,7,14,50.0,0,0,,7,14,50.0,50.0,1,4,25.0,5,14,19,14,1,2,13,16,15
Ralph Jackson,1.0,1985 - 1985,PG,1,12,1,3,33.33333333333333,0,0,,1,3,33.33333333333333,33.33333333333333,0,0,,1,0,1,4,2,0,1,1,2
Ralph Lewis,3.0,1988 - 1990,SG,109,689,91,221,41.17647058823529,1,5,20.0,90,216,41.66666666666667,41.40271493212669,50,89,56.17977528089888,59,67,126,30,25,7,45,69,233
Ralph Sampson,9.0,1984 - 1992,C,494,14898,3207,6581,48.73119586688953,13,66,19.696969696969695,3194,6515,49.025326170376054,48.829965050904114,1323,1988,66.54929577464789,1298,3113,4411,1147,425,809,1486,1747,7750
Ramon Rivas,1.0,1989 - 1989,C,28,91,12,31,38.70967741935484,0,1,0.0,12,30,40.0,38.70967741935484,16,25,64.0,9,15,24,3,4,1,9,21,40
Ramon Sessions,11.0,2008 - 2018,PG,713,16717,2475,5723,43.246549012755544,222,708,31.35593220338983,2253,5015,44.925224327018945,45.18609121090337,2160,2735,78.97623400365632,344,1556,1900,2873,480,54,1205,983,7332
Randell Jackson,2.0,1999 - 2000,PF,28,272,46,108,42.592592592592595,1,7,14.285714285714285,45,101,44.554455445544555,43.05555555555556,21,32,65.625,30,24,54,8,3,11,26,29,114
Randolph Childress,2.0,1996 - 1997,PG,51,405,39,119,32.773109243697476,18,66,27.27272727272727,21,53,39.62264150943396,40.33613445378151,28,35,80.0,2,23,25,49,17,1,46,38,124
Randolph Keys,5.0,1989 - 1996,SF,242,3330,522,1232,42.37012987012987,40,148,27.027027027027028,482,1084,44.464944649446494,43.993506493506494,178,247,72.06477732793523,210,344,554,193,135,45,177,524,1262
Randolph Morris,4.0,2007 - 2010,C,80,456,53,125,42.4,0,0,,53,125,42.4,42.4,37,67,55.223880597014926,29,79,108,7,14,7,31,105,143
Randy Allen,2.0,1989 - 1990,SG,70,789,114,258,44.18604651162791,0,8,0.0,114,250,45.6,44.18604651162791,24,45,53.333333333333336,52,93,145,23,17,20,30,109,252
Randy Breuer,11.0,1984 - 1994,C,741,13369,2013,4283,46.99976651879524,0,4,0.0,2013,4279,47.04370179948586,46.99976651879524,860,1373,62.63656227239621,1117,2055,3172,642,328,794,706,1593,4886
Randy Brown,12.0,1992 - 2003,PG,702,11814,1302,3125,41.664,27,126,21.428571428571427,1275,2999,42.51417139046349,42.096000000000004,591,854,69.20374707259953,335,867,1202,1442,737,159,743,1309,3222
Randy Foye,11.0,2007 - 2017,SG,779,19760,2747,6865,40.01456664238893,1126,3075,36.61788617886179,1621,3790,42.770448548812666,48.215586307356155,1232,1446,85.20055325034578,251,1477,1728,2142,536,226,1129,1621,7852
Randy Holcomb,1.0,2006 - 2006,SF,4,11,1,1,100.0,0,0,,1,1,100.0,100.0,0,0,,1,0,1,0,0,0,0,2,2
Randy Livingston,11.0,1997 - 2007,PG,220,2866,324,812,39.90147783251231,38,108,35.18518518518518,286,704,40.625,42.241379310344826,140,179,78.2122905027933,82,220,302,435,129,32,231,317,826
Randy White,5.0,1990 - 1994,PF,282,5384,783,1951,40.13326499231164,27,140,19.28571428571429,756,1811,41.744892324682496,40.82521783700666,490,693,70.70707070707071,531,835,1366,175,209,127,372,861,2083
Randy Wittman,9.0,1984 - 1992,SG,581,12699,2048,4053,50.53047125585985,17,55,30.909090909090907,2031,3998,50.80040020010005,50.740192450037014,408,543,75.13812154696133,208,630,838,1316,279,71,483,627,4521
Randy Woods,4.0,1993 - 1996,PG,151,1093,115,338,34.023668639053255,57,187,30.481283422459892,58,151,38.41059602649007,42.455621301775146,69,101,68.31683168316832,32,61,93,257,85,4,110,166,356
Rashad McCants,4.0,2006 - 2009,SG,249,5037,923,2144,43.05037313432835,292,793,36.82219419924338,631,1351,46.706143597335306,49.86007462686567,341,460,74.1304347826087,114,392,506,331,183,61,362,584,2479
Rashad Vaughn,3.0,2016 - 2018,SG,142,1681,163,482,33.81742738589212,85,267,31.835205992509362,78,215,36.27906976744186,42.634854771784234,18,26,69.23076923076923,18,140,158,75,53,29,48,120,429
Rashard Lewis,16.0,1999 - 2014,SF,1142,36370,6061,13435,45.1135094901377,1925,5013,38.4001595850788,4136,8422,49.1094751840418,52.27763304800893,2724,3380,80.59171597633136,1518,4348,5866,1928,1184,583,1714,2616,16771
Rasheed Wallace,16.0,1996 - 2013,PF,1286,42081,7237,15594,46.40887520841349,1276,3768,33.86411889596603,5961,11826,50.405885337392185,50.50019238168526,2640,3664,72.0524017467249,1814,6689,8503,2258,1235,1685,1921,3904,18390
Rasho Nesterovic,12.0,1999 - 2010,C,875,19085,2687,5371,50.027927760193634,2,15,13.333333333333334,2685,5356,50.130694548170275,50.04654626698939,396,682,58.06451612903226,1594,2778,4372,874,343,973,788,2347,5772
Rastko Cvetkovic,1.0,1996 - 1996,C,14,48,5,16,31.25,0,1,0.0,5,15,33.33333333333333,31.25,0,4,0.0,4,7,11,3,2,1,3,11,10
Rasual Butler,13.0,2003 - 2016,SF,852,17701,2348,5821,40.33671190517094,941,2592,36.30401234567901,1407,3229,43.57386187674203,48.41951554715684,607,810,74.93827160493827,301,1685,1986,670,292,414,538,1184,6244
Ratko Varda,1.0,2002 - 2002,C,1,6,2,3,66.66666666666666,0,0,,2,3,66.66666666666666,66.66666666666666,1,1,100.0,0,1,1,0,0,0,1,3,5
Raul Lopez,2.0,2004 - 2005,PG,113,2135,280,652,42.944785276073624,45,130,34.61538461538461,235,522,45.01915708812261,46.395705521472394,128,150,85.33333333333334,31,163,194,428,84,5,221,278,733
Raul Neto,4.0,2016 - 2019,PG,216,2949,379,857,44.224037339556595,118,313,37.69968051118211,261,544,47.97794117647059,51.10851808634772,123,156,78.84615384615384,36,242,278,390,113,16,202,272,999
Rawle Alkins,1.0,2019 - 2019,SG,10,120,13,39,33.33333333333333,3,12,25.0,10,27,37.03703703703704,37.17948717948718,8,12,66.66666666666666,11,15,26,13,1,0,8,7,37
Rawle Marshall,2.0,2006 - 2007,SG,63,602,56,149,37.58389261744966,5,21,23.809523809523807,51,128,39.84375,39.261744966442954,53,74,71.62162162162163,16,44,60,23,20,12,34,39,170
Ray Allen,18.0,1997 - 2014,SG,1471,52408,9495,21050,45.10688836104514,3358,8388,40.03338102050548,6137,12662,48.467856578739536,53.08313539192399,4906,5495,89.28116469517742,1368,4552,5920,4810,1615,285,2983,3260,27254
Ray Blume,1.0,1982 - 1982,SG,49,546,102,222,45.94594594594595,4,18,22.22222222222222,98,204,48.03921568627451,46.846846846846844,18,28,64.28571428571429,14,27,41,68,23,2,54,57,226
Ray McCallum,3.0,2014 - 2016,PG,154,2808,374,916,40.8296943231441,71,212,33.490566037735846,303,704,43.03977272727273,44.70524017467249,101,142,71.12676056338029,78,228,306,368,79,27,148,190,920
Ray Owes,1.0,1997 - 1997,PF,57,592,75,180,41.66666666666667,1,5,20.0,74,175,42.285714285714285,41.94444444444444,26,46,56.52173913043478,64,99,163,15,15,20,23,86,177
Ray Spalding,1.0,2019 - 2019,PF,14,148,25,47,53.191489361702125,0,3,0.0,25,44,56.81818181818182,53.191489361702125,4,12,33.33333333333333,15,33,48,5,9,8,9,23,54
Ray Tolbert,5.0,1982 - 1989,PF,266,2822,399,805,49.56521739130435,0,6,0.0,399,799,49.93742177722152,49.56521739130435,140,258,54.263565891472865,222,392,614,136,75,101,210,425,938
Raymond Brown,1.0,1990 - 1990,PF,19,62,8,28,28.57142857142857,0,0,,8,28,28.57142857142857,28.57142857142857,0,2,0.0,10,5,15,4,0,0,6,13,16
Raymond Felton,14.0,2006 - 2019,PG,1013,29979,4275,10360,41.26447876447876,957,2911,32.87530058399176,3318,7449,44.54289166331051,45.883204633204635,1776,2256,78.72340425531915,579,2401,2980,5239,1188,214,2064,1946,11283
Reece Gaines,3.0,2004 - 2006,PG,71,605,48,148,32.432432432432435,7,26,26.923076923076923,41,122,33.60655737704918,34.7972972972973,20,33,60.60606060606061,9,44,53,50,17,3,26,40,123
Reggie Bullock,6.0,2014 - 2019,SF,276,5267,682,1564,43.60613810741688,362,922,39.26247288503254,320,642,49.84423676012461,55.17902813299232,144,174,82.75862068965517,88,477,565,304,135,35,151,277,1870
Reggie Carter,2.0,1981 - 1982,SG,136,1466,178,460,38.69565217391304,0,3,0.0,178,457,38.949671772428886,38.69565217391304,115,149,77.18120805369128,66,100,166,206,58,8,117,196,471
Reggie Evans,13.0,2003 - 2015,PF,854,16440,1159,2496,46.434294871794876,1,13,7.6923076923076925,1158,2483,46.637132501006846,46.45432692307692,1143,2161,52.89217954650625,2073,4019,6092,473,597,127,944,2014,3462
Reggie Geary,2.0,1997 - 1998,PG,108,977,81,234,34.61538461538461,21,65,32.30769230769231,60,169,35.50295857988166,39.1025641025641,35,71,49.29577464788733,23,61,84,116,51,14,59,141,218
Reggie Hanson,1.0,1998 - 1998,SF,8,26,3,6,50.0,0,0,,3,6,50.0,50.0,0,0,,3,3,6,1,2,1,3,8,6
Reggie Hearn,1.0,2018 - 2018,SG,3,7,1,2,50.0,1,2,50.0,0,0,,75.0,0,0,,0,0,0,0,0,0,0,0,3
Reggie Jackson,8.0,2012 - 2019,PG,564,14423,2703,6276,43.06883365200765,639,1924,33.21205821205821,2064,4352,47.42647058823529,48.15965583173996,1210,1406,86.0597439544808,306,1400,1706,2453,393,73,1096,1128,7255
Reggie Johnson,4.0,1981 - 1984,PF,324,6252,1102,2190,50.31963470319635,1,7,14.285714285714285,1101,2183,50.435180943655524,50.34246575342466,459,638,71.9435736677116,448,829,1277,281,133,175,410,947,2664
Reggie Jordan,6.0,1994 - 2000,SG,198,1750,194,441,43.99092970521542,3,7,42.857142857142854,191,434,44.00921658986175,44.33106575963719,138,238,57.98319327731093,184,174,358,202,98,32,107,213,529
Reggie Lewis,6.0,1988 - 1993,SG,492,15954,3491,7125,48.99649122807018,29,150,19.333333333333332,3462,6975,49.634408602150536,49.2,1625,1982,81.98789101917255,631,1482,2113,1262,620,436,765,1378,8636
Reggie Miller,18.0,1988 - 2005,SG,1533,52927,9182,19594,46.861284066550986,2880,7306,39.41965507801807,6302,12288,51.285807291666664,54.21047259365112,7007,7888,88.83113590263692,960,3638,4598,4498,1651,333,2666,3005,28251
Reggie Slater,8.0,1995 - 2003,PF,263,3565,508,1053,48.243114909781575,0,2,0.0,508,1051,48.3349191246432,48.243114909781575,447,711,62.869198312236286,341,441,782,145,93,59,247,518,1463
Reggie Smith,2.0,1993 - 1994,PF,66,384,39,99,39.39393939393939,0,1,0.0,39,98,39.795918367346935,39.39393939393939,21,52,40.38461538461539,55,65,120,5,16,7,16,63,99
Reggie Williams,17.0,1988 - 2017,SF,829,20287,3670,8373,43.83136271348382,596,1863,31.991411701556626,3074,6510,47.21966205837174,47.39042159321629,1387,1779,77.96514896008993,918,2056,2974,1850,904,433,1229,2233,9323
Renaldo Balkman,6.0,2007 - 2012,SF,229,3084,370,727,50.894085281980736,11,65,16.923076923076923,359,662,54.229607250755286,51.65061898211829,147,271,54.24354243542435,280,493,773,133,168,104,134,424,898
Renaldo Major,1.0,2007 - 2007,PF,1,27,2,10,20.0,0,0,,2,10,20.0,20.0,1,2,50.0,0,2,2,0,2,0,1,4,5
Rex Chapman,12.0,1989 - 2000,SG,679,19936,3781,8793,43.00011372682816,832,2373,35.06110408765276,2949,6420,45.93457943925234,47.731149778232684,1520,1904,79.83193277310924,383,1290,1673,1826,600,129,1052,1258,9914
Rex Walters,7.0,1994 - 2000,SG,339,4616,573,1300,44.07692307692307,187,520,35.96153846153846,386,780,49.48717948717949,51.26923076923077,216,267,80.89887640449437,81,322,403,573,129,30,291,439,1549
Rich King,4.0,1992 - 1995,C,72,309,44,112,39.285714285714285,0,2,0.0,44,110,40.0,39.285714285714285,47,71,66.19718309859155,30,44,74,21,5,7,28,62,135
Rich Manning,2.0,1996 - 1997,PF,58,533,83,204,40.68627450980392,2,5,40.0,81,199,40.7035175879397,41.17647058823529,23,34,67.64705882352942,35,63,98,11,7,9,24,71,191
Rich Yonakor,1.0,1982 - 1982,PF,12,74,15,28,53.57142857142857,0,0,,15,28,53.57142857142857,53.57142857142857,5,7,71.42857142857143,13,15,28,4,2,2,2,8,35
Richard Anderson,6.0,1983 - 1990,PF,422,6142,929,2254,41.21561668145519,156,466,33.47639484978541,773,1788,43.23266219239373,44.67613132209405,304,398,76.38190954773869,464,980,1444,621,227,97,366,711,2318
Richard Coffey,1.0,1991 - 1991,SF,52,320,28,75,37.333333333333336,0,1,0.0,28,74,37.83783783783784,37.333333333333336,12,22,54.54545454545454,42,37,79,3,6,4,5,45,68
Richard Dumas,3.0,1993 - 1996,SF,128,2730,542,1060,51.132075471698116,3,15,20.0,539,1045,51.578947368421055,51.27358490566037,246,350,70.28571428571428,197,220,417,135,158,60,178,280,1333
Richard Hamilton,14.0,2000 - 2013,SG,1051,34598,6912,15436,44.77844001036538,601,1739,34.56009200690052,6311,13697,46.07578301817916,46.72518787250583,3854,4519,85.28435494578447,951,2407,3358,3592,836,155,2325,2730,18279
Richard Jefferson,17.0,2002 - 2018,SF,1321,38131,5685,12234,46.46885728298185,1106,2966,37.28927848954821,4579,9268,49.40656020716443,50.989046918424066,3939,5155,76.41125121241514,1033,4295,5328,2653,874,391,1993,2960,16415
Richard Morton,1.0,1989 - 1989,PG,2,11,3,4,75.0,0,0,,3,4,75.0,75.0,0,0,,0,0,0,1,0,0,1,2,6
Richard Petruska,1.0,1994 - 1994,C,22,92,20,46,43.47826086956522,7,15,46.666666666666664,13,31,41.935483870967744,51.08695652173913,6,8,75.0,9,22,31,1,2,3,15,15,53
Richard Rellford,1.0,1988 - 1988,SF,4,42,5,8,62.5,0,0,,5,8,62.5,62.5,6,8,75.0,2,5,7,1,0,3,4,3,16
Richaun Holmes,4.0,2016 - 2019,C,229,3836,701,1241,56.4867042707494,39,152,25.657894736842106,662,1089,60.78971533516988,58.058017727639,288,408,70.58823529411765,328,661,989,213,123,203,164,522,1729
Richie Frahm,4.0,2004 - 2008,SG,140,1473,178,433,41.10854503464203,95,267,35.580524344569284,83,166,50.0,52.078521939953816,51,63,80.95238095238095,36,128,164,83,37,10,35,122,502
Rick Brunson,9.0,1998 - 2006,PG,353,4561,399,1057,37.74834437086093,100,276,36.231884057971016,299,781,38.2842509603073,42.47871333964049,201,289,69.55017301038062,86,362,448,879,202,21,361,367,1099
Rick Calloway,1.0,1991 - 1991,SG,64,678,75,192,39.0625,0,2,0.0,75,190,39.473684210526315,39.0625,55,79,69.62025316455697,25,53,78,61,22,7,51,98,205
Rick Carlisle,5.0,1985 - 1990,SG,200,1523,187,441,42.40362811791383,11,50,22.0,176,391,45.012787723785166,43.65079365079365,58,75,77.33333333333333,48,100,148,209,45,9,123,197,443
Rick Fox,13.0,1992 - 2004,SF,1041,26250,3649,8120,44.9384236453202,857,2447,35.02247650183898,2792,5673,49.21558258417063,50.21551724137932,1540,1994,77.23169508525577,1090,2780,3870,2895,1051,382,1762,3059,9695
Rick Hughes,1.0,2000 - 2000,PF,21,224,35,72,48.61111111111111,0,1,0.0,35,71,49.29577464788733,48.61111111111111,12,26,46.15384615384615,24,25,49,9,3,1,14,30,82
Rick Mahorn,18.0,1981 - 1999,PF,1223,28208,3347,6814,49.11945993542706,5,41,12.195121951219512,3342,6773,49.342979477336485,49.15614910478427,1676,2370,70.71729957805907,1964,5572,7536,1154,675,1070,1549,3847,8375
Rickey Brown,5.0,1981 - 1985,C,347,4585,625,1346,46.43387815750371,0,3,0.0,625,1343,46.53760238272524,46.43387815750371,265,395,67.08860759493672,427,795,1222,121,95,115,306,818,1515
Rickey Green,12.0,1981 - 1992,PG,898,23017,3576,7539,47.433346597692,46,208,22.115384615384613,3530,7331,48.15168462692675,47.738426847061945,1638,1989,82.35294117647058,434,1334,1768,5303,1315,53,1543,1391,8836
Rickey Williams,1.0,1983 - 1983,SG,44,346,56,135,41.48148148148148,0,3,0.0,56,132,42.42424242424242,41.48148148148148,35,53,66.0377358490566,15,23,38,37,20,4,38,42,147
Rickie Winslow,1.0,1988 - 1988,SF,7,45,3,13,23.076923076923077,0,1,0.0,3,12,25.0,23.076923076923077,1,2,50.0,3,4,7,2,1,0,4,9,7
Ricky Berry,1.0,1989 - 1989,SG,64,1406,255,567,44.97354497354497,65,160,40.625,190,407,46.68304668304668,50.70546737213404,131,166,78.91566265060241,57,140,197,80,37,22,82,197,706
Ricky Blanton,1.0,1993 - 1993,SF,2,13,3,7,42.857142857142854,0,0,,3,7,42.857142857142854,42.857142857142854,0,0,,2,1,3,1,2,0,1,1,6
Ricky Davis,12.0,1999 - 2010,SG,747,22290,3795,8524,44.52135147817926,590,1633,36.1298224127373,3205,6891,46.50994050210419,47.98216799624589,1866,2391,78.04265997490589,574,2013,2587,2454,743,189,1639,1460,10046
Ricky Grace,1.0,1994 - 1994,PG,3,8,2,3,66.66666666666666,0,0,,2,3,66.66666666666666,66.66666666666666,0,2,0.0,0,1,1,1,0,0,0,3,4
Ricky Ledo,2.0,2014 - 2015,SG,28,277,38,113,33.6283185840708,13,35,37.142857142857146,25,78,32.05128205128205,39.38053097345133,20,26,76.92307692307693,16,22,38,21,7,1,28,23,109
Ricky Pierce,16.0,1983 - 1998,SG,1066,26321,5923,12067,49.08427943979448,329,1013,32.477788746298124,5594,11054,50.606115433327304,50.447501450236174,3739,4275,87.46198830409357,961,1564,2525,2013,838,167,1607,2479,15914
Ricky Rubio,8.0,2012 - 2019,PG,504,15551,1806,4664,38.7221269296741,423,1315,32.167300380228134,1383,3349,41.29590922663481,43.25686106346483,1574,1879,83.7679616817456,335,1801,2136,3859,967,69,1381,1319,5609
Ricky Wilson,1.0,1988 - 1988,PG,26,429,43,112,38.392857142857146,10,26,38.46153846153847,33,86,38.372093023255815,42.857142857142854,29,40,72.5,2,25,27,70,23,3,26,42,125
Rik Smits,12.0,1989 - 2000,C,971,25847,5924,11691,50.67145667607561,4,30,13.333333333333334,5920,11661,50.7675156504588,50.68856385253614,2556,3282,77.87934186471664,1680,4137,5817,1350,423,1201,1764,3430,14408
Rob Kurz,1.0,2009 - 2009,SF,40,442,51,131,38.93129770992366,15,38,39.473684210526315,36,93,38.70967741935484,44.656488549618324,40,50,80.0,33,48,81,20,14,19,16,78,157
Rob Lock,1.0,1989 - 1989,PF,20,110,9,32,28.125,0,0,,9,32,28.125,28.125,12,15,80.0,14,18,32,4,3,4,13,15,30
Rob Rose,1.0,1989 - 1989,SG,2,3,0,1,0.0,0,0,,0,1,0.0,0.0,0,0,,1,1,2,0,0,0,0,0,0
Rob Williams,2.0,1983 - 1984,PG,165,3650,545,1240,43.95161290322581,24,78,30.76923076923077,521,1162,44.836488812392425,44.91935483870968,319,402,79.35323383084577,98,264,362,886,184,19,381,535,1433
Robbie Hummel,2.0,2014 - 2015,SF,98,1397,146,349,41.833810888252145,48,140,34.285714285714285,98,209,46.889952153110045,48.71060171919771,39,45,86.66666666666667,66,200,266,50,32,11,28,143,379
Robert Archibald,2.0,2003 - 2004,C-PF,44,328,15,53,28.30188679245283,0,0,,15,53,28.30188679245283,28.30188679245283,21,49,42.857142857142854,27,42,69,16,14,6,17,59,51
Robert Churchwell,1.0,1996 - 1996,SG,4,20,3,8,37.5,0,0,,3,8,37.5,37.5,0,0,,0,3,3,1,0,0,2,1,6
Robert Covington,6.0,2014 - 2019,SF,336,10028,1399,3495,40.028612303290416,781,2174,35.9245630174793,618,1321,46.78274034822105,51.20171673819742,657,809,81.21137206427689,319,1536,1855,531,553,268,587,1021,4236
Robert Hite,1.0,2007 - 2007,SG,12,136,19,60,31.666666666666664,5,23,21.73913043478261,14,37,37.83783783783784,35.833333333333336,8,12,66.66666666666666,4,12,16,8,3,2,6,8,51
Robert Horry,16.0,1993 - 2008,PF,1351,33892,3485,8205,42.47410115783059,1056,3057,34.543670264965655,2429,5148,47.183372183372185,48.90920170627666,1628,2244,72.54901960784314,2054,4576,6630,2918,1434,1260,1660,3397,9654
Robert Pack,13.0,1992 - 2004,PG,585,11898,1798,4244,42.36569274269557,120,411,29.1970802919708,1678,3833,43.77771980172189,43.779453345900095,1375,1752,78.48173515981736,268,879,1147,2618,628,50,1371,1106,5091
Robert Sacre,4.0,2013 - 2016,C,191,2749,318,730,43.56164383561644,0,1,0.0,318,729,43.62139917695473,43.56164383561644,151,225,67.11111111111111,212,383,595,126,57,110,102,336,787
Robert Swift,4.0,2005 - 2009,C,97,1500,172,340,50.588235294117645,0,0,,172,340,50.588235294117645,50.588235294117645,72,118,61.016949152542374,122,254,376,20,26,86,71,224,416
Robert Traylor,7.0,1999 - 2005,C,460,6488,869,1835,47.356948228882835,4,25,16.0,865,1810,47.790055248618785,47.46594005449592,408,708,57.6271186440678,694,1016,1710,323,290,319,416,1136,2150
Robert Werdann,3.0,1993 - 1997,C,47,273,37,98,37.755102040816325,0,1,0.0,37,97,38.144329896907216,37.755102040816325,27,47,57.446808510638306,31,50,81,9,13,8,20,65,101
Robert Whaley,1.0,2006 - 2006,C,23,212,23,57,40.35087719298245,0,0,,23,57,40.35087719298245,40.35087719298245,3,6,50.0,16,27,43,17,7,8,14,41,49
Robert Williams,1.0,2019 - 2019,C,32,283,36,51,70.58823529411765,0,0,,36,51,70.58823529411765,70.58823529411765,9,15,60.0,27,54,81,7,9,40,10,36,81
Robin Lopez,11.0,2009 - 2019,C,794,18399,3008,5661,53.135488429606085,11,51,21.568627450980394,2997,5610,53.42245989304813,53.232644409115,1175,1548,75.90439276485789,1952,2283,4235,659,201,959,881,1615,7202
Rock Lee,1.0,1982 - 1982,C,2,10,1,2,50.0,0,0,,1,2,50.0,50.0,0,4,0.0,0,1,1,2,0,0,0,3,2
Rod Foster,3.0,1984 - 1986,PG,226,3630,648,1498,43.257676902536716,72,251,28.68525896414343,576,1247,46.19085805934242,45.66088117489986,243,314,77.38853503184714,81,193,274,504,147,11,304,466,1611
Rod Higgins,13.0,1983 - 1995,SF,812,17922,2573,5541,46.43566143295434,373,1101,33.87829246139873,2200,4440,49.549549549549546,49.80147987727847,1754,2170,80.82949308755761,985,1947,2932,1309,513,381,809,1790,7273
Rod Strickland,17.0,1989 - 2005,PG,1146,35231,5693,12545,45.38062973296134,205,726,28.236914600550968,5488,11819,46.43370843556984,46.197688322040655,3571,4956,72.05407586763519,1237,3054,4291,8377,1672,226,2987,2183,15162
Rodions Kurucs,1.0,2019 - 2019,SF,63,1294,202,449,44.98886414253897,58,184,31.521739130434785,144,265,54.339622641509436,51.44766146993318,72,92,78.26086956521739,56,190,246,52,41,25,77,146,534
Rodney Buford,5.0,2000 - 2005,SF,254,4306,647,1574,41.10546378653113,79,258,30.620155038759687,568,1316,43.161094224924014,43.61499364675985,143,188,76.06382978723404,122,494,616,186,121,32,144,352,1516
Rodney Carney,5.0,2007 - 2011,SF,305,4684,687,1630,42.147239263803684,205,601,34.109816971713805,482,1029,46.84159378036929,48.43558282208589,229,326,70.24539877300614,167,428,595,137,166,102,157,429,1808
Rodney Hood,5.0,2015 - 2019,SG,348,9244,1525,3631,41.99944918755164,565,1569,36.01019757807521,960,2062,46.55674102812803,49.77967502065547,591,709,83.3568406205924,118,851,969,643,255,67,383,764,4206
Rodney McCray,10.0,1984 - 1993,SF,814,26526,3713,7371,50.37308370641704,57,225,25.333333333333336,3656,7146,51.16148894486427,50.75973409306742,2034,2676,76.00896860986546,1726,3632,5358,2956,618,526,1506,1833,9517
Rodney McGruder,3.0,2017 - 2019,SG,166,3831,413,998,41.38276553106213,167,482,34.64730290456431,246,516,47.674418604651166,49.74949899799599,100,151,66.22516556291392,165,365,530,253,90,33,124,279,1093
Rodney Monroe,1.0,1992 - 1992,SG,38,313,53,144,36.80555555555556,6,27,22.22222222222222,47,117,40.17094017094017,38.88888888888889,19,23,82.6086956521739,12,21,33,27,12,2,23,19,131
Rodney Purvis,1.0,2018 - 2018,SG,16,290,35,107,32.71028037383177,13,52,25.0,22,55,40.0,38.78504672897196,13,15,86.66666666666667,1,26,27,17,3,3,10,26,96
Rodney Rogers,12.0,1994 - 2005,SF,948,23590,3831,8563,44.738993343454396,753,2189,34.39926907263591,3078,6374,48.289927831816755,49.13581688660516,1697,2448,69.3218954248366,1365,2834,4199,1839,922,492,1736,2904,10112
Rodney Stuckey,10.0,2008 - 2017,PG,679,18523,2988,7090,42.14386459802539,283,946,29.915433403805498,2705,6144,44.02669270833333,44.139633286318755,2169,2632,82.40881458966565,433,1535,1968,2426,590,97,1216,1399,8428
Rodney White,4.0,2002 - 2005,SF,223,3382,621,1471,42.21617946974847,91,293,31.058020477815703,530,1178,44.99151103565365,45.309313392250175,215,287,74.91289198606272,114,376,490,237,120,65,288,312,1548
Rodrick Rhodes,3.0,1998 - 2000,SF,75,1241,127,363,34.9862258953168,3,15,20.0,124,348,35.63218390804598,35.39944903581267,129,209,61.72248803827751,38,51,89,121,70,12,120,146,386
Rodrigue Beaubois,4.0,2010 - 2013,PG,188,2939,511,1164,43.90034364261168,131,404,32.42574257425743,380,760,50.0,49.52749140893471,154,192,80.20833333333334,49,296,345,380,124,52,208,318,1307
Roger Burkman,1.0,1982 - 1982,SG,6,30,0,4,0.0,0,1,0.0,0,3,0.0,0.0,5,6,83.33333333333334,2,4,6,5,6,2,3,6,5
Roger Mason,10.0,2003 - 2014,SG,542,9556,1242,3058,40.614780902550685,616,1615,38.142414860681114,626,1443,43.38184338184338,50.68672334859385,316,367,86.10354223433242,81,839,920,698,196,76,382,758,3416
Roger Powell,1.0,2007 - 2007,SF,3,13,0,3,0.0,0,1,0.0,0,2,0.0,0.0,2,2,100.0,3,0,3,0,0,0,3,2,2
Roko Ukic,2.0,2009 - 2010,PG,85,987,137,354,38.70056497175141,14,74,18.91891891891892,123,280,43.92857142857143,40.67796610169492,53,71,74.64788732394366,27,51,78,165,31,2,66,83,341
Rolando Blackman,13.0,1982 - 1994,SG,1049,34224,7321,14866,49.24660298668101,238,698,34.097421203438394,7083,14168,49.99294184076793,50.04708731333244,3853,4577,84.18177845750492,1125,2353,3478,3198,757,288,1955,1753,18733
Rolando Ferreira,1.0,1989 - 1989,C,12,34,1,18,5.555555555555555,0,0,,1,18,5.555555555555555,5.555555555555555,7,8,87.5,4,9,13,1,0,1,6,7,9
Ron Anderson,10.0,1985 - 1994,SF,691,15733,3042,6478,46.95893794380982,109,377,28.912466843501328,2933,6101,48.07408621537453,47.80024698981167,1129,1379,81.87092095721538,881,1511,2392,998,481,92,759,1077,7322
Ron Baker,3.0,2017 - 2019,SG,96,1394,106,296,35.810810810810814,35,132,26.515151515151516,71,164,43.292682926829265,41.72297297297297,53,75,70.66666666666667,18,121,139,169,66,15,79,125,300
Ron Cavenall,2.0,1985 - 1989,C,58,669,30,89,33.70786516853933,0,0,,30,89,33.70786516853933,33.70786516853933,24,44,54.54545454545454,53,115,168,19,12,44,47,125,84
Ron Crevier,1.0,1986 - 1986,C,3,4,0,3,0.0,0,0,,0,3,0.0,0.0,0,2,0.0,1,0,1,0,0,0,0,2,0
Ron Davis,2.0,1981 - 1982,SF,71,884,149,339,43.95280235988201,2,8,25.0,147,331,44.41087613293052,44.24778761061947,97,164,59.14634146341463,54,78,132,51,36,11,66,106,397
Ron Grandison,4.0,1989 - 1996,PF,107,875,84,209,40.19138755980861,4,25,16.0,80,184,43.47826086956522,41.14832535885167,82,115,71.30434782608695,73,90,163,58,31,6,51,109,254
Ron Harper,15.0,1987 - 2001,SG,1121,34199,5723,12829,44.60986826720711,580,2006,28.913260219341975,5143,10823,47.519172133419566,46.87037181385922,2897,4031,71.86802282312081,1448,3278,4726,4221,1857,805,2372,2569,14923
Ron Mercer,8.0,1998 - 2005,SG,443,13670,2524,5888,42.86684782608695,60,240,25.0,2464,5648,43.626062322946176,43.37635869565217,862,1066,80.86303939962477,385,980,1365,932,463,115,691,901,5970
Ron Moore,1.0,1988 - 1988,C,14,59,9,29,31.03448275862069,0,0,,9,29,31.03448275862069,31.03448275862069,6,8,75.0,2,6,8,1,5,0,4,21,24
Ron Rowan,1.0,1987 - 1987,SG,7,16,4,9,44.44444444444444,1,1,100.0,3,8,37.5,50.0,3,4,75.0,1,0,1,1,4,0,3,1,12
Ronald Dupree,6.0,2004 - 2011,SF,171,1796,220,517,42.5531914893617,5,13,38.46153846153847,215,504,42.65873015873016,43.036750483559,114,204,55.88235294117647,118,227,345,100,57,29,91,258,559
Ronald Murray,8.0,2003 - 2010,SG,532,12112,1915,4682,40.90132422041862,351,1169,30.025662959794698,1564,3513,44.52035297466553,44.64972234087997,955,1305,73.18007662835248,217,889,1106,1174,431,108,776,862,5136
Rondae Hollis-Jefferson,4.0,2016 - 2019,SF,234,5530,840,1891,44.420941300898996,41,184,22.282608695652172,799,1707,46.80726420620972,45.50502379693284,594,804,73.88059701492537,319,1056,1375,460,230,135,331,490,2315
Ronnie Brewer,8.0,2007 - 2014,SG,549,12394,1659,3392,48.909198113207545,94,370,25.405405405405407,1565,3022,51.786896095301124,50.29481132075472,792,1173,67.51918158567774,488,1060,1548,886,658,132,417,606,4204
Ronnie Lester,6.0,1981 - 1986,PG,264,5055,692,1482,46.69365721997301,5,23,21.73913043478261,687,1459,47.08704592186429,46.86234817813765,465,591,78.68020304568529,155,332,487,1016,189,32,483,406,1854
Ronnie Murphy,1.0,1988 - 1988,SF,18,89,14,49,28.57142857142857,1,4,25.0,13,45,28.888888888888886,29.591836734693878,7,11,63.63636363636363,5,6,11,6,5,1,8,14,36
Ronnie Price,12.0,2006 - 2017,PG,572,7476,758,2048,37.01171875,249,832,29.927884615384613,509,1216,41.85855263157895,43.0908203125,311,423,73.5224586288416,185,490,675,991,435,59,484,953,2076
Ronnie Valentine,1.0,1981 - 1981,SF,24,123,37,98,37.755102040816325,1,2,50.0,36,96,37.5,38.265306122448976,9,19,47.368421052631575,10,20,30,7,7,4,16,23,84
Ronny Turiaf,10.0,2006 - 2015,C,520,8535,903,1702,53.05522914218567,0,7,0.0,903,1695,53.27433628318584,53.05522914218567,531,840,63.21428571428571,555,1298,1853,629,188,630,381,1211,2337
Rony Seikaly,11.0,1989 - 1999,C,692,21800,3694,7638,48.36344592825347,6,32,18.75,3688,7606,48.48803576124113,48.402723225975386,2737,4029,67.9324894514768,2180,4346,6526,872,460,887,1941,2392,10131
Rory Sparrow,12.0,1981 - 1992,PG,866,23332,3364,7248,46.41280353200883,106,405,26.172839506172842,3258,6843,47.610697062691806,47.144039735099334,980,1229,79.73962571196095,457,1349,1806,4353,854,104,1588,1997,7814
Rory White,5.0,1983 - 1987,SF,327,5450,978,1933,50.59493016037248,1,14,7.142857142857142,977,1919,50.91193329859301,50.62079668908432,446,656,67.98780487804879,351,408,759,232,187,52,331,524,2403
Roshown McLeod,3.0,1999 - 2001,SF,119,2179,349,848,41.15566037735849,5,45,11.11111111111111,344,803,42.839352428393525,41.450471698113205,140,170,82.35294117647058,92,219,311,125,42,15,141,201,843
Roy Hibbert,9.0,2009 - 2017,C,716,18097,2880,6172,46.66234607906675,7,26,26.923076923076923,2873,6146,46.745850959973964,46.719053791315616,1524,2015,75.63275434243177,1721,2902,4623,943,254,1252,1141,2262,7291
Roy Hinson,8.0,1984 - 1991,SF,516,15822,2833,5668,49.98235709244884,0,12,0.0,2833,5656,50.08840169731259,49.98235709244884,1693,2293,73.83340601831662,1072,2433,3505,501,313,901,1019,1924,7359
Roy Marble,2.0,1990 - 1994,SG,29,194,18,70,25.71428571428571,0,2,0.0,18,68,26.47058823529412,25.71428571428571,19,32,59.375,18,14,32,12,7,3,17,17,55
Roy Rogers,3.0,1997 - 2000,PF,137,2309,288,596,48.322147651006716,1,2,50.0,287,594,48.31649831649832,48.40604026845637,75,141,53.191489361702125,180,303,483,57,26,209,101,268,652
Roy Tarpley,6.0,1987 - 1995,PF,304,8282,1628,3349,48.61152582860556,6,38,15.789473684210526,1622,3311,48.98822108124434,48.701104807405194,678,916,74.0174672489083,1079,2031,3110,324,346,372,605,1049,3940
Royal Ivey,10.0,2005 - 2014,SG,508,6245,633,1561,40.55092889173606,168,465,36.12903225806451,465,1096,42.42700729927007,45.93209481101857,239,339,70.50147492625368,149,416,565,505,235,39,257,766,1673
Royce O'Neale,2.0,2018 - 2019,SF,162,3080,311,683,45.534407027818446,120,322,37.267080745341616,191,361,52.90858725761773,54.31918008784773,105,137,76.64233576642336,50,509,559,234,100,44,141,307,847
Royce White,1.0,2014 - 2014,PF,3,9,0,1,0.0,0,0,,0,1,0.0,0.0,0,0,,0,0,0,0,0,0,0,2,0
Ruben Boumtje-Boumtje,3.0,2002 - 2004,C,44,276,14,38,36.84210526315789,0,0,,14,38,36.84210526315789,36.84210526315789,15,27,55.55555555555556,22,35,57,6,4,17,14,40,43
Ruben Garces,1.0,2001 - 2001,PF,13,73,7,22,31.818181818181817,0,0,,7,22,31.818181818181817,31.818181818181817,2,8,25.0,16,13,29,5,3,2,5,14,16
Ruben Nembhard,1.0,1997 - 1997,SG-PG,10,113,16,37,43.24324324324324,0,6,0.0,16,31,51.61290322580645,43.24324324324324,8,10,80.0,3,5,8,17,9,0,8,12,40
Ruben Patterson,10.0,1999 - 2008,SF,671,16322,2731,5291,51.615951615951616,35,203,17.24137931034483,2696,5088,52.987421383647806,51.94670194670194,1603,2493,64.30004011231448,1310,1441,2751,1167,762,253,1191,1447,7100
Ruben Wolkowyski,2.0,2001 - 2003,PF,41,329,27,83,32.53012048192771,0,3,0.0,27,80,33.75,32.53012048192771,26,38,68.42105263157895,12,35,47,4,6,18,13,41,80
Rudy Fernandez,4.0,2009 - 2012,SG,267,6327,771,1933,39.88618727366787,435,1199,36.28023352793995,336,734,45.776566757493185,51.138127263321266,380,454,83.70044052863436,134,513,647,573,260,44,302,395,2357
Rudy Gay,13.0,2007 - 2019,SF,891,30327,5948,13060,45.543644716692185,911,2635,34.573055028462996,5037,10425,48.31654676258993,49.03139356814702,2848,3581,79.5308573024295,1275,4012,5287,1986,1124,691,2035,2174,15655
Rudy Gobert,6.0,2014 - 2019,C,426,12290,1752,2783,62.95364714337046,0,3,0.0,1752,2780,63.021582733812956,62.95364714337046,1269,2026,62.63573543928924,1377,3105,4482,567,295,932,671,1089,4773
Rudy Macklin,3.0,1982 - 1984,SF,165,2860,407,906,44.92273730684327,0,8,0.0,407,898,45.32293986636971,44.92273730684327,260,333,78.07807807807808,210,272,482,124,84,32,214,449,1074
Rumeal Robinson,6.0,1991 - 1997,PG,352,6314,1046,2423,43.16962443252167,118,344,34.30232558139535,928,2079,44.636844636844636,45.604622368964094,413,677,61.00443131462334,168,454,622,1223,311,54,608,632,2623
Russ Schoene,4.0,1983 - 1989,PF,312,3753,642,1485,43.23232323232323,66,202,32.67326732673268,576,1283,44.89477786438036,45.45454545454545,201,267,75.28089887640449,294,479,773,182,125,75,232,604,1551
Russ Smith,2.0,2015 - 2016,PG,29,134,15,47,31.914893617021278,3,16,18.75,12,31,38.70967741935484,35.1063829787234,20,26,76.92307692307693,2,13,15,21,8,1,19,18,53
Russell Cross,1.0,1984 - 1984,C,45,354,64,112,57.14285714285714,0,0,,64,112,57.14285714285714,57.14285714285714,38,91,41.75824175824176,35,47,82,22,12,7,19,58,166
Russell Westbrook,11.0,2009 - 2019,PG,914,31853,7447,17239,43.1985614014734,1051,3425,30.686131386861316,6396,13814,46.300854205878096,46.24688206972562,5289,6565,80.56359482102057,1546,4855,6401,7622,1621,275,3693,2326,21234
Rusty LaRue,5.0,1998 - 2004,PG,102,1618,193,513,37.62183235867446,56,175,32.0,137,338,40.532544378698226,43.07992202729044,64,79,81.0126582278481,22,110,132,158,63,11,98,153,506
Ryan Anderson,11.0,2009 - 2019,PF,693,17689,2844,6777,41.96547144754316,1373,3637,37.750893593621115,1471,3140,46.847133757961785,52.095322414047516,1199,1402,85.5206847360913,1300,2274,3574,616,348,227,636,1358,8260
Ryan Arcidiacono,2.0,2018 - 2019,PG,105,2265,204,459,44.44444444444444,90,248,36.29032258064516,114,211,54.02843601895735,54.248366013071895,94,108,87.03703703703704,28,216,244,304,78,4,76,189,592
Ryan Bowen,10.0,2000 - 2010,SF,528,6674,554,1225,45.224489795918366,14,69,20.28985507246377,540,1156,46.71280276816609,45.795918367346935,221,318,69.49685534591194,516,572,1088,258,332,138,175,777,1343
Ryan Broekhoff,1.0,2019 - 2019,SG,42,453,57,126,45.23809523809524,38,93,40.86021505376344,19,33,57.57575757575758,60.317460317460316,15,19,78.94736842105263,8,55,63,22,6,4,16,35,167
Ryan Gomes,8.0,2006 - 2014,SF,487,13463,1891,4249,44.504589315132975,334,956,34.93723849372385,1557,3293,47.282113574248406,48.43492586490939,810,1014,79.88165680473372,617,1622,2239,712,351,78,550,942,4926
Ryan Hollins,10.0,2007 - 2016,C,554,6434,712,1230,57.886178861788615,0,1,0.0,712,1229,57.93327908868999,57.886178861788615,551,852,64.67136150234741,486,713,1199,162,95,285,398,1101,1975
Ryan Humphrey,3.0,2003 - 2005,PF,88,777,79,228,34.64912280701755,0,3,0.0,79,225,35.11111111111111,34.64912280701755,41,76,53.94736842105263,87,104,191,18,20,19,48,113,199
Ryan Kelly,4.0,2014 - 2017,PF,163,3125,324,857,37.80630105017503,102,323,31.57894736842105,222,534,41.57303370786517,43.75729288214703,231,290,79.65517241379311,77,427,504,215,79,84,106,309,981
Ryan Lorthridge,1.0,1995 - 1995,SG,37,672,106,223,47.53363228699551,3,14,21.428571428571427,103,209,49.282296650717704,48.20627802690583,57,88,64.77272727272727,24,47,71,101,28,1,57,42,272
Ryan Reid,1.0,2012 - 2012,PF,5,17,4,5,80.0,0,0,,4,5,80.0,80.0,0,0,,1,1,2,0,0,0,1,1,8
Ryan Robertson,1.0,2000 - 2000,SG,1,25,2,6,33.33333333333333,0,2,0.0,2,4,50.0,33.33333333333333,1,1,100.0,0,0,0,0,0,0,0,0,5
Ryan Stack,2.0,1999 - 2000,PF,43,397,31,88,35.22727272727273,0,1,0.0,31,87,35.63218390804598,35.22727272727273,37,47,78.72340425531915,34,45,79,10,6,22,26,78,99
Salah Mejri,4.0,2016 - 2019,C,208,2506,287,474,60.54852320675106,12,41,29.268292682926827,275,433,63.51039260969977,61.81434599156118,126,217,58.06451612903226,264,557,821,95,75,195,123,393,712
Salim Stoudamire,3.0,2006 - 2008,SG,160,2700,450,1106,40.6871609403255,169,462,36.58008658008658,281,644,43.63354037267081,48.32730560578662,203,230,88.26086956521739,22,193,215,164,56,10,161,242,1272
Sam Bowie,10.0,1985 - 1995,C,540,14742,2191,4861,45.07303024069122,34,110,30.909090909090907,2157,4751,45.40096821721743,45.4227525200576,1313,1760,74.60227272727272,1241,2764,4005,1113,277,950,1008,1650,5729
Sam Cassell,15.0,1994 - 2008,PG,1129,33351,6263,13922,44.986352535555234,789,2351,33.560187154402385,5474,11571,47.30792498487598,47.819997126849586,3976,4627,85.9304084720121,676,2894,3570,6531,1163,182,2686,3146,17291
Sam Dekker,4.0,2016 - 2019,PF,204,3127,454,956,47.48953974895397,92,315,29.20634920634921,362,641,56.47425897035882,52.30125523012552,103,170,60.588235294117645,196,421,617,161,102,38,98,203,1103
Sam Jacobson,3.0,1999 - 2001,PG,68,752,120,235,51.06382978723404,9,25,36.0,111,210,52.85714285714286,52.97872340425533,34,46,73.91304347826086,28,52,80,36,33,3,34,134,283
Sam Mack,7.0,1993 - 2002,SF,269,5198,731,1834,39.858233369683745,341,914,37.308533916849015,390,920,42.391304347826086,49.154852780806976,270,328,82.3170731707317,110,441,551,344,169,37,227,471,2073
Sam Mitchell,13.0,1990 - 2002,SF,1053,23111,3318,7452,44.524959742351044,71,321,22.118380062305295,3247,7131,45.5335857523489,45.00134192163178,2196,2799,78.45659163987139,1290,2551,3841,1123,558,310,877,2631,8903
Sam Perkins,17.0,1985 - 2001,PF,1453,41383,6154,13463,45.71046572086459,1001,2767,36.17636429345862,5153,10696,48.17688855646971,49.428062096115276,3876,4798,80.78365985827428,2579,6023,8602,2221,1223,1059,1793,3618,17185
Sam Vincent,7.0,1986 - 1992,PG,448,8073,1245,2818,44.18026969481902,17,96,17.708333333333336,1228,2722,45.11388684790595,44.481902058197306,826,963,85.7736240913811,172,693,865,1630,284,64,702,652,3333
Sam Williams,4.0,1982 - 1985,PF,266,4609,671,1349,49.7405485544848,0,3,0.0,671,1346,49.85141158989599,49.7405485544848,296,459,64.4880174291939,408,756,1164,159,212,303,317,710,1638
Sam Worthen,2.0,1981 - 1982,PG,70,968,97,197,49.23857868020304,0,4,0.0,97,193,50.259067357512954,49.23857868020304,45,60,75.0,23,93,116,118,57,6,93,118,239
Sam Young,4.0,2010 - 2013,SF,279,4356,612,1388,44.09221902017291,54,198,27.27272727272727,558,1190,46.890756302521005,46.03746397694525,282,383,73.62924281984334,181,451,632,186,144,61,219,346,1560
Samaki Walker,10.0,1997 - 2006,PF,493,8109,981,2131,46.03472548099484,2,10,20.0,979,2121,46.15747289014615,46.08165180666354,528,835,63.233532934131745,681,1559,2240,263,139,337,427,975,2492
Samardo Samuels,3.0,2011 - 2013,C,109,1722,237,532,44.54887218045113,0,4,0.0,237,528,44.88636363636363,44.54887218045113,164,251,65.33864541832669,148,218,366,45,38,41,115,231,638
Samuel Dalembert,13.0,2002 - 2015,C,911,22308,2882,5536,52.059248554913296,1,12,8.333333333333332,2881,5524,52.15423606082549,52.068280346820806,1229,1746,70.38946162657503,2361,4811,7172,473,446,1582,1302,2679,6994
Sarunas Jasikevicius,2.0,2006 - 2007,PG,148,2602,305,771,39.559014267185475,132,375,35.199999999999996,173,396,43.686868686868685,48.119325551232166,209,232,90.08620689655173,35,193,228,407,66,6,211,191,951
Sarunas Marciulionis,7.0,1990 - 1997,SG,380,8563,1646,3269,50.35178953808504,132,365,36.16438356164384,1514,2904,52.13498622589532,52.37075558274702,1440,1868,77.08779443254818,307,551,858,868,483,33,743,1011,4864
Sasha Danilovic,2.0,1996 - 1997,SG,78,2391,340,772,44.04145077720207,123,324,37.96296296296296,217,448,48.4375,52.00777202072538,179,226,79.20353982300885,42,141,183,153,70,12,156,217,982
Sasha Kaun,1.0,2016 - 2016,C,25,95,9,17,52.94117647058824,0,0,,9,17,52.94117647058824,52.94117647058824,5,11,45.45454545454545,12,14,26,3,4,5,7,11,23
Sasha Pavlovic,10.0,2004 - 2013,SG,619,9750,1165,2897,40.2140144977563,335,971,34.5005149330587,830,1926,43.09449636552441,45.995857783914396,363,549,66.12021857923497,210,872,1082,555,298,104,505,1120,3028
Sasha Vujacic,10.0,2005 - 2017,SG,646,9862,1180,3044,38.76478318002628,596,1615,36.90402476780186,584,1429,40.86773967809657,48.55453350854139,462,537,86.03351955307262,228,972,1200,790,365,42,365,984,3418
Scooter McCray,3.0,1984 - 1987,PF,81,930,87,202,43.06930693069307,0,1,0.0,87,201,43.28358208955223,43.06930693069307,58,96,60.416666666666664,73,123,196,77,22,26,68,122,232
Scot Pollard,11.0,1998 - 2008,C,566,9039,926,1875,49.38666666666667,0,2,0.0,926,1873,49.439402028830756,49.38666666666667,542,773,70.11642949547219,987,1549,2536,230,317,378,330,1307,2394
Scott Brooks,10.0,1989 - 1998,PG,714,9592,1262,2814,44.847192608386635,297,794,37.405541561712845,965,2020,47.77227722772277,50.124378109452735,585,692,84.53757225433526,162,547,709,1665,492,30,472,870,3406
Scott Burrell,8.0,1994 - 2001,SF,406,7865,1005,2397,41.92740926157697,345,930,37.096774193548384,660,1467,44.989775051124745,49.123904881101375,377,519,72.63969171483622,406,972,1378,538,362,183,348,898,2732
Scott Haffner,2.0,1990 - 1991,PG,50,609,96,238,40.33613445378151,3,23,13.043478260869565,93,215,43.25581395348837,40.96638655462185,18,27,66.66666666666666,9,46,55,89,16,3,37,57,213
Scott Haskin,1.0,1994 - 1994,C,27,186,21,45,46.666666666666664,0,0,,21,45,46.666666666666664,46.666666666666664,13,19,68.42105263157895,17,38,55,6,2,15,13,33,55
Scott Hastings,11.0,1983 - 1993,PF,622,6241,612,1373,44.57392571012382,31,108,28.703703703703702,581,1265,45.92885375494071,45.70284049526584,469,581,80.72289156626506,439,895,1334,293,167,156,338,1088,1724
Scott Lloyd,3.0,1981 - 1983,C,161,3439,372,882,42.17687074829932,2,7,28.57142857142857,370,875,42.285714285714285,42.290249433106574,227,313,72.52396166134186,240,423,663,247,55,38,210,468,973
Scott Machado,2.0,2013 - 2019,PG,15,48,8,14,57.14285714285714,1,2,50.0,7,12,58.333333333333336,60.71428571428571,4,5,80.0,0,2,2,10,3,0,9,3,21
Scott Meents,2.0,1990 - 1991,PF,41,209,28,76,36.84210526315789,1,1,100.0,27,75,36.0,37.5,19,28,67.85714285714286,10,31,41,15,12,7,15,18,76
Scott Padgett,8.0,2000 - 2007,PF,478,5904,711,1737,40.932642487046635,251,679,36.96612665684831,460,1058,43.47826086956522,48.15774323546344,284,386,73.57512953367875,430,862,1292,340,192,92,271,725,1957
Scott Roth,3.0,1988 - 1990,SF,166,1808,249,664,37.5,23,79,29.11392405063291,226,585,38.63247863247864,39.23192771084337,232,318,72.95597484276729,61,143,204,186,89,11,136,250,753
Scott Skiles,10.0,1987 - 1996,PG,602,16812,2294,5267,43.55420543003608,524,1383,37.88864786695589,1770,3884,45.57157569515963,48.52857414087716,1549,1742,88.92078071182549,276,1251,1527,3884,500,29,1502,1345,6661
Scott Williams,15.0,1991 - 2005,C,840,13724,1790,3821,46.84637529442554,5,49,10.204081632653061,1785,3772,47.322375397667024,46.91180319288144,727,1024,70.99609375,1435,2505,3940,489,431,495,614,2170,4312
Scottie Pippen,17.0,1988 - 2004,SF,1386,49174,8755,18709,46.79565984285638,1178,3662,32.16821409066084,7577,15047,50.35555260184754,49.94387727831525,3894,5504,70.74854651162791,2534,6543,9077,7183,2702,1132,3859,4015,22582
Scotty Hopson,2.0,2014 - 2018,SG,3,15,0,5,0.0,0,2,0.0,0,3,0.0,0.0,2,4,50.0,0,0,0,2,1,0,1,0,2
Sean Colson,1.0,2001 - 2001,PG,13,44,6,24,25.0,1,5,20.0,5,19,26.31578947368421,27.083333333333332,2,4,50.0,2,4,6,10,1,0,2,6,15
Sean Elliott,12.0,1990 - 2001,SF,827,27338,4236,9152,46.28496503496503,662,1777,37.253798536859875,3574,7375,48.461016949152544,49.90166083916084,2528,3162,79.94939911448449,899,2646,3545,2104,635,321,1475,1846,11662
Sean Green,3.0,1992 - 1994,SG,85,674,153,396,38.63636363636363,15,61,24.59016393442623,138,335,41.19402985074627,40.53030303030303,31,50,62.0,36,49,85,45,33,13,63,63,352
Sean Higgins,6.0,1991 - 1998,SF,223,3347,559,1307,42.76970160673297,93,290,32.068965517241374,466,1017,45.82104228121927,46.327467482785,164,193,84.97409326424871,115,287,402,227,73,32,239,352,1375
Sean Kilpatrick,4.0,2015 - 2018,SG,157,3082,545,1319,41.31918119787718,194,579,33.506044905008636,351,740,47.43243243243243,48.6732373009856,332,385,86.23376623376623,40,389,429,236,73,13,206,191,1616
Sean Lampley,2.0,2003 - 2004,SF,45,550,69,149,46.308724832214764,0,4,0.0,69,145,47.58620689655172,46.308724832214764,65,94,69.14893617021278,28,66,94,33,7,4,28,45,203
Sean Marks,11.0,1999 - 2011,PF,236,2358,265,591,44.83925549915397,5,26,19.230769230769234,260,565,46.017699115044245,45.26226734348562,119,178,66.85393258426966,168,353,521,50,36,89,118,351,654
Sean May,4.0,2006 - 2010,PF,119,1868,324,708,45.76271186440678,3,13,23.076923076923077,321,695,46.18705035971223,45.97457627118644,170,228,74.56140350877193,155,326,481,115,53,47,134,236,821
Sean Rooks,12.0,1993 - 2004,C,778,13813,1734,3774,45.94594594594595,2,22,9.090909090909092,1732,3752,46.16204690831556,45.972443031266565,1278,1830,69.83606557377048,963,1956,2919,642,262,510,817,1717,4748
Sean Singletary,1.0,2009 - 2009,PG,37,303,31,85,36.470588235294116,10,25,40.0,21,60,35.0,42.35294117647059,18,21,85.71428571428571,10,25,35,29,11,0,23,45,90
Sean Williams,4.0,2008 - 2012,PF,139,1984,229,448,51.11607142857143,0,1,0.0,229,447,51.23042505592841,51.11607142857143,123,197,62.43654822335025,183,290,473,47,47,162,121,325,581
Sebastian Telfair,10.0,2005 - 2015,PG,564,12149,1542,3953,39.008348090058185,361,1133,31.862312444836714,1181,2820,41.87943262411348,43.57450037945864,738,950,77.6842105263158,151,747,898,1960,413,75,859,1196,4183
Sedale Threatt,14.0,1984 - 1997,PG,1021,23970,4165,8630,48.261877172653534,209,721,28.9875173370319,3956,7909,50.01896573523834,49.472769409038236,1395,1711,81.531268264173,393,1426,1819,3865,1211,143,1380,2340,9934
Sedric Toney,5.0,1986 - 1994,PG,115,1425,142,387,36.69250645994832,34,97,35.051546391752574,108,290,37.24137931034483,41.08527131782946,102,130,78.46153846153847,22,76,98,237,49,1,116,163,420
Semaj Christon,1.0,2017 - 2017,PG,66,994,79,228,34.64912280701755,13,66,19.696969696969695,66,162,40.74074074074074,37.5,17,31,54.83870967741935,19,71,90,135,29,7,43,80,188
Semi Ojeleye,2.0,2018 - 2019,PF,146,1974,142,379,37.46701846965699,74,236,31.35593220338983,68,143,47.55244755244755,47.229551451187334,55,87,63.2183908045977,65,210,275,45,34,8,46,155,413
Semih Erden,2.0,2011 - 2012,C,69,928,101,185,54.59459459459459,0,0,,101,185,54.59459459459459,54.59459459459459,60,101,59.4059405940594,57,133,190,29,25,29,50,164,262
Serge Ibaka,10.0,2010 - 2019,PF,862,24952,4364,8517,51.23869907244335,524,1453,36.063317274604266,3840,7064,54.36013590033974,54.31489961253963,1247,1634,76.31578947368422,1852,4363,6215,617,370,1878,1081,2467,10499
Sergei Bazarevich,1.0,1995 - 1995,PG,10,74,11,22,50.0,1,6,16.666666666666664,10,16,62.5,52.27272727272727,7,9,77.77777777777779,1,6,7,14,1,1,7,10,30
Sergei Monia,1.0,2006 - 2006,SF,26,343,29,87,33.33333333333333,9,34,26.47058823529412,20,53,37.735849056603776,38.50574712643678,10,14,71.42857142857143,11,41,52,19,7,5,12,41,77
Sergey Karasev,3.0,2014 - 2016,SF,95,1110,96,243,39.50617283950617,31,110,28.18181818181818,65,133,48.87218045112782,45.884773662551446,64,76,84.21052631578947,30,110,140,87,32,4,57,94,287
Sergio Rodriguez,5.0,2007 - 2017,PG,358,5308,678,1657,40.91732045866023,202,600,33.666666666666664,476,1057,45.033112582781456,47.01267350633675,193,261,73.9463601532567,122,406,528,1190,212,14,493,446,1751
Seth Curry,5.0,2014 - 2019,PG,192,4141,653,1398,46.70958512160229,301,686,43.87755102040816,352,712,49.43820224719101,57.474964234620884,174,206,84.46601941747572,61,301,362,323,139,22,189,266,1781
Shabazz Muhammad,5.0,2014 - 2018,SG,282,4801,949,2008,47.26095617529881,127,391,32.48081841432225,822,1617,50.83487940630798,50.42330677290837,504,672,75.0,294,480,774,151,83,25,185,285,2529
Shabazz Napier,5.0,2015 - 2019,PG,295,4724,633,1608,39.365671641791046,274,775,35.35483870967742,359,833,43.09723889555822,47.885572139303484,353,436,80.96330275229357,79,426,505,593,222,37,330,310,1893
Shai Gilgeous-Alexander,1.0,2019 - 2019,PG,82,2174,341,716,47.625698324022345,51,139,36.69064748201439,290,577,50.25996533795494,51.187150837988824,156,195,80.0,57,175,232,270,96,45,141,175,889
Shake Milton,1.0,2019 - 2019,SG,20,268,34,87,39.08045977011494,14,44,31.818181818181817,20,43,46.51162790697674,47.12643678160919,5,7,71.42857142857143,9,26,35,18,8,8,6,29,87
Shammond Williams,7.0,1999 - 2007,PG,340,5586,710,1756,40.43280182232346,267,724,36.87845303867403,443,1032,42.92635658914728,48.03530751708428,297,374,79.41176470588235,111,425,536,797,207,15,347,394,1984
Shandon Anderson,10.0,1997 - 2006,SG,793,17221,2129,4664,45.647512864494,324,1020,31.76470588235294,1805,3644,49.53347969264544,49.12092624356775,1104,1501,73.55096602265156,648,1796,2444,1075,587,187,1035,1566,5686
Shane Battier,13.0,2002 - 2014,SF,1089,33036,3208,7387,43.42764315689725,1389,3644,38.11745334796927,1819,3743,48.5973817793214,52.829294706917565,1285,1723,74.57922228670922,1369,3054,4423,1834,1065,961,957,2495,9090
Shane Edwards,1.0,2014 - 2014,SF,2,12,1,3,33.33333333333333,0,0,,1,3,33.33333333333333,33.33333333333333,0,0,,1,1,2,0,0,0,1,1,2
Shane Heal,2.0,1997 - 2004,PG,51,311,35,123,28.455284552845526,26,85,30.58823529411765,9,38,23.684210526315788,39.02439024390244,7,10,70.0,3,19,22,39,4,3,22,22,103
Shane Larkin,4.0,2014 - 2018,PG,269,5044,561,1328,42.243975903614455,121,362,33.42541436464088,440,966,45.54865424430642,46.799698795180724,197,252,78.17460317460318,84,418,502,759,248,24,308,390,1440
Shannon Brown,9.0,2007 - 2015,SG,463,8095,1304,3105,41.99677938808374,304,913,33.29682365826944,1000,2192,45.62043795620438,46.89210950080515,494,619,79.80613893376413,197,636,833,498,310,101,410,612,3406
Shaquille Harrison,2.0,2018 - 2019,PG,96,1814,243,550,44.18181818181818,30,115,26.08695652173913,213,435,48.96551724137931,46.909090909090914,110,161,68.32298136645963,42,241,283,194,115,37,82,166,626
Shaquille O'Neal,19.0,1993 - 2011,C,1423,50016,13371,23084,57.9232368740253,1,22,4.545454545454546,13370,23062,57.97415662128176,57.92540287645123,7103,13569,52.3472621416464,5075,10532,15607,3608,856,3191,3959,4915,33846
Shareef Abdur-Rahim,12.0,1997 - 2008,PF,836,29011,5457,11558,47.21405087385361,154,522,29.50191570881226,5303,11036,48.05183037332367,47.88025609967123,4015,4958,80.98023396530859,1877,4391,6268,2116,822,638,2149,2351,15083
Sharone Wright,4.0,1995 - 1998,C,203,4531,777,1705,45.57184750733138,1,12,8.333333333333332,776,1693,45.83579444772593,45.60117302052786,419,678,61.799410029498524,419,604,1023,118,82,203,355,562,1974
Sharrod Ford,1.0,2006 - 2006,PF,3,13,2,3,66.66666666666666,0,0,,2,3,66.66666666666666,66.66666666666666,0,0,,1,2,3,0,0,1,2,7,4
Shaun Livingston,14.0,2005 - 2019,PG,937,19316,2446,4997,48.949369621773066,15,78,19.230769230769234,2431,4919,49.42061394592397,49.099459675805484,1044,1311,79.63386727688787,562,1728,2290,2749,630,335,1155,1707,5951
Shavlik Randolph,8.0,2006 - 2015,PF,149,1209,129,288,44.79166666666667,1,6,16.666666666666664,128,282,45.39007092198582,44.96527777777778,84,153,54.90196078431373,151,215,366,36,44,38,59,195,343
Shawn Bradley,12.0,1994 - 2005,C,875,20088,2767,6048,45.75066137566138,4,40,10.0,2763,6008,45.98868175765646,45.78373015873016,1342,1874,71.61152614727855,1795,3620,5415,583,539,2166,1085,2669,6880
Shawn Kemp,14.0,1990 - 2003,PF,1139,32230,6019,12310,48.89520714865962,36,134,26.865671641791046,5983,12176,49.137647831800265,49.04142973192526,4795,6421,74.67684161345585,3340,6347,9687,1865,1284,1416,3041,4172,16869
Shawn Long,1.0,2017 - 2017,C,18,234,61,109,55.96330275229357,7,19,36.84210526315789,54,90,60.0,59.174311926605505,19,35,54.285714285714285,41,44,85,13,9,9,13,49,148
Shawn Marion,16.0,2000 - 2015,SF,1272,43934,7906,16408,48.18381277425646,862,2613,32.988901645618064,7044,13795,51.06197897789054,50.810580204778155,2545,3140,81.05095541401273,2992,8048,11040,2356,1887,1360,1890,2812,19219
Shawn Respert,4.0,1996 - 1999,SG,172,2350,315,760,41.44736842105263,97,285,34.03508771929825,218,475,45.89473684210526,47.828947368421055,124,152,81.57894736842105,81,145,226,177,91,7,125,192,851
Shawne Williams,7.0,2007 - 2015,SF,318,5469,660,1636,40.34229828850856,281,826,34.01937046004843,379,810,46.79012345679012,48.93031784841076,200,265,75.47169811320755,251,708,959,225,131,160,201,664,1801
Shawnelle Scott,4.0,1997 - 2002,C,113,650,80,174,45.97701149425287,0,2,0.0,80,172,46.51162790697674,45.97701149425287,34,72,47.22222222222222,104,126,230,20,14,24,40,125,194
Shayne Whittington,2.0,2015 - 2016,PF,27,149,24,53,45.28301886792453,1,8,12.5,23,45,51.11111111111111,46.22641509433962,19,25,76.0,15,26,41,9,6,3,10,25,68
Shea Seals,1.0,1998 - 1998,SG,4,9,1,8,12.5,0,3,0.0,1,5,20.0,12.5,2,4,50.0,3,1,4,0,1,0,0,1,4
Shelden Williams,6.0,2007 - 2012,PF,369,5643,594,1285,46.22568093385214,2,9,22.22222222222222,592,1276,46.39498432601881,46.30350194552529,441,595,74.11764705882354,531,1044,1575,163,180,164,310,741,1631
Sheldon Mac,1.0,2017 - 2017,SG,37,304,35,84,41.66666666666667,9,35,25.71428571428571,26,49,53.06122448979592,47.023809523809526,25,29,86.20689655172413,4,32,36,15,8,2,6,18,104
Shelton Jones,1.0,1989 - 1989,SF,51,682,93,209,44.49760765550239,0,1,0.0,93,208,44.71153846153847,44.49760765550239,58,80,72.5,32,81,113,42,21,15,47,58,244
Shelvin Mack,8.0,2012 - 2019,PG,486,8786,1220,2896,42.12707182320442,327,984,33.23170731707317,893,1912,46.70502092050209,47.77279005524862,390,532,73.30827067669173,129,821,950,1481,316,24,577,599,3157
Sherell Ford,1.0,1996 - 1996,SF,28,139,30,80,37.5,4,25,16.0,26,55,47.27272727272727,40.0,26,34,76.47058823529412,12,12,24,5,8,1,6,27,90
Sherman Douglas,12.0,1990 - 2001,PG,782,21672,3408,7068,48.217317487266556,160,598,26.755852842809364,3248,6470,50.200927357032455,49.34917940011319,1627,2399,67.81992496873698,576,1154,1730,4642,799,77,1807,1650,8603
Sherron Collins,1.0,2011 - 2011,PG,20,66,7,25,28.000000000000004,2,10,20.0,5,15,33.33333333333333,32.0,1,1,100.0,0,5,5,8,2,0,4,2,17
Sidney Green,10.0,1984 - 1993,PF,722,13753,2051,4521,45.36606945366069,1,27,3.7037037037037033,2050,4494,45.61637739207833,45.37712895377129,1127,1533,73.51598173515981,1356,2921,4277,653,374,230,1066,1877,5230
Sidney Lowe,4.0,1984 - 1990,PG,193,3422,198,540,36.666666666666664,4,30,13.333333333333334,194,510,38.03921568627451,37.03703703703704,162,212,76.41509433962264,81,254,335,749,191,9,191,282,562
Sim Bhullar,1.0,2015 - 2015,C,3,3,1,2,50.0,0,0,,1,2,50.0,50.0,0,0,,0,1,1,1,0,1,0,0,2
Sindarius Thornwell,2.0,2018 - 2019,SG,137,1469,117,282,41.48936170212766,26,76,34.21052631578947,91,206,44.1747572815534,46.09929078014184,84,122,68.85245901639344,38,146,184,86,62,32,73,166,344
Skal Labissiere,3.0,2017 - 2019,PF,115,2028,348,725,48.0,27,72,37.5,321,653,49.15773353751914,49.862068965517246,156,209,74.64114832535886,159,334,493,110,46,68,121,225,879
Skeeter Henry,1.0,1994 - 1994,SG,7,31,2,11,18.181818181818183,0,4,0.0,2,7,28.57142857142857,18.181818181818183,2,4,50.0,1,4,5,7,0,0,2,2,6
Slavko Vranes,1.0,2004 - 2004,C,1,3,0,1,0.0,0,0,,0,1,0.0,0.0,0,0,,0,0,0,0,0,0,0,1,0
Sleepy Floyd,13.0,1983 - 1995,PG,993,27421,4619,10389,44.4604870536144,547,1669,32.774116237267826,4072,8720,46.69724770642202,47.093079218404085,2942,3611,81.4732761008031,649,1922,2571,5394,1163,220,2343,2030,12727
Smush Parker,5.0,2003 - 2008,PG,286,7386,934,2214,42.18608852755194,294,870,33.793103448275865,640,1344,47.61904761904761,48.8256549232159,378,528,71.5909090909091,132,555,687,805,354,46,511,638,2540
Solomon Alabi,2.0,2011 - 2012,C,26,181,16,51,31.372549019607842,0,0,,16,51,31.372549019607842,31.372549019607842,7,10,70.0,22,39,61,5,4,11,8,16,39
Solomon Hill,6.0,2014 - 2019,SF,322,7225,646,1635,39.510703363914374,246,732,33.60655737704918,400,903,44.29678848283499,47.03363914373089,354,434,81.5668202764977,223,819,1042,486,213,75,292,585,1892
Solomon Jones,8.0,2007 - 2014,PF,297,3198,309,667,46.326836581709145,1,9,11.11111111111111,308,658,46.808510638297875,46.40179910044978,238,333,71.47147147147147,270,408,678,102,60,157,162,566,857
Sonny Weems,4.0,2009 - 2016,SG,183,3335,514,1106,46.473779385171795,34,120,28.333333333333332,480,986,48.6815415821501,48.01084990958409,127,181,70.1657458563536,88,314,402,257,84,28,198,268,1189
Soumaila Samake,2.0,2001 - 2003,C,47,303,28,72,38.88888888888889,0,0,,28,72,38.88888888888889,38.88888888888889,12,26,46.15384615384615,32,44,76,5,2,19,6,36,68
Speedy Claxton,7.0,2002 - 2009,PG,364,8926,1176,2870,40.97560975609756,42,219,19.17808219178082,1134,2651,42.776310826103355,41.70731707317073,839,1103,76.06527651858568,202,674,876,1500,524,45,607,873,3233
Spencer Dinwiddie,5.0,2015 - 2019,PG,254,6170,895,2192,40.83029197080292,316,979,32.27783452502553,579,1213,47.73289365210223,48.03832116788321,681,850,80.11764705882352,101,553,654,1147,174,69,386,565,2787
Spencer Hawes,10.0,2008 - 2017,C,718,16098,2530,5539,45.676114822170064,366,1044,35.05747126436782,2164,4495,48.14238042269188,48.979960281639286,699,975,71.6923076923077,1022,3009,4031,1310,271,671,1001,1772,6125
Spud Webb,12.0,1986 - 1998,PG,853,21013,3017,6670,45.232383808095946,327,1041,31.412103746397698,2690,5629,47.788239474151716,47.68365817091455,2032,2401,84.6314035818409,343,1484,1827,4540,952,113,1674,1702,8393
Stacey Augmon,15.0,1992 - 2006,SG,1078,23131,3199,6850,46.7007299270073,12,82,14.634146341463413,3187,6768,47.089243498817964,46.78832116788321,2042,2793,73.11134980307912,1357,2038,3395,1662,1030,331,1321,1891,8452
Stacey King,8.0,1990 - 1997,PF,499,8125,1160,2467,47.020672882042966,6,21,28.57142857142857,1154,2446,47.17906786590352,47.142278070531006,757,1066,71.01313320825517,650,946,1596,418,194,225,577,1004,3083
Stan Kimbrough,2.0,1990 - 1993,PG,13,65,9,22,40.909090909090914,1,2,50.0,8,20,40.0,43.18181818181818,2,2,100.0,4,3,7,6,5,0,4,5,21
Stanislav Medvedenko,7.0,2001 - 2007,PF,300,3671,641,1418,45.20451339915374,2,13,15.384615384615385,639,1405,45.480427046263344,45.27503526093089,229,308,74.35064935064936,363,456,819,147,93,47,168,590,1513
Stanley Brundy,1.0,1990 - 1990,SF,16,128,15,30,50.0,0,0,,15,30,50.0,50.0,7,18,38.88888888888889,15,11,26,3,6,5,6,24,37
Stanley Jackson,1.0,1994 - 1994,SG,17,92,17,33,51.515151515151516,1,5,20.0,16,28,57.14285714285714,53.03030303030303,3,3,100.0,12,15,27,16,5,0,10,13,38
Stanley Johnson,4.0,2016 - 2019,SF,289,6241,747,1988,37.57545271629779,243,818,29.706601466992666,504,1170,43.07692307692308,43.68712273641851,280,366,76.50273224043715,161,819,980,423,267,64,346,592,2017
Stanley Roberts,8.0,1992 - 2000,C,309,6046,1085,2181,49.74782209995415,0,3,0.0,1085,2178,49.81634527089073,49.74782209995415,444,872,50.917431192660544,524,1071,1595,190,113,392,381,1089,2614
Stefano Rusconi,1.0,1996 - 1996,PF,7,30,3,9,33.33333333333333,0,0,,3,9,33.33333333333333,33.33333333333333,2,5,40.0,3,3,6,3,0,2,3,10,8
Steffond Johnson,1.0,1987 - 1987,PF,29,234,27,64,42.1875,0,3,0.0,27,61,44.26229508196721,42.1875,20,38,52.63157894736842,15,28,43,5,9,2,18,55,74
Stephane Lasme,1.0,2008 - 2008,PF-SF,16,303,32,71,45.07042253521127,0,0,,32,71,45.07042253521127,45.07042253521127,19,32,59.375,26,27,53,3,13,22,15,35,83
Stephen Curry,10.0,2010 - 2019,PG,784,27248,6438,13593,47.36261310968881,2861,6617,43.237116518059544,3577,6976,51.27580275229357,57.8864121238873,2926,3240,90.30864197530865,560,3044,3604,5166,1357,180,2487,1935,18663
Stephen Graham,6.0,2006 - 2011,SG,241,2920,378,852,44.36619718309859,53,173,30.63583815028902,325,679,47.864506627393226,47.47652582159624,157,205,76.58536585365854,77,347,424,118,58,19,156,353,966
Stephen Howard,4.0,1993 - 1998,SF,135,824,121,256,47.265625,0,0,,121,256,47.265625,47.265625,117,183,63.934426229508205,74,110,184,25,39,28,62,159,359
Stephen Jackson,14.0,2001 - 2014,SF,930,29817,4935,11932,41.359369761984574,1371,4098,33.45534407027819,3564,7834,45.494000510594844,47.10442507542742,2738,3426,79.91827203736136,722,2869,3591,2827,1207,345,2334,2248,13979
Stephen Thompson,1.0,1992 - 1992,SG,19,91,14,37,37.83783783783784,0,1,0.0,14,36,38.88888888888889,37.83783783783784,3,8,37.5,11,8,19,8,6,3,5,9,31
Stephen Zimmerman,1.0,2017 - 2017,C,19,108,10,31,32.25806451612903,0,0,,10,31,32.25806451612903,32.25806451612903,3,5,60.0,11,24,35,4,2,5,3,17,23
Stephon Marbury,13.0,1997 - 2009,PG,878,32829,5919,13746,43.05979921431689,1018,3147,32.34826819192882,4901,10599,46.24021134069252,46.762694602066055,3843,4904,78.36460032626428,599,1999,2598,6617,1051,121,2621,2089,16699
Sterling Brown,2.0,2018 - 2019,SG,115,1823,230,522,44.06130268199234,86,241,35.684647302904565,144,281,51.245551601423486,52.29885057471264,50,66,75.75757575757575,57,272,329,109,57,21,71,170,596
Steve Alford,4.0,1988 - 1991,PG,182,1747,311,682,45.60117302052786,41,125,32.800000000000004,270,557,48.473967684021545,48.60703812316716,135,155,87.09677419354838,29,124,153,191,88,10,94,124,798
Steve Bardo,3.0,1992 - 1996,SG,33,299,28,85,32.94117647058823,1,10,10.0,27,75,36.0,33.52941176470588,16,23,69.56521739130434,13,47,60,44,12,4,22,45,73
Steve Blake,13.0,2004 - 2016,PG,923,21908,2149,5366,40.048453224002984,1089,2843,38.30460780865283,1060,2523,42.01347602061038,50.1956764815505,517,666,77.62762762762763,265,1655,1920,3580,612,69,1275,1359,5904
Steve Bucknall,1.0,1990 - 1990,SG,18,75,9,33,27.27272727272727,0,1,0.0,9,32,28.125,27.27272727272727,5,6,83.33333333333334,5,2,7,10,2,1,11,10,23
Steve Burtt,4.0,1985 - 1993,SG,109,1225,234,550,42.54545454545455,2,16,12.5,232,534,43.445692883895134,42.72727272727273,164,231,70.995670995671,31,73,104,137,54,13,118,213,634
Steve Colter,8.0,1985 - 1995,PG,550,9977,1363,3035,44.90939044481054,79,276,28.6231884057971,1284,2759,46.53860094237042,46.21087314662273,666,860,77.44186046511628,310,788,1098,1559,477,80,555,946,3471
Steve Francis,9.0,2000 - 2008,PG,581,21854,3573,8337,42.857142857142854,582,1701,34.21516754850088,2991,6636,45.072332730560575,46.34760705289673,2814,3534,79.62648556876061,966,2291,3257,3511,853,224,2051,1831,10542
Steve Goodrich,2.0,2001 - 2002,SF,21,183,9,28,32.142857142857146,1,3,33.33333333333333,8,25,32.0,33.92857142857143,5,9,55.55555555555556,8,18,26,11,3,3,11,24,24
Steve Hamer,1.0,1997 - 1997,C,35,268,30,57,52.63157894736842,0,2,0.0,30,55,54.54545454545454,52.63157894736842,16,29,55.172413793103445,17,43,60,7,2,4,13,39,76
Steve Harris,5.0,1986 - 1990,SG,231,3014,622,1435,43.34494773519164,1,21,4.761904761904762,621,1414,43.91796322489392,43.37979094076655,262,314,83.43949044585987,162,220,382,245,123,32,174,283,1507
Steve Hayes,5.0,1982 - 1986,C,213,2297,234,484,48.34710743801653,0,1,0.0,234,483,48.4472049689441,48.34710743801653,79,158,50.0,203,324,527,85,32,102,99,438,547
Steve Henson,7.0,1991 - 1999,PG,244,2369,263,652,40.33742331288344,109,251,43.42629482071713,154,401,38.403990024937656,48.69631901840491,129,149,86.57718120805369,47,136,183,473,93,2,183,290,764
Steve Johnson,10.0,1982 - 1991,C,639,13864,2878,5056,56.92246835443038,0,4,0.0,2878,5052,56.96753760886778,56.92246835443038,1700,2681,63.409175680716146,1216,2291,3507,783,294,532,1497,2449,7456
Steve Kerr,15.0,1989 - 2003,PG,1038,18204,2234,4714,47.39075095460331,810,1826,44.359255202628695,1424,2888,49.307479224376735,55.98218073822656,712,823,86.51275820170109,213,957,1170,1814,539,49,545,989,5990
Steve Lingenfelter,2.0,1983 - 1984,PF,10,67,5,7,71.42857142857143,0,0,,5,7,71.42857142857143,71.42857142857143,0,6,0.0,4,12,16,5,1,3,6,22,10
Steve Nash,18.0,1997 - 2014,PG,1337,42358,7070,14476,48.8394584139265,1863,4377,42.563399588759424,5207,10099,51.55956035251015,55.27424702956618,3456,3824,90.3765690376569,711,3353,4064,11396,965,116,3861,2221,19459
Steve Novak,11.0,2007 - 2017,SF,489,5844,765,1746,43.81443298969072,585,1359,43.04635761589404,180,387,46.51162790697674,60.567010309278345,100,114,87.71929824561403,74,544,618,133,92,40,84,385,2215
Steve Scheffler,7.0,1991 - 1997,C,193,972,128,233,54.93562231759657,1,5,20.0,127,228,55.70175438596491,55.15021459227468,92,124,74.19354838709677,89,111,200,29,34,8,35,135,349
Steve Smith,14.0,1992 - 2005,SG,1032,31757,5053,11527,43.836210635898325,1284,3553,36.13847452856741,3769,7974,47.26611487333835,49.4057430380845,3378,3991,84.64044099223253,1211,2117,3328,3117,803,304,1849,2499,14768
Steve Stipanovich,5.0,1984 - 1988,C,407,12740,2036,4198,48.49928537398761,10,57,17.543859649122805,2026,4141,48.92538034291234,48.618389709385426,1296,1630,79.50920245398773,778,2383,3161,941,418,382,781,1449,5378
Steven Adams,6.0,2014 - 2019,C,514,13768,2018,3416,59.07494145199064,0,8,0.0,2018,3408,59.213615023474176,59.07494145199064,826,1492,55.36193029490617,1736,2034,3770,502,438,515,698,1394,4862
Steven Hill,1.0,2009 - 2009,PF,1,2,1,1,100.0,0,0,,1,1,100.0,100.0,0,0,,2,1,3,0,0,0,0,0,2
Steven Hunter,8.0,2002 - 2010,C,424,6251,762,1367,55.74250182882224,0,1,0.0,762,1366,55.78330893118595,55.74250182882224,359,738,48.6449864498645,500,807,1307,83,50,443,258,691,1883
Steven Smith,1.0,2007 - 2007,PF,8,28,2,8,25.0,0,0,,2,8,25.0,25.0,1,2,50.0,1,5,6,0,1,0,2,4,5
Stevin Smith,1.0,1997 - 1997,SG,8,60,6,18,33.33333333333333,1,6,16.666666666666664,5,12,41.66666666666667,36.11111111111111,1,1,100.0,2,8,10,4,1,0,4,9,14
Stewart Granger,3.0,1984 - 1987,PG,80,996,123,297,41.41414141414141,4,17,23.52941176470588,119,280,42.5,42.08754208754209,66,89,74.15730337078652,15,63,78,173,33,1,91,127,316
Stojko Vrankovic,5.0,1991 - 1999,C,173,2063,199,417,47.721822541966425,0,0,,199,417,47.721822541966425,47.721822541966425,79,133,59.3984962406015,156,363,519,60,22,179,133,320,477
Stromile Swift,9.0,2001 - 2009,PF,554,10926,1734,3669,47.26083401471791,2,27,7.4074074074074066,1732,3642,47.55628775398133,47.28808939765604,1164,1665,69.90990990990991,898,1670,2568,279,358,689,695,1366,4634
Stuart Gray,7.0,1985 - 1991,C,393,3483,340,764,44.50261780104712,0,7,0.0,340,757,44.91413474240423,44.50261780104712,232,351,66.0968660968661,314,721,1035,148,65,133,246,651,912
Sun Yue,1.0,2009 - 2009,SG,10,28,3,11,27.27272727272727,0,6,0.0,3,5,60.0,27.27272727272727,0,0,,0,0,0,2,1,1,3,10,6
Sundiata Gaines,3.0,2010 - 2012,PG,118,1318,187,464,40.30172413793103,45,147,30.612244897959183,142,317,44.79495268138801,45.150862068965516,100,180,55.55555555555556,47,130,177,207,83,3,93,101,519
Sviatoslav Mykhailiuk,1.0,2019 - 2019,SF,42,440,46,140,32.857142857142854,29,89,32.58426966292135,17,51,33.33333333333333,43.214285714285715,12,20,60.0,9,27,36,37,14,1,21,25,133
Sylvester Gray,1.0,1989 - 1989,SF,55,1220,167,398,41.959798994974875,1,4,25.0,166,394,42.13197969543147,42.085427135678394,105,156,67.3076923076923,117,169,286,117,36,25,102,144,440
T.J. Ford,8.0,2004 - 2012,PG,447,12318,1915,4411,43.414191793244164,136,463,29.373650107991363,1779,3948,45.06079027355623,44.95579233733847,1055,1291,81.71959721146398,307,1077,1384,2586,511,57,1089,1009,5021
T.J. Leaf,2.0,2018 - 2019,PF,112,985,163,319,51.09717868338558,26,73,35.61643835616438,137,246,55.6910569105691,55.172413793103445,29,47,61.702127659574465,72,135,207,33,14,23,22,80,381
T.J. McConnell,4.0,2016 - 2019,PG,324,7070,909,1852,49.08207343412527,85,251,33.86454183266932,824,1601,51.46783260462211,51.37688984881209,162,212,76.41509433962264,153,774,927,1485,406,50,508,493,2065
T.J. Warren,5.0,2015 - 2019,SF,261,7234,1563,3143,49.72955774737512,156,459,33.98692810457516,1407,2684,52.42175856929955,52.21126312440344,472,616,76.62337662337663,379,699,1078,293,247,134,253,588,3754
Tahjere McCall,1.0,2019 - 2019,SG,1,8,2,3,66.66666666666666,0,1,0.0,2,2,100.0,66.66666666666666,0,1,0.0,0,1,1,0,0,0,0,2,4
Taj Gibson,10.0,2010 - 2019,PF,803,20512,3211,6273,51.18762952335406,22,107,20.5607476635514,3189,6166,51.719104768083035,51.36298421807748,1323,1867,70.86234600964113,1861,3181,5042,799,445,875,952,2061,7767
Tamar Slay,3.0,2003 - 2005,SG,78,540,75,211,35.54502369668246,14,51,27.450980392156865,61,160,38.125,38.862559241706165,16,28,57.14285714285714,24,48,72,31,27,4,41,72,180
Tang Hamilton,1.0,2002 - 2002,SF,9,98,10,19,52.63157894736842,0,1,0.0,10,18,55.55555555555556,52.63157894736842,0,1,0.0,6,12,18,5,4,0,2,10,20
Tarence Kinsey,3.0,2007 - 2009,SG,118,1351,187,414,45.169082125603865,23,71,32.3943661971831,164,343,47.8134110787172,47.94685990338164,118,144,81.94444444444444,43,106,149,53,69,1,72,104,515
Tarik Black,4.0,2015 - 2018,C,227,3338,440,802,54.862842892768086,2,14,14.285714285714285,438,788,55.58375634517766,54.98753117206982,195,335,58.2089552238806,395,642,1037,112,83,117,164,521,1077
Tariq Abdul-Wahad,6.0,1998 - 2003,SG,249,4985,744,1789,41.58747903856903,18,79,22.78481012658228,726,1710,42.45614035087719,42.09055338177753,392,553,70.88607594936708,303,514,817,277,188,87,313,499,1898
Tate George,4.0,1991 - 1995,PG,183,2085,306,747,40.963855421686745,1,14,7.142857142857142,305,733,41.60982264665758,41.03078982597055,142,175,81.14285714285714,66,117,183,339,80,12,162,191,755
Taurean Green,1.0,2008 - 2008,SG-PG,17,74,7,25,28.000000000000004,2,11,18.181818181818183,5,14,35.714285714285715,32.0,11,12,91.66666666666666,0,10,10,11,2,0,9,5,27
Taurean Waller-Prince,3.0,2017 - 2019,SF,202,5184,820,1906,43.02203567681007,336,888,37.83783783783784,484,1018,47.54420432220039,51.83630640083945,326,395,82.53164556962025,104,673,777,395,183,89,359,414,2302
Taylor Griffin,1.0,2010 - 2010,SF,8,32,4,10,40.0,0,2,0.0,4,8,50.0,40.0,2,4,50.0,0,2,2,1,0,2,1,4,10
Tayshaun Prince,14.0,2003 - 2016,SF,1157,36553,5201,11529,45.1123254401943,672,1850,36.32432432432432,4529,9679,46.79202396941833,48.02671523982999,1800,2373,75.85335018963337,1352,3712,5064,2774,680,586,1245,1495,12874
Tellis Frank,5.0,1988 - 1994,PF,264,4703,639,1456,43.887362637362635,0,4,0.0,639,1452,44.00826446280991,43.887362637362635,432,583,74.09948542024014,363,659,1022,276,158,95,326,795,1710
Terence Morris,3.0,2002 - 2006,SF,139,1934,209,514,40.66147859922179,22,112,19.642857142857142,187,402,46.517412935323385,42.80155642023346,32,45,71.11111111111111,123,254,377,93,35,49,81,126,472
Terence Stansbury,3.0,1985 - 1987,SG,192,2984,468,1055,44.360189573459714,24,107,22.429906542056074,444,948,46.835443037974684,45.497630331753555,240,308,77.92207792207793,76,201,277,390,119,20,248,483,1200
Terrance Ferguson,2.0,2018 - 2019,SG,138,2700,256,601,42.59567387687188,147,411,35.76642335766424,109,190,57.36842105263158,54.82529118136439,46,61,75.40983606557377,53,136,189,92,64,26,58,316,705
Terrance Roberson,1.0,2001 - 2001,SF,3,13,0,2,0.0,0,1,0.0,0,1,0.0,0.0,0,0,,0,1,1,1,0,0,2,3,0
Terrel Harris,2.0,2012 - 2013,SG,46,465,34,112,30.357142857142854,8,48,16.666666666666664,26,64,40.625,33.92857142857143,24,35,68.57142857142857,22,58,80,35,11,5,42,51,100
Terrell Brandon,11.0,1992 - 2002,PG,762,22491,4073,9081,44.8518885585288,410,1152,35.59027777777778,3663,7929,46.19750283768445,47.10934919061777,1836,2101,87.38695859114706,443,1853,2296,4570,1173,235,1486,1391,10392
Terrence Jones,6.0,2013 - 2019,PF,259,6136,1076,2176,49.44852941176471,96,335,28.65671641791045,980,1841,53.2319391634981,51.654411764705884,410,662,61.933534743202415,446,1021,1467,264,159,286,238,438,2658
Terrence Rencher,1.0,1996 - 1996,PG,36,405,33,100,33.0,9,29,31.03448275862069,24,71,33.80281690140845,37.5,31,46,67.3913043478261,9,35,44,54,16,2,43,37,106
Terrence Ross,7.0,2013 - 2019,SG,523,12542,1996,4746,42.05646860514117,922,2489,37.04298915226999,1074,2257,47.58529020824103,51.76991150442478,438,540,81.11111111111111,191,1227,1418,552,422,176,464,925,5352
Terrence Williams,4.0,2010 - 2013,SG,158,2970,439,1071,40.98972922502334,58,186,31.182795698924732,381,885,43.050847457627114,43.69747899159664,154,234,65.8119658119658,68,487,555,370,83,20,226,202,1090
Terry Catledge,8.0,1986 - 1993,PF,534,13977,2649,5480,48.33941605839416,3,33,9.090909090909092,2646,5447,48.577198457866714,48.36678832116788,1399,2146,65.19105312208761,1525,1895,3420,466,294,108,909,1333,6700
Terry Cummings,18.0,1983 - 2000,PF,1293,36857,8723,17979,48.5177151120752,45,160,28.125,8678,17819,48.700824962119086,48.64286111574615,3633,5146,70.5985231247571,3435,5937,9372,2363,1353,712,2371,4189,21124
Terry Davis,10.0,1990 - 2001,PF,480,10369,1202,2545,47.22986247544204,3,19,15.789473684210526,1199,2526,47.46634996041172,47.288801571709236,654,1081,60.49953746530989,1106,1781,2887,273,183,149,518,1176,3061
Terry Dehere,6.0,1994 - 1999,PG,404,7310,1082,2633,41.093809342954806,328,868,37.78801843317972,754,1765,42.71954674220963,47.322445879225214,743,954,77.88259958071279,145,444,589,1034,213,36,618,831,3235
Terry Dozier,1.0,1990 - 1990,SF,9,92,9,27,33.33333333333333,0,1,0.0,9,26,34.61538461538461,33.33333333333333,4,8,50.0,7,8,15,3,6,2,7,10,22
Terry Mills,11.0,1991 - 2001,PF,695,16831,2896,6349,45.61348243817924,550,1435,38.32752613240418,2346,4914,47.74114774114774,49.94487320837927,964,1239,77.8046811945117,1045,2708,3753,911,407,298,865,1949,7306
Terry Porter,17.0,1986 - 2002,PG,1398,39293,6048,13054,46.33062662785353,1448,3766,38.44928305894849,4600,9288,49.52627045650301,51.876819365711654,3870,4636,83.47713546160483,788,3455,4243,7784,1720,195,2902,2448,17414
Terry Rozier,4.0,2016 - 2019,PG,313,6505,904,2354,38.40271877655056,404,1141,35.40753724802805,500,1213,41.22011541632317,46.98385726423109,311,396,78.53535353535354,182,952,1134,778,236,65,248,379,2523
Terry Teagle,11.0,1983 - 1993,SG,732,15394,3498,7540,46.392572944297086,30,147,20.408163265306122,3468,7393,46.909238468821854,46.59151193633952,1451,1833,79.15984724495362,765,1136,1901,998,546,137,1059,1636,8477
Thabo Sefolosha,13.0,2007 - 2019,SG,920,20390,2035,4559,44.63698179425313,549,1591,34.50659962287869,1486,2968,50.06738544474394,50.65803904364993,704,957,73.5632183908046,663,2758,3421,1273,996,385,800,1523,5323
Thaddeus Young,12.0,2008 - 2019,PF,948,29050,5395,10797,49.96758358803371,416,1270,32.75590551181102,4979,9527,52.26199223260208,51.89404464203019,1318,1966,67.03967446592065,1964,3719,5683,1557,1364,384,1354,2092,12524
Thanasis Antetokounmpo,1.0,2016 - 2016,SF,2,6,3,4,75.0,0,1,0.0,3,3,100.0,75.0,0,0,,0,1,1,0,0,0,0,2,6
Tharon Mayes,1.0,1992 - 1992,SG,24,255,30,99,30.303030303030305,15,41,36.58536585365854,15,58,25.862068965517242,37.878787878787875,24,36,66.66666666666666,3,13,16,35,16,2,31,41,99
Theo Pinson,1.0,2019 - 2019,SG,18,211,25,73,34.24657534246575,12,46,26.08695652173913,13,27,48.148148148148145,42.465753424657535,19,22,86.36363636363636,4,32,36,21,6,0,18,15,81
Theo Ratliff,16.0,1996 - 2011,C,854,21373,2296,4630,49.58963282937365,0,2,0.0,2296,4628,49.611063094209165,49.58963282937365,1449,2049,70.71742313323573,1616,3168,4784,483,413,2035,1038,2409,6041
Theron Smith,2.0,2004 - 2005,SF,53,688,60,179,33.5195530726257,9,24,37.5,51,155,32.903225806451616,36.03351955307262,20,24,83.33333333333334,52,105,157,35,11,9,41,76,149
Thomas Bryant,2.0,2018 - 2019,C,87,1568,317,523,60.61185468451242,34,109,31.19266055045872,283,414,68.35748792270532,63.862332695984705,112,146,76.71232876712328,116,355,471,98,26,69,62,132,780
Thomas Gardner,2.0,2008 - 2009,SG,23,162,23,72,31.944444444444443,10,41,24.390243902439025,13,31,41.935483870967744,38.88888888888889,3,7,42.857142857142854,3,10,13,5,5,1,7,12,59
Thomas Hamilton,2.0,1996 - 2000,C,33,343,44,110,40.0,0,0,,44,110,40.0,40.0,19,41,46.34146341463415,41,71,112,16,4,23,37,37,107
Thomas Jordan,1.0,1993 - 1993,PF,4,106,18,41,43.90243902439025,0,0,,18,41,43.90243902439025,43.90243902439025,8,17,47.05882352941176,5,14,19,3,3,5,12,14,44
Thomas Robinson,5.0,2013 - 2017,PF,324,4326,653,1392,46.910919540229884,0,6,0.0,653,1386,47.113997113997115,46.910919540229884,254,498,51.00401606425703,552,983,1535,196,166,116,324,569,1560
Thomas Welsh,1.0,2019 - 2019,C,11,36,7,13,53.84615384615385,3,7,42.857142857142854,4,6,66.66666666666666,65.38461538461539,1,2,50.0,0,4,4,5,0,0,1,3,18
Thon Maker,3.0,2017 - 2019,C,207,3018,345,824,41.86893203883495,116,361,32.13296398891966,229,463,49.46004319654428,48.907766990291265,167,244,68.44262295081968,170,413,583,131,76,152,106,386,973
Thurl Bailey,12.0,1984 - 1999,PF,997,26990,5117,10867,47.0875126529861,4,39,10.256410256410255,5113,10828,47.220169929811604,47.10591699641115,2525,3104,81.34664948453609,1420,3680,5100,1396,465,1168,1553,2039,12763
Tiago Splitter,7.0,2011 - 2017,C,420,8057,1228,2203,55.742169768497504,2,16,12.5,1226,2187,56.05852766346594,55.78756241488879,767,1127,68.05678793256433,670,1388,2058,512,241,240,444,829,3225
Tibor Pleiss,1.0,2016 - 2016,C,12,82,11,25,44.0,0,2,0.0,11,23,47.82608695652174,44.0,2,2,100.0,6,9,15,2,1,2,8,19,24
Tierre Brown,4.0,2002 - 2005,PG,134,1654,202,526,38.40304182509506,30,85,35.294117647058826,172,441,39.002267573696145,41.254752851711025,93,121,76.85950413223141,41,125,166,266,64,4,143,95,527
Tim Breaux,3.0,1995 - 1998,SF,102,940,108,293,36.86006825938566,22,74,29.72972972972973,86,219,39.26940639269406,40.61433447098976,61,96,63.541666666666664,38,58,96,41,24,13,47,68,299
Tim Duncan,19.0,1998 - 2016,C,1643,56738,12260,24273,50.50879578132081,35,203,17.24137931034483,12225,24070,50.78936435396759,50.58089234952416,7113,10234,69.50361539964824,4637,13313,17950,4989,1193,3588,4014,4005,31668
Tim Frazier,5.0,2015 - 2019,PG,249,4472,464,1129,41.09831709477413,115,350,32.857142857142854,349,779,44.801026957637994,46.191319751992914,225,308,73.05194805194806,125,470,595,1002,175,20,325,443,1268
Tim Hardaway,19.0,1990 - 2019,PG,1341,43481,7855,18451,42.572218307950784,2405,6903,34.83992467043315,5450,11548,47.1943193626602,49.089480244973174,3565,4530,78.69757174392936,718,3367,4085,8231,1775,200,3114,2842,21680
Tim James,3.0,2000 - 2002,SF,43,261,26,79,32.91139240506329,1,3,33.33333333333333,25,76,32.89473684210527,33.54430379746836,15,23,65.21739130434783,23,23,46,11,2,9,13,33,68
Tim Kempton,8.0,1987 - 1998,PF,286,3879,475,987,48.12563323201621,0,3,0.0,475,984,48.27235772357724,48.12563323201621,353,517,68.27852998065764,252,564,816,319,124,44,295,620,1303
Tim Legler,10.0,1990 - 2000,SG,313,5272,762,1707,44.63971880492091,260,604,43.04635761589404,502,1103,45.51223934723481,52.25541886350322,399,476,83.82352941176471,128,354,482,404,149,41,194,511,2183
Tim McCormick,8.0,1985 - 1992,C,498,10604,1569,2942,53.33106730115568,1,17,5.88235294117647,1568,2925,53.60683760683761,53.34806254248811,950,1348,70.47477744807121,788,1635,2423,497,143,191,626,1291,4089
Tim Ohlbrecht,1.0,2013 - 2013,C,3,12,1,3,33.33333333333333,0,0,,1,3,33.33333333333333,33.33333333333333,1,1,100.0,0,1,1,1,1,0,4,1,3
Tim Perry,8.0,1989 - 1996,PF,504,9738,1366,2802,48.75089221984297,92,289,31.833910034602077,1274,2513,50.69637883008357,50.39257673090649,596,924,64.5021645021645,750,1223,1973,449,229,427,511,844,3420
Tim Quarterman,2.0,2017 - 2018,SG,21,100,15,34,44.11764705882353,6,17,35.294117647058826,9,17,52.94117647058824,52.94117647058824,2,5,40.0,4,13,17,13,2,3,13,8,38
Tim Thomas,13.0,1998 - 2010,SF,879,22881,3710,8460,43.85342789598109,1050,2811,37.353255069370334,2660,5649,47.08798017348203,50.05910165484634,1715,2259,75.91854803010182,864,2795,3659,1348,641,329,1277,2464,10185
Tim Young,1.0,2000 - 2000,C,25,137,13,39,33.33333333333333,0,0,,13,39,33.33333333333333,33.33333333333333,28,36,77.77777777777779,13,22,35,5,2,1,9,18,54
Timofey Mozgov,8.0,2011 - 2018,C,494,8885,1322,2489,53.11370028123744,11,58,18.96551724137931,1311,2431,53.92842451665981,53.334672559260746,672,907,74.090407938258,841,1574,2415,268,152,428,577,1087,3327
Timothe Luwawu-Cabarrot,3.0,2017 - 2019,SF,171,2666,327,846,38.652482269503544,139,435,31.95402298850575,188,411,45.742092457420924,46.867612293144205,182,222,81.98198198198197,50,268,318,155,63,23,132,324,975
Tito Horford,3.0,1989 - 1994,C,65,378,34,111,30.630630630630627,0,0,,34,111,30.630630630630627,30.630630630630627,27,43,62.7906976744186,29,55,84,5,7,26,30,50,95
Tito Maddox,1.0,2003 - 2003,SG,9,35,3,12,25.0,0,3,0.0,3,9,33.33333333333333,25.0,5,8,62.5,1,6,7,5,3,1,3,4,11
Tobias Harris,8.0,2012 - 2019,PF,550,16748,3208,6819,47.04502126411497,691,1899,36.38757240652975,2517,4920,51.15853658536585,52.11174659040915,1386,1685,82.25519287833828,556,2732,3288,1041,405,265,756,1087,8493
Toby Bailey,2.0,1999 - 2000,SG,78,713,93,230,40.43478260869565,3,15,20.0,90,215,41.86046511627907,41.08695652173913,56,82,68.29268292682927,51,77,128,45,22,6,35,80,245
Tod Murphy,5.0,1988 - 1994,PF,191,4071,396,872,45.412844036697244,18,62,29.03225806451613,378,810,46.666666666666664,46.44495412844037,239,352,67.89772727272727,340,601,941,183,113,88,112,382,1049
Todd Day,8.0,1993 - 2001,SG,492,12314,2052,5052,40.61757719714964,573,1662,34.47653429602888,1479,3390,43.6283185840708,46.288598574821854,1282,1737,73.80541162924582,584,1075,1659,717,536,292,721,1372,5959
Todd Fuller,5.0,1997 - 2001,C,235,2605,327,778,42.030848329048844,0,4,0.0,327,774,42.248062015503876,42.030848329048844,207,311,66.55948553054662,248,454,702,46,34,62,151,372,861
Todd Lichti,5.0,1990 - 1994,SG,240,4310,748,1624,46.05911330049261,19,79,24.050632911392405,729,1545,47.18446601941748,46.64408866995074,399,507,78.69822485207101,182,341,523,334,180,45,262,423,1914
Todd MacCulloch,4.0,2000 - 2003,C,266,3956,646,1196,54.0133779264214,0,0,,646,1196,54.0133779264214,54.0133779264214,264,410,64.39024390243902,404,626,1030,139,66,207,181,545,1556
Todd Mitchell,1.0,1989 - 1989,SF,24,353,43,97,44.329896907216494,0,0,,43,97,44.329896907216494,44.329896907216494,37,64,57.8125,18,32,50,21,16,2,33,51,123
Todd Mundt,1.0,1996 - 1996,C,33,151,16,41,39.02439024390244,0,0,,16,41,39.02439024390244,39.02439024390244,5,8,62.5,11,17,28,3,2,5,3,29,37
Tom Chambers,16.0,1982 - 1998,PF,1215,36983,7985,17129,46.6168486193006,254,829,30.639324487334136,7731,16300,47.42944785276074,47.35828127736587,5487,6783,80.89340999557719,2080,5192,7272,2466,947,695,2757,4101,21711
Tom Copa,1.0,1992 - 1992,C,33,132,22,40,55.00000000000001,0,0,,22,40,55.00000000000001,55.00000000000001,4,13,30.76923076923077,14,22,36,3,2,6,8,29,48
Tom Garrick,4.0,1989 - 1992,SG,251,4718,543,1159,46.85073339085418,5,60,8.333333333333332,538,1099,48.95359417652411,47.066436583261435,268,346,77.45664739884393,123,378,501,853,266,22,343,447,1359
Tom Gugliotta,13.0,1993 - 2005,PF,775,23891,3917,8701,45.01781404436272,211,736,28.668478260869566,3706,7965,46.52856246076585,46.23031835421216,1965,2599,75.60600230858022,1607,4040,5647,2166,1098,498,1754,1918,10010
Tom Hammonds,12.0,1990 - 2001,PF,708,10645,1433,2991,47.910397860247414,0,11,0.0,1433,2980,48.08724832214765,47.910397860247414,820,1186,69.13996627318718,751,1536,2287,383,167,139,539,1284,3686
Tom Hovasse,1.0,1995 - 1995,SF,2,4,0,1,0.0,0,1,0.0,0,0,,0.0,0,0,,0,0,0,0,1,0,0,1,0
Tom Piotrowski,1.0,1984 - 1984,C,18,78,12,26,46.15384615384615,0,0,,12,26,46.15384615384615,46.15384615384615,6,6,100.0,6,10,16,5,1,3,6,22,30
Tom Scheffler,1.0,1985 - 1985,C,42,278,23,54,42.592592592592595,0,0,,23,54,42.592592592592595,42.592592592592595,13,24,54.166666666666664,21,60,81,11,9,11,16,48,59
Tom Sewell,1.0,1985 - 1985,SG,21,87,9,36,25.0,0,2,0.0,9,34,26.47058823529412,25.0,2,4,50.0,2,2,4,6,3,1,7,13,20
Tom Sluby,1.0,1985 - 1985,SG,31,151,30,58,51.724137931034484,0,2,0.0,30,56,53.57142857142857,51.724137931034484,13,21,61.904761904761905,5,7,12,16,3,0,11,18,73
Tom Tolbert,7.0,1989 - 1995,PF,321,5796,771,1680,45.89285714285714,30,101,29.7029702970297,741,1579,46.928435718809375,46.785714285714285,490,691,70.91172214182345,406,863,1269,293,119,113,351,770,2062
Tomas Satoransky,3.0,2017 - 2019,SG,226,4622,524,1080,48.51851851851852,120,303,39.603960396039604,404,777,51.994851994852,54.074074074074076,234,298,78.52348993288591,185,424,609,786,161,34,246,371,1402
Toney Douglas,8.0,2010 - 2017,PG,409,7660,1112,2756,40.34833091436865,454,1280,35.46875,658,1476,44.579945799457995,48.58490566037736,386,468,82.47863247863248,216,676,892,904,351,30,415,790,3064
Toni Kukoc,13.0,1994 - 2006,SF,945,24876,4019,9005,44.630760688506385,839,2500,33.56,3180,6505,48.88547271329746,49.28928373126041,1997,2751,72.59178480552526,1120,2822,3942,3436,912,319,1685,1680,10874
Tony Allen,14.0,2005 - 2018,SG,932,20206,2844,6020,47.24252491694352,130,491,26.476578411405292,2714,5529,49.08663411105083,48.32225913621262,1504,2120,70.94339622641509,1143,2074,3217,1182,1295,384,1232,2204,7322
Tony Battie,14.0,1998 - 2012,C,893,18558,2247,4598,48.86907351022183,12,77,15.584415584415584,2235,4521,49.43596549435966,48.99956502827316,806,1177,68.47918436703483,1440,3063,4503,543,434,763,725,2325,5312
Tony Bennett,3.0,1993 - 1995,PG,160,1972,233,561,41.53297682709447,59,172,34.30232558139535,174,389,44.73007712082262,46.79144385026738,43,58,74.13793103448276,29,135,164,316,71,2,98,208,568
Tony Bobbitt,1.0,2005 - 2005,SG,2,12,2,5,40.0,1,2,50.0,1,3,33.33333333333333,50.0,0,0,,0,3,3,0,0,0,0,1,5
Tony Bradley,2.0,2018 - 2019,C,13,67,12,29,41.37931034482759,0,1,0.0,12,28,42.857142857142854,41.37931034482759,3,4,75.0,14,13,27,2,2,2,3,7,27
Tony Brown,7.0,1985 - 1992,SF,377,6139,871,1997,43.615423134702056,39,147,26.53061224489796,832,1850,44.972972972972975,44.59188783174762,414,577,71.75043327556327,356,422,778,572,238,40,394,768,2195
Tony Campbell,11.0,1985 - 1995,SF,728,15488,3235,7097,45.58264055234606,71,273,26.00732600732601,3164,6824,46.36576787807737,46.082851909257435,1613,2046,78.83675464320625,923,1231,2154,1034,590,158,1104,1595,8154
Tony Dawson,2.0,1991 - 1995,SF,6,30,7,15,46.666666666666664,2,4,50.0,5,11,45.45454545454545,53.333333333333336,1,1,100.0,2,3,5,1,0,0,3,4,17
Tony Delk,10.0,1997 - 2006,PG,598,12740,2019,4934,40.92014592622618,522,1501,34.77681545636243,1497,3433,43.60617535683076,46.20997162545602,803,1046,76.76864244741873,387,1108,1495,1103,482,86,620,941,5363
Tony Dumas,4.0,1995 - 1998,SG,156,2222,409,1013,40.375123395853905,102,312,32.69230769230769,307,701,43.794579172610554,45.409674234945705,220,362,60.773480662983424,94,104,198,186,65,19,148,256,1140
Tony Farmer,2.0,1998 - 2000,PF,101,1368,144,365,39.45205479452055,10,53,18.867924528301888,134,312,42.94871794871795,40.821917808219176,234,304,76.97368421052632,134,193,327,79,76,20,91,190,532
Tony Fuller,1.0,1981 - 1981,SG,15,248,24,66,36.36363636363637,0,1,0.0,24,65,36.92307692307693,36.36363636363637,12,16,75.0,13,29,42,28,10,1,23,25,60
Tony Harris,3.0,1991 - 1995,SG,14,147,16,55,29.09090909090909,3,12,25.0,13,43,30.23255813953488,31.818181818181817,33,38,86.8421052631579,3,8,11,8,5,0,10,15,68
Tony Jackson,1.0,1981 - 1981,PG,2,14,1,3,33.33333333333333,0,0,,1,3,33.33333333333333,33.33333333333333,0,0,,0,2,2,2,2,0,0,1,2
Tony Massenburg,13.0,1991 - 2005,PF,698,12390,1649,3511,46.966676160637995,1,11,9.090909090909092,1648,3500,47.08571428571429,46.980917117630305,967,1374,70.37845705967976,1065,1931,2996,268,261,326,690,1618,4266
Tony Mitchell,1.0,2014 - 2014,PF,21,79,5,12,41.66666666666667,1,1,100.0,4,11,36.36363636363637,45.83333333333333,11,19,57.89473684210527,15,11,26,2,6,3,4,9,22
Tony Parker,18.0,2002 - 2019,PG,1480,46037,9390,19331,48.574827996482334,638,1988,32.09255533199195,8752,17343,50.46416421611024,50.22502715845015,4100,5483,74.77658216304943,549,3513,4062,8179,1251,117,3459,2488,23518
Tony Price,1.0,1981 - 1981,SG,5,29,2,7,28.57142857142857,0,0,,2,7,28.57142857142857,28.57142857142857,0,0,,0,0,0,3,2,1,2,3,4
Tony Smith,9.0,1991 - 2001,SG,484,7545,1051,2443,43.02087597216537,129,418,30.861244019138756,922,2025,45.53086419753086,45.661072451903394,360,525,68.57142857142857,337,419,756,903,330,80,464,751,2591
Tony Snell,6.0,2014 - 2019,SG,471,10142,1054,2494,42.26142742582197,549,1441,38.09854267869535,505,1053,47.95821462488129,53.26784282277466,231,281,82.20640569395017,133,962,1095,476,210,112,269,645,2888
Tony White,1.0,1988 - 1988,PG,49,581,111,249,44.57831325301205,0,6,0.0,111,243,45.67901234567901,44.57831325301205,39,54,72.22222222222221,12,19,31,59,20,2,47,57,261
Tony Wroten,4.0,2013 - 2016,PG,151,3093,577,1404,41.096866096866094,84,365,23.013698630136986,493,1039,47.44947064485082,44.08831908831909,374,576,64.93055555555556,107,260,367,439,138,28,377,269,1612
Torgeir Bryn,1.0,1990 - 1990,C,3,10,0,2,0.0,0,0,,0,2,0.0,0.0,4,6,66.66666666666666,0,2,2,0,2,1,1,5,4
Tornike Shengelia,2.0,2013 - 2014,SF,45,247,23,51,45.09803921568628,1,8,12.5,22,43,51.162790697674424,46.07843137254902,12,24,50.0,13,26,39,17,6,2,23,29,59
Torraye Braggs,2.0,2004 - 2005,PF,22,178,19,40,47.5,0,0,,19,40,47.5,47.5,8,12,66.66666666666666,25,26,51,7,4,2,15,33,46
Torrey Craig,2.0,2018 - 2019,SF,114,2132,222,499,44.48897795591182,78,246,31.70731707317073,144,253,56.916996047430835,52.30460921843687,71,105,67.61904761904762,129,261,390,97,49,61,64,238,593
Toure' Murry,2.0,2014 - 2015,PG,56,391,58,134,43.28358208955223,5,12,41.66666666666667,53,122,43.44262295081967,45.149253731343286,25,41,60.97560975609756,14,31,45,50,20,1,38,48,146
Tracy Jackson,3.0,1982 - 1984,SG,129,1797,279,602,46.34551495016611,2,13,15.384615384615385,277,589,47.02886247877759,46.51162790697674,134,179,74.86033519553072,123,120,243,132,78,14,108,183,694
Tracy McGrady,15.0,1998 - 2012,SG,988,32382,7106,16346,43.472409152086136,1137,3391,33.52993217340018,5969,12955,46.074874565804706,46.95032423834577,4141,5544,74.69336219336219,1363,4199,5562,4410,1189,854,2163,1754,19490
Tracy Moore,5.0,1992 - 1997,SG,119,1729,298,738,40.37940379403794,77,224,34.375,221,514,42.996108949416346,45.59620596205962,160,191,83.7696335078534,75,108,183,121,62,8,98,186,833
Tracy Murray,12.0,1993 - 2004,SF,666,12206,2202,5109,43.10041103934233,758,1955,38.77237851662404,1444,3154,45.78313253012048,50.518692503425335,844,1016,83.07086614173228,511,1150,1661,511,367,163,605,1113,6006
Trae Young,1.0,2019 - 2019,PG,81,2503,525,1256,41.79936305732484,156,482,32.365145228215766,369,774,47.674418604651166,48.009554140127385,343,414,82.85024154589372,64,237,301,653,72,15,308,140,1549
Trajan Langdon,3.0,2000 - 2002,SG,119,1738,220,529,41.58790170132325,86,217,39.63133640552996,134,312,42.94871794871795,49.7164461247637,121,133,90.97744360902256,29,130,159,152,56,14,98,179,647
Travis Best,10.0,1996 - 2005,PG,771,16372,2159,5022,42.99084030266826,289,848,34.08018867924528,1870,4174,44.80114997604217,45.86818000796495,1211,1444,83.86426592797784,264,1111,1375,2617,706,68,1005,1781,5818
Travis Diener,5.0,2006 - 2010,PG,181,2667,298,768,38.80208333333333,164,465,35.26881720430107,134,303,44.224422442244226,49.47916666666667,94,111,84.68468468468468,39,204,243,434,76,9,99,200,854
Travis Hansen,1.0,2004 - 2004,SF,41,507,46,130,35.38461538461539,9,30,30.0,37,100,37.0,38.84615384615385,22,27,81.48148148148148,30,40,70,19,10,9,15,67,123
Travis Knight,7.0,1997 - 2003,C,398,4718,539,1220,44.18032786885246,15,58,25.862068965517242,524,1162,45.09466437177281,44.795081967213115,223,324,68.82716049382715,447,741,1188,228,140,226,255,845,1316
Travis Leslie,1.0,2012 - 2012,SG,10,45,5,14,35.714285714285715,0,0,,5,14,35.714285714285715,35.714285714285715,4,9,44.44444444444444,6,3,9,5,2,2,2,4,14
Travis Mays,3.0,1991 - 1993,PG,116,2984,431,1051,41.008563273073264,104,288,36.11111111111111,327,763,42.857142857142854,45.956232159847765,311,415,74.93975903614458,75,159,234,326,102,14,214,235,1277
Travis Outlaw,11.0,2004 - 2014,SF,628,13196,2015,4779,42.163632559112784,348,1037,33.55834136933462,1667,3742,44.548369855692144,45.80456162377066,949,1277,74.31480031323414,482,1510,1992,517,336,385,517,1045,5327
Travis Wear,2.0,2015 - 2018,SF,68,900,109,281,38.79003558718861,28,77,36.36363636363637,81,204,39.705882352941174,43.77224199288256,28,34,82.35294117647058,31,113,144,47,19,16,41,85,274
Travis Williams,2.0,1998 - 1999,SF,51,445,63,135,46.666666666666664,0,1,0.0,63,134,47.01492537313433,46.666666666666664,30,54,55.55555555555556,60,56,116,22,21,7,36,68,156
Tremaine Fowlkes,4.0,2002 - 2005,SF,103,1233,105,257,40.856031128404666,4,20,20.0,101,237,42.616033755274266,41.63424124513619,87,110,79.0909090909091,94,134,228,54,47,6,50,146,301
Trent Tucker,11.0,1983 - 1993,SG,822,16730,2736,5948,45.998655010087425,625,1530,40.849673202614376,2111,4418,47.7818017202354,51.25252185608608,503,670,75.07462686567165,542,1072,1614,1632,723,93,631,1701,6600
Trenton Hassell,9.0,2002 - 2010,SG,662,16750,1611,3599,44.76243400944707,96,301,31.893687707641195,1515,3298,45.936931473620376,46.096137816060015,561,732,76.63934426229508,562,1308,1870,1159,292,279,613,1441,3879
Treveon Graham,3.0,2017 - 2019,SG,125,1954,179,452,39.60176991150443,87,240,36.25,92,212,43.39622641509434,49.22566371681416,69,96,71.875,70,180,250,99,52,10,47,195,514
Trevon Duval,1.0,2019 - 2019,PG,3,6,2,3,66.66666666666666,1,1,100.0,1,2,50.0,83.33333333333334,0,0,,0,1,1,2,0,0,0,0,5
Trevor Ariza,15.0,2005 - 2019,SF,1113,33450,4231,10009,42.271955240283745,1620,4596,35.24804177545692,2611,5413,48.23572880103455,50.364671795384155,1765,2426,72.75350370981039,1110,4279,5389,2398,1654,341,1503,2286,11847
Trevor Booker,8.0,2011 - 2018,PF,548,11082,1567,3042,51.51216305062459,75,249,30.120481927710845,1492,2793,53.41926244181884,52.744904667981594,518,812,63.793103448275865,1050,1939,2989,574,358,287,544,1100,3727
Trevor Ruffin,2.0,1995 - 1996,PG,115,1881,351,853,41.14888628370457,143,387,36.95090439276486,208,466,44.63519313304721,49.53106682297773,176,225,78.22222222222223,29,129,158,319,58,4,196,184,1021
Trevor Wilson,4.0,1991 - 1996,PF,103,1609,236,518,45.559845559845556,0,4,0.0,236,514,45.91439688715953,45.559845559845556,119,210,56.666666666666664,153,200,353,99,50,14,117,157,591
Trevor Winter,1.0,1999 - 1999,C,1,5,0,0,,0,0,,0,0,,,0,0,,1,2,3,0,0,0,0,5,0
Trey Burke,6.0,2014 - 2019,PG,364,8549,1518,3727,40.72980949825597,448,1318,33.99089529590288,1070,2409,44.4167704441677,46.740005366246315,440,550,80.0,134,607,741,1306,210,43,475,507,3924
Trey Gilder,1.0,2010 - 2010,SF,2,5,1,1,100.0,0,0,,1,1,100.0,100.0,0,0,,0,1,1,0,1,0,0,0,2
Trey Johnson,3.0,2009 - 2012,SG,26,181,21,57,36.84210526315789,1,4,25.0,20,53,37.735849056603776,37.719298245614034,19,21,90.47619047619048,6,18,24,16,2,1,11,28,62
Trey Lyles,4.0,2016 - 2019,PF,290,5061,830,1927,43.07213284898806,249,753,33.067729083665334,581,1174,49.48892674616695,49.53295277633627,296,420,70.47619047619048,206,923,1129,307,113,95,259,416,2205
Trey McKinney-Jones,1.0,2018 - 2018,SG,1,1,0,0,,0,0,,0,0,,,0,0,,0,0,0,0,0,0,0,0,0
Trey Thompkins,1.0,2012 - 2012,C,24,119,24,61,39.34426229508197,4,13,30.76923076923077,20,48,41.66666666666667,42.62295081967213,5,7,71.42857142857143,4,20,24,3,3,3,6,10,57
Tristan Thompson,8.0,2012 - 2019,PF,640,17978,2280,4359,52.30557467309016,0,10,0.0,2280,4349,52.4258450218441,52.30557467309016,1193,1952,61.11680327868852,2176,3306,5482,565,308,460,679,1481,5753
Troy Bell,1.0,2004 - 2004,PG,6,34,4,18,22.22222222222222,0,4,0.0,4,14,28.57142857142857,22.22222222222222,3,3,100.0,3,1,4,4,1,0,6,6,11
Troy Brown,1.0,2019 - 2019,SF,52,730,97,234,41.452991452991455,22,69,31.88405797101449,75,165,45.45454545454545,46.15384615384615,32,47,68.08510638297872,35,110,145,80,21,5,30,56,248
Troy Caupain,1.0,2019 - 2019,PG,4,16,4,8,50.0,2,3,66.66666666666666,2,5,40.0,62.5,0,0,,1,2,3,4,1,0,0,0,10
Troy Daniels,6.0,2014 - 2019,SG,306,4667,708,1762,40.18161180476731,520,1299,40.03079291762894,188,463,40.60475161987041,54.937570942111236,138,168,82.14285714285714,66,344,410,171,93,18,179,405,2074
Troy Hudson,11.0,1998 - 2008,PG,531,11663,1782,4453,40.0179654165731,469,1380,33.98550724637681,1313,3073,42.72697689554182,45.28407814956209,813,942,86.30573248407643,199,703,902,1796,282,30,845,702,4846
Troy Murphy,12.0,2002 - 2013,PF,734,19939,2849,6401,44.50867052023121,614,1579,38.88537048765041,2235,4822,46.350062214848606,49.30479612560538,1551,1977,78.45220030349014,1374,4338,5712,1088,478,294,888,1890,7863
Troy Williams,3.0,2017 - 2019,SF,77,1195,168,383,43.86422976501306,43,149,28.859060402684566,125,234,53.41880341880342,49.47780678851175,51,79,64.55696202531645,51,147,198,53,57,22,62,131,430
Ty Lawson,8.0,2010 - 2017,PG,587,17021,2656,5773,46.00727524683873,500,1400,35.714285714285715,2156,4373,49.30253830322433,50.337779317512556,1596,2070,77.10144927536233,374,1215,1589,3466,670,54,1203,964,7408
Tyler Cavanaugh,2.0,2018 - 2019,PF,50,557,70,162,43.20987654320987,33,94,35.1063829787234,37,68,54.41176470588235,53.39506172839506,19,23,82.6086956521739,48,87,135,28,9,4,15,64,192
Tyler Davis,1.0,2019 - 2019,C,1,1,0,1,0.0,0,0,,0,1,0.0,0.0,0,0,,1,0,1,0,0,0,0,0,0
Tyler Dorsey,2.0,2018 - 2019,SG,104,1672,251,646,38.85448916408669,116,331,35.04531722054381,135,315,42.857142857142854,47.8328173374613,83,124,66.93548387096774,44,199,243,135,31,7,64,116,701
Tyler Ennis,4.0,2015 - 2018,PG,187,2352,322,772,41.70984455958549,67,213,31.455399061032864,255,559,45.61717352415027,46.04922279792746,73,95,76.84210526315789,51,203,254,362,98,18,171,234,784
Tyler Hansbrough,7.0,2010 - 2016,PF,472,7885,1012,2336,43.321917808219176,3,22,13.636363636363635,1009,2314,43.604148660328434,43.3861301369863,1048,1426,73.492286115007,809,1134,1943,201,226,95,355,961,3075
Tyler Honeycutt,2.0,2012 - 2013,SF,24,120,11,35,31.428571428571427,1,5,20.0,10,30,33.33333333333333,32.857142857142854,5,7,71.42857142857143,6,18,24,9,4,4,7,5,28
Tyler Johnson,5.0,2015 - 2019,PG,280,7367,1090,2508,43.46092503987241,356,969,36.738906088751285,734,1539,47.693307342430145,50.558213716108455,493,639,77.15179968701096,163,756,919,697,258,128,329,551,3029
Tyler Lydon,2.0,2018 - 2019,PF,26,96,9,18,50.0,4,10,40.0,5,8,62.5,61.111111111111114,1,3,33.33333333333333,7,11,18,6,2,0,4,10,23
Tyler Ulis,3.0,2017 - 2019,PG,133,2782,398,988,40.2834008097166,63,225,28.000000000000004,335,763,43.90563564875492,43.47165991902834,139,172,80.81395348837209,44,179,223,537,118,12,204,193,998
Tyler Zeller,7.0,2013 - 2019,C,437,7522,1199,2354,50.93457943925234,10,35,28.57142857142857,1189,2319,51.27210004312204,51.146983857264225,558,731,76.33378932968536,650,1232,1882,382,110,249,359,921,2966
Tyreke Evans,10.0,2010 - 2019,SG,598,18367,3524,8021,43.93467148734572,502,1559,32.2001282873637,3022,6462,46.76570721138966,47.06395711257948,1837,2432,75.53453947368422,503,2237,2740,2872,739,223,1495,1318,9387
Tyrone Corbin,16.0,1986 - 2001,SF,1146,29883,4191,9192,45.59399477806789,224,751,29.82689747003995,3967,8441,46.99680132685701,46.8124456048738,1841,2329,79.04680120223271,1882,3568,5450,2008,1308,285,1387,2829,10447
Tyrone Hill,14.0,1991 - 2004,PF,875,24261,3017,6049,49.876012564060176,0,17,0.0,3017,6032,50.016578249336874,49.876012564060176,1989,3100,64.16129032258064,2556,4750,7306,678,653,401,1320,3153,8023
Tyrone Nesby,4.0,1999 - 2002,SF,255,6659,918,2271,40.422721268163805,191,604,31.62251655629139,727,1667,43.61127774445111,44.627917217084985,404,523,77.24665391969407,295,646,941,370,264,93,269,667,2431
Tyrone Wallace,2.0,2018 - 2019,PG,92,1479,202,464,43.53448275862069,14,59,23.728813559322035,188,405,46.41975308641975,45.043103448275865,91,135,67.4074074074074,41,165,206,113,48,20,82,166,509
Tyronn Lue,11.0,1999 - 2009,PG,575,12734,1784,4088,43.6399217221135,466,1191,39.126784214945424,1318,2897,45.495340006903696,49.33953033268102,724,873,82.93241695303551,134,822,956,1744,300,11,671,1072,4758
Tyrus Thomas,8.0,2007 - 2015,PF,423,8317,1206,2749,43.87049836304111,8,35,22.857142857142858,1198,2714,44.14148857774502,44.01600582029829,826,1130,73.09734513274336,576,1462,2038,361,347,552,557,1044,3246
Tyshawn Taylor,2.0,2013 - 2014,PG,63,493,63,179,35.19553072625698,9,25,36.0,54,154,35.064935064935064,37.709497206703915,39,57,68.42105263157895,5,28,33,57,25,1,56,54,174
Tyson Chandler,18.0,2002 - 2019,C,1209,33597,3737,6287,59.44011452202959,0,11,0.0,3737,6276,59.54429572976419,59.44011452202959,2524,3917,64.43706918560123,3761,7259,11020,998,667,1412,1729,3527,9998
Tyson Wheeler,1.0,1999 - 1999,PG,1,3,1,1,100.0,1,1,100.0,0,0,,150.0,1,2,50.0,0,0,0,2,0,0,0,1,4
Tyus Edney,4.0,1996 - 2001,PG,232,4874,603,1487,40.55144586415602,67,211,31.753554502369667,536,1276,42.00626959247649,42.804303967720244,507,630,80.47619047619048,124,281,405,924,226,6,404,399,1780
Tyus Jones,4.0,2016 - 2019,PG,251,4429,468,1118,41.86046511627907,127,383,33.15926892950392,341,735,46.394557823129254,47.54025044722719,190,232,81.89655172413794,56,333,389,831,256,19,178,271,1253
Udonis Haslem,16.0,2004 - 2019,PF,1001,24712,2971,6080,48.86513157894737,4,56,7.142857142857142,2967,6024,49.25298804780876,48.89802631578947,1398,1864,75.0,1836,4724,6560,810,480,290,921,2423,7344
Uros Slokar,1.0,2007 - 2007,C,20,72,14,26,53.84615384615385,1,2,50.0,13,24,54.166666666666664,55.769230769230774,9,13,69.23076923076923,7,7,14,1,1,2,9,11,38
Uwe Blab,5.0,1986 - 1990,C,242,1995,188,434,43.31797235023041,0,0,,188,434,43.31797235023041,43.31797235023041,141,234,60.256410256410255,130,290,420,103,20,86,144,350,517
Vander Blue,3.0,2014 - 2018,SG,10,134,12,39,30.76923076923077,2,13,15.384615384615385,10,26,38.46153846153847,33.33333333333333,4,12,33.33333333333333,2,11,13,12,4,0,11,7,30
Vassilis Spanoulis,1.0,2007 - 2007,SG,32,275,24,74,32.432432432432435,5,29,17.24137931034483,19,45,42.22222222222222,35.810810810810814,36,44,81.81818181818183,5,18,23,29,7,1,29,33,89
Vern Fleming,12.0,1985 - 1996,PG,930,25476,4073,8188,49.74352711284807,40,224,17.857142857142858,4033,7964,50.64038171772979,49.98778700537372,2223,2909,76.41801306290822,1016,2082,3098,4407,948,112,1852,2072,10409
Vernon Macklin,1.0,2012 - 2012,C,23,135,19,35,54.285714285714285,0,0,,19,35,54.285714285714285,54.285714285714285,8,14,57.14285714285714,14,20,34,5,4,4,3,9,46
Vernon Maxwell,13.0,1989 - 2001,SG,904,25957,4172,10523,39.64648864392284,1340,4210,31.828978622327792,2832,6313,44.85981308411215,46.01349425068897,1870,2558,73.10398749022674,404,1939,2343,3077,1019,157,1751,1877,11554
Viacheslav Kravtsov,2.0,2013 - 2014,C,45,283,41,61,67.21311475409836,0,0,,41,61,67.21311475409836,67.21311475409836,15,45,33.33333333333333,33,29,62,10,5,10,20,39,97
Victor Alexander,5.0,1992 - 2002,C,291,5782,1104,2132,51.78236397748592,18,63,28.57142857142857,1086,2069,52.489125181246976,52.204502814258916,323,509,63.45776031434185,447,944,1391,258,137,177,380,721,2549
Victor Claver,3.0,2013 - 2015,SF,82,1079,100,251,39.8406374501992,34,116,29.310344827586203,66,135,48.888888888888886,46.613545816733065,24,45,53.333333333333336,43,140,183,56,30,16,59,103,258
Victor Oladipo,6.0,2014 - 2019,SG,414,13802,2665,6042,44.107911287653096,647,1840,35.16304347826087,2018,4202,48.02475011899096,49.462098642833496,1264,1595,79.24764890282133,254,1691,1945,1641,704,205,1063,1001,7241
Viktor Khryapa,4.0,2005 - 2008,SF,143,2351,251,567,44.26807760141093,14,48,29.166666666666668,237,519,45.664739884393065,45.5026455026455,127,193,65.80310880829016,168,324,492,142,86,48,139,353,643
Vin Baker,13.0,1994 - 2006,PF,815,26486,4830,9956,48.51345922057051,40,183,21.85792349726776,4790,9773,49.01258569528292,48.7143431096826,2455,3860,63.601036269430054,2337,3699,6036,1542,611,823,1800,2648,12155
Vince Carter,21.0,1999 - 2019,SG,1569,48524,9743,22375,43.544134078212295,2348,6318,37.16365938588161,7395,16057,46.05468020178115,48.791061452513965,5189,6505,79.76940814757879,1771,5188,6959,4961,1601,910,2725,4162,27023
Vince Edwards,1.0,2019 - 2019,SF,2,16,1,4,25.0,1,4,25.0,0,0,,37.5,0,0,,1,1,2,0,0,0,0,0,3
Vince Hunter,1.0,2018 - 2018,PF,4,7,3,5,60.0,0,0,,3,5,60.0,60.0,0,0,,2,1,3,0,0,1,1,0,6
Vince Taylor,1.0,1983 - 1983,SG,31,321,37,102,36.27450980392157,0,0,,37,102,36.27450980392157,36.27450980392157,21,32,65.625,19,17,36,41,20,2,30,54,95
Vincent Askew,9.0,1988 - 1998,SG,517,10068,1291,2725,47.37614678899082,86,282,30.49645390070922,1205,2443,49.32460090053213,48.95412844036697,859,1147,74.89102005231038,436,836,1272,1076,325,115,545,1067,3527
Vincent Yarbrough,1.0,2003 - 2003,SG,59,1381,168,428,39.25233644859813,21,78,26.923076923076923,147,350,42.0,41.705607476635514,49,62,79.03225806451613,36,126,162,130,57,33,81,145,406
Vincenzo Esposito,1.0,1996 - 1996,PG,30,282,36,100,36.0,13,56,23.214285714285715,23,44,52.27272727272727,42.5,31,39,79.48717948717949,4,12,16,23,7,0,39,27,116
Vinny Del Negro,12.0,1989 - 2002,SG,825,20579,3056,6456,47.33581164807931,274,749,36.58210947930574,2782,5707,48.747152619589976,49.45786864931846,1125,1342,83.83010432190761,301,1627,1928,2635,610,71,867,1563,7511
Vitaly Potapenko,11.0,1997 - 2007,C,623,11724,1652,3453,47.84245583550536,1,6,16.666666666666664,1651,3447,47.89672178706121,47.85693599768317,721,1041,69.26032660902978,1074,1670,2744,421,261,209,792,1555,4026
Vitor Faverani,1.0,2014 - 2014,C,37,488,64,147,43.53741496598639,12,40,30.0,52,107,48.598130841121495,47.61904761904761,24,37,64.86486486486487,42,86,128,16,14,27,41,74,164
Vlade Divac,16.0,1990 - 2005,C,1255,37566,5746,11638,49.37274445781062,113,480,23.541666666666668,5633,11158,50.483957698512285,49.85822306238185,3261,4686,69.59026888604353,3188,7051,10239,3827,1405,1796,2730,4048,14866
Vladimir Radmanovic,12.0,2002 - 2013,PF,784,17151,2276,5468,41.62399414776884,1034,2726,37.93103448275862,1242,2742,45.29540481400438,51.07900512070227,637,841,75.74316290130797,693,2256,2949,1052,564,274,878,1667,6223
Vladimir Stepania,6.0,1999 - 2004,C,270,3726,455,1071,42.48366013071895,2,15,13.333333333333334,453,1056,42.89772727272727,42.57703081232493,206,384,53.645833333333336,444,736,1180,94,110,144,213,482,1118
Voise Winters,1.0,1986 - 1986,SF,4,17,3,13,23.076923076923077,0,1,0.0,3,12,25.0,23.076923076923077,0,0,,1,2,3,0,1,0,2,1,6
Von Wafer,6.0,2006 - 2012,SG,217,2667,432,1027,42.06426484907498,111,337,32.93768545994065,321,690,46.52173913043478,47.46835443037975,191,251,76.09561752988047,38,210,248,155,75,20,140,167,1166
Vonteego Cummings,3.0,2000 - 2002,PG,200,3790,521,1359,38.33701250919794,109,340,32.05882352941177,412,1019,40.43179587831207,42.347314201618836,230,317,72.55520504731862,118,255,373,534,176,32,259,387,1381
Voshon Lenard,11.0,1996 - 2006,SG,596,16301,2575,6196,41.55907036797934,1001,2592,38.61882716049383,1574,3604,43.67369589345172,49.63686249193028,982,1246,78.81219903691814,364,1328,1692,1238,440,137,799,1298,7133
Wade Baldwin,3.0,2017 - 2019,PG,63,610,61,174,35.05747126436782,10,37,27.027027027027028,51,137,37.22627737226277,37.93103448275862,48,62,77.41935483870968,15,61,76,83,22,11,60,67,180
Walker Russell,7.0,1983 - 2012,PG,190,2134,214,556,38.489208633093526,10,51,19.607843137254903,204,505,40.396039603960396,39.38848920863309,116,149,77.85234899328859,58,155,213,409,76,11,235,225,554
Wallace Bryant,3.0,1984 - 1986,C,104,1431,134,330,40.60606060606061,0,0,,134,330,40.60606060606061,40.60606060606061,57,98,58.16326530612245,129,252,381,113,36,41,73,201,325
Wally Rank,1.0,1981 - 1981,SF,25,153,21,57,36.84210526315789,0,0,,21,57,36.84210526315789,36.84210526315789,13,28,46.42857142857143,17,13,30,17,7,1,26,33,55
Wally Szczerbiak,10.0,2000 - 2009,SF,705,21498,3676,7638,48.12778214192197,627,1583,39.6083385975995,3049,6055,50.355078447564,52.232259753862266,1768,2052,86.15984405458089,713,2056,2769,1609,414,169,1052,1502,9747
Walt Lemon,2.0,2018 - 2019,PG,11,202,45,103,43.689320388349515,3,6,50.0,42,97,43.29896907216495,45.14563106796117,10,14,71.42857142857143,4,25,29,35,11,2,14,19,103
Walt Williams,11.0,1993 - 2003,SF,743,19402,3054,7201,42.410776281072074,1012,2672,37.87425149700599,2042,4529,45.0872157209097,49.43757811415081,1480,1993,74.25990968389364,787,2092,2879,1677,672,422,1353,2123,8600
Walter Berry,3.0,1987 - 1989,SF,212,5014,1241,2303,53.88623534520192,1,6,16.666666666666664,1240,2297,53.983456682629516,53.90794615718628,498,774,64.34108527131784,414,587,1001,303,129,154,421,604,2981
Walter Bond,3.0,1993 - 1995,SG,157,2440,329,807,40.76827757125155,41,138,29.71014492753623,288,669,43.04932735426009,43.30855018587361,175,229,76.41921397379913,80,210,290,177,98,34,146,364,874
Walter Herrmann,3.0,2007 - 2009,PF,160,1988,316,693,45.5988455988456,117,304,38.48684210526316,199,389,51.156812339331616,54.04040404040404,83,107,77.57009345794393,80,241,321,68,32,12,61,150,832
Walter Jordan,1.0,1981 - 1981,SF,30,207,29,75,38.666666666666664,0,0,,29,75,38.666666666666664,38.666666666666664,10,17,58.82352941176471,23,19,42,11,11,5,17,35,68
Walter McCarty,10.0,1997 - 2006,PF,639,11116,1161,2937,39.530132788559754,488,1410,34.60992907801418,673,1527,44.073346430910284,47.837929860401765,429,614,69.86970684039088,431,1228,1659,707,397,182,540,1287,3239
Walter Palmer,2.0,1991 - 1993,C,50,215,43,106,40.56603773584906,0,1,0.0,43,105,40.95238095238095,40.56603773584906,16,24,66.66666666666666,18,48,66,11,4,9,17,52,102
Walter Sharpe,1.0,2009 - 2009,PF,8,20,4,11,36.36363636363637,0,2,0.0,4,9,44.44444444444444,36.36363636363637,0,2,0.0,0,3,3,0,0,2,0,3,8
Wang Zhizhi,5.0,2001 - 2005,C,153,1330,223,535,41.6822429906542,74,190,38.94736842105263,149,345,43.188405797101446,48.598130841121495,114,156,73.07692307692307,61,180,241,44,26,37,70,168,634
Warren Kidd,1.0,1994 - 1994,PF,68,884,100,169,59.171597633136095,0,0,,100,169,59.171597633136095,59.171597633136095,47,86,54.65116279069767,76,157,233,19,19,23,44,129,247
Wayman Tisdale,12.0,1986 - 1997,PF,862,24249,5405,10722,50.410371199403095,0,22,0.0,5405,10700,50.51401869158878,50.410371199403095,2225,2936,75.78337874659401,1633,3541,5174,1099,466,505,1420,2862,13035
Wayne Ellington,10.0,2010 - 2019,SG,652,13835,1939,4733,40.96767377984365,980,2582,37.955073586367156,959,2151,44.58391445839144,51.32051552926262,467,551,84.75499092558984,213,1213,1426,716,360,50,443,752,5325
Wayne Englestad,1.0,1989 - 1989,PF,11,50,11,29,37.93103448275862,0,0,,11,29,37.93103448275862,37.93103448275862,6,10,60.0,5,11,16,7,1,0,3,12,28
Wayne Kreklow,1.0,1981 - 1981,SG,25,100,11,47,23.404255319148938,1,4,25.0,10,43,23.25581395348837,24.46808510638298,7,10,70.0,2,10,12,9,2,1,10,20,30
Wayne Robinson,1.0,1981 - 1981,PF,81,1592,234,509,45.97249508840864,0,6,0.0,234,503,46.52087475149106,45.97249508840864,175,240,72.91666666666666,117,177,294,112,46,24,149,186,643
Wayne Sappleton,1.0,1985 - 1985,PF,33,298,41,87,47.12643678160919,0,0,,41,87,47.12643678160919,47.12643678160919,14,34,41.17647058823529,28,47,75,7,7,4,21,50,96
Wayne Selden,3.0,2017 - 2019,SG,130,2473,346,836,41.38755980861244,113,335,33.731343283582085,233,501,46.506986027944116,48.145933014354064,128,177,72.31638418079096,57,204,261,195,58,20,147,216,933
Wayne Simien,2.0,2006 - 2007,PF,53,514,67,146,45.89041095890411,0,0,,67,146,45.89041095890411,45.89041095890411,35,41,85.36585365853658,44,56,100,11,15,1,28,84,169
Wayne Turner,1.0,2000 - 2000,PG,3,41,1,6,16.666666666666664,0,0,,1,6,16.666666666666664,16.666666666666664,2,6,33.33333333333333,1,2,3,5,0,0,3,4,4
Wendell Carter,1.0,2019 - 2019,C,44,1110,180,371,48.517520215633425,6,32,18.75,174,339,51.32743362831859,49.32614555256065,89,112,79.46428571428571,87,220,307,78,26,58,65,152,455
Wes Matthews,9.0,1981 - 1990,PG,503,9689,1531,3200,47.84375,37,169,21.893491124260358,1494,3031,49.29066314747608,48.421875,728,923,78.87323943661971,175,469,644,2021,458,83,1006,1007,3827
Wesley Iwundu,2.0,2018 - 2019,SF,130,2253,206,492,41.86991869918699,38,125,30.4,168,367,45.776566757493185,45.73170731707317,118,150,78.66666666666666,73,248,321,130,61,34,74,204,568
Wesley Johnson,9.0,2011 - 2019,SF,618,13560,1634,4042,40.42553191489361,617,1832,33.67903930131004,1017,2210,46.01809954751131,48.05789213260762,367,495,74.14141414141415,342,1602,1944,647,470,406,527,1176,4252
Wesley Matthews,10.0,2010 - 2019,SG,756,24751,3529,8326,42.385299063175594,1610,4236,38.007554296506136,1919,4090,46.919315403422985,52.05380735046842,1666,2019,82.51609707776126,406,1946,2352,1647,832,157,1006,1723,10334
Wesley Person,11.0,1995 - 2005,SG,760,21510,3226,7078,45.577846849392486,1200,2888,41.55124653739612,2026,4190,48.353221957040574,54.05481774512574,818,1049,77.97902764537655,448,2041,2489,1265,593,236,700,1001,8470
Will Barton,7.0,2013 - 2019,SG,445,10275,1720,3989,43.118576084231634,470,1372,34.25655976676385,1250,2617,47.764615972487576,49.009776886437706,753,955,78.84816753926701,302,1434,1736,1039,311,178,595,671,4663
Will Blalock,1.0,2007 - 2007,PG,14,166,9,30,30.0,1,5,20.0,8,25,32.0,31.666666666666664,6,6,100.0,6,9,15,17,5,0,12,9,25
Will Bynum,8.0,2006 - 2015,PG,367,6720,1142,2582,44.229279628195194,86,315,27.3015873015873,1056,2267,46.58138509042788,45.89465530596437,617,770,80.12987012987013,128,442,570,1198,263,30,591,685,2987
Will Cherry,1.0,2015 - 2015,PG,8,69,5,19,26.31578947368421,2,9,22.22222222222222,3,10,30.0,31.57894736842105,3,6,50.0,1,4,5,8,6,1,4,10,15
Will Conroy,3.0,2007 - 2013,PG,16,108,3,22,13.636363636363635,0,6,0.0,3,16,18.75,13.636363636363635,1,8,12.5,4,7,11,16,0,0,6,13,7
Will Perdue,13.0,1989 - 2001,C,900,13616,1656,3207,51.637043966323674,2,19,10.526315789473683,1654,3188,51.882057716436634,51.66822575615841,793,1361,58.265980896399704,1573,2722,4295,629,241,569,886,1795,4107
Will Solomon,2.0,2002 - 2009,SG,115,1584,218,576,37.84722222222222,74,248,29.838709677419356,144,328,43.90243902439025,44.27083333333333,74,107,69.1588785046729,24,108,132,225,62,11,116,147,584
William Avery,3.0,2000 - 2002,PG,144,1217,140,421,33.2541567695962,41,159,25.78616352201258,99,262,37.786259541984734,38.12351543942993,65,91,71.42857142857143,17,77,94,201,34,7,106,125,386
William Bedford,6.0,1987 - 1993,C,252,2607,414,1010,40.99009900990099,7,24,29.166666666666668,407,986,41.27789046653144,41.336633663366335,158,259,61.003861003861005,210,389,599,113,40,131,177,377,993
William Cunningham,2.0,1998 - 1999,C,23,201,7,27,25.925925925925924,0,0,,7,27,25.925925925925924,25.925925925925924,0,2,0.0,17,21,38,2,3,11,5,40,14
Willie Anderson,9.0,1989 - 1997,SG,607,17114,3002,6379,47.060667816272144,113,414,27.294685990338163,2889,5965,48.4325230511316,47.946386580968806,1137,1446,78.63070539419087,584,1640,2224,2232,636,354,1244,1628,7254
Willie Burton,8.0,1991 - 1999,SF,318,6677,1091,2573,42.401865526622615,140,408,34.31372549019608,951,2165,43.926096997690536,45.122425184609405,923,1174,78.62010221465077,326,606,932,393,191,121,518,849,3245
Willie Cauley-Stein,4.0,2016 - 2019,C,295,7090,1246,2334,53.384747215081404,4,18,22.22222222222222,1242,2316,53.626943005181346,53.470437017994854,475,777,61.132561132561136,531,1348,1879,483,274,228,308,705,2971
Willie Green,12.0,2004 - 2015,SG,767,15322,2491,5859,42.515787677077995,528,1537,34.35263500325309,1963,4322,45.418787598334106,47.02167605393412,735,963,76.32398753894081,249,1100,1349,1050,405,113,727,1319,6245
Willie Reed,3.0,2016 - 2018,C,152,1885,319,539,59.183673469387756,2,6,33.33333333333333,317,533,59.47467166979362,59.36920222634509,111,198,56.060606060606055,213,362,575,46,33,99,66,240,751
Willie Warren,1.0,2011 - 2011,PG,19,134,13,35,37.142857142857146,5,15,33.33333333333333,8,20,40.0,44.285714285714285,6,8,75.0,1,11,12,27,6,0,8,16,37
Willie White,2.0,1985 - 1986,SG,96,721,155,356,43.53932584269663,13,39,33.33333333333333,142,317,44.79495268138801,45.36516853932584,47,66,71.21212121212122,42,58,100,105,29,4,73,58,370
Willy Hernangomez,3.0,2017 - 2019,C,178,2631,490,924,53.03030303030303,24,66,36.36363636363637,466,858,54.312354312354316,54.32900432900433,250,359,69.63788300835655,348,648,996,189,75,72,193,312,1254
Wilson Chandler,11.0,2008 - 2019,SF,652,19873,3231,7304,44.23603504928806,847,2475,34.22222222222222,2384,4829,49.368399254504034,50.0342278203724,1045,1361,76.78177810433505,762,2722,3484,1176,465,409,908,1768,8354
Winston Bennett,3.0,1990 - 1992,SF,141,2292,280,651,43.01075268817204,0,1,0.0,280,650,43.07692307692308,43.01075268817204,138,199,69.34673366834171,191,244,435,125,53,22,119,316,698
Winston Crite,2.0,1988 - 1989,SF,31,264,34,71,47.88732394366197,0,0,,34,71,47.88732394366197,47.88732394366197,19,25,76.0,28,37,65,15,5,8,26,43,87
Winston Garland,7.0,1988 - 1995,PG,531,13907,1983,4616,42.95927209705373,74,264,28.030303030303028,1909,4352,43.864889705882355,43.76083188908146,943,1132,83.30388692579506,433,1066,1499,2481,703,82,1012,1309,4983
Xavier Henry,5.0,2011 - 2015,SF,185,2905,368,907,40.57331863285557,41,126,32.53968253968254,327,781,41.86939820742638,42.8335170893054,273,430,63.48837209302326,81,270,351,120,100,23,139,264,1050
Xavier McDaniel,12.0,1986 - 1998,SF,921,26934,6038,12472,48.41244387427838,85,322,26.39751552795031,5953,12150,48.99588477366255,48.75320718409237,2312,3235,71.46831530139104,2227,3443,5670,1906,827,438,2012,2730,14473
Xavier Munford,2.0,2016 - 2018,SG,24,354,42,111,37.83783783783784,10,33,30.303030303030305,32,78,41.02564102564102,42.34234234234234,8,18,44.44444444444444,5,36,41,36,20,6,22,37,102
Xavier Rathan-Mayes,1.0,2018 - 2018,SG,5,118,12,42,28.57142857142857,1,14,7.142857142857142,11,28,39.285714285714285,29.761904761904763,4,9,44.44444444444444,0,5,5,18,6,3,11,18,29
Xavier Silas,2.0,2012 - 2018,SG,6,50,5,19,26.31578947368421,1,8,12.5,4,11,36.36363636363637,28.947368421052634,2,3,66.66666666666666,4,4,8,3,1,0,3,6,13
Yakhouba Diawara,4.0,2007 - 2010,SG,196,2644,236,661,35.703479576399396,122,408,29.901960784313726,114,253,45.059288537549406,44.93192133131619,67,105,63.8095238095238,77,187,264,122,53,16,72,278,661
Yante Maten,1.0,2019 - 2019,PF,2,13,1,4,25.0,0,1,0.0,1,3,33.33333333333333,25.0,0,0,,1,2,3,0,1,0,0,0,2
Yao Ming,8.0,2003 - 2011,C,514,16806,3575,6821,52.411669843131506,2,10,20.0,3573,6811,52.459257084128616,52.42633045008064,2650,3182,83.28095537397863,1309,3446,4755,798,198,962,1393,1701,9802
Yaroslav Korolev,2.0,2006 - 2007,SF,34,168,13,46,28.26086956521739,3,12,25.0,10,34,29.411764705882355,31.521739130434785,10,16,62.5,6,10,16,13,6,0,7,11,39
Yi Jianlian,5.0,2008 - 2012,PF,273,6043,814,2015,40.397022332506204,75,226,33.1858407079646,739,1789,41.30799329234209,42.25806451612903,447,574,77.87456445993031,379,962,1341,192,137,184,302,618,2150
Yinka Dare,4.0,1995 - 1998,C,110,1002,86,217,39.63133640552996,0,0,,86,217,39.63133640552996,39.63133640552996,61,107,57.009345794392516,101,180,281,4,12,70,96,179,233
Yogi Ferrell,3.0,2017 - 2019,PG,199,4546,624,1476,42.27642276422765,256,684,37.42690058479532,368,792,46.464646464646464,50.94850948509485,216,259,83.3976833976834,59,410,469,510,142,22,188,307,1720
Yuta Tabuse,1.0,2005 - 2005,PG,4,17,1,6,16.666666666666664,1,1,100.0,0,5,0.0,25.0,4,4,100.0,2,2,4,3,0,0,1,1,7
Yuta Watanabe,1.0,2019 - 2019,SF,15,174,15,51,29.411764705882355,2,16,12.5,13,35,37.142857142857146,31.372549019607842,7,10,70.0,4,27,31,8,4,1,6,11,39
Yvon Joseph,1.0,1986 - 1986,C,1,5,0,0,,0,0,,0,0,,,2,2,100.0,0,0,0,0,0,0,0,1,2
Zabian Dowdell,1.0,2011 - 2011,PG,24,292,51,125,40.8,3,10,30.0,48,115,41.73913043478261,42.0,16,17,94.11764705882352,5,15,20,51,20,2,29,30,121
Zach Collins,2.0,2018 - 2019,C,147,2471,315,719,43.81084840055633,78,248,31.451612903225808,237,471,50.318471337579616,49.235048678720446,124,172,72.09302325581395,157,400,557,129,45,99,137,317,832
Zach LaVine,5.0,2015 - 2019,SG,293,8772,1711,3836,44.60375391032325,462,1237,37.348423605497175,1249,2599,48.05694497883801,50.62565172054223,826,1002,82.43512974051896,122,868,990,1021,248,67,691,650,4710
Zach Lofton,1.0,2019 - 2019,SG,1,4,0,1,0.0,0,1,0.0,0,0,,0.0,0,0,,0,0,0,0,1,0,1,0,0
Zach Randolph,17.0,2002 - 2018,PF,1186,37066,7875,16779,46.93366708385482,203,755,26.887417218543046,7672,16024,47.87818272591113,47.538589904046724,3780,4956,76.27118644067797,3503,7355,10858,2169,885,327,2419,2842,19733
Zan Tabak,6.0,1995 - 2001,C,267,3695,543,1079,50.324374420759966,0,3,0.0,543,1076,50.46468401486989,50.324374420759966,166,311,53.37620578778135,333,570,903,166,66,131,272,594,1252
Zarko Cabarkapa,3.0,2004 - 2006,PF,150,1550,234,548,42.700729927007295,24,88,27.27272727272727,210,460,45.65217391304348,44.89051094890511,148,202,73.26732673267327,98,214,312,85,33,25,119,221,640
Zarko Paspalj,1.0,1990 - 1990,SF,28,181,27,79,34.177215189873415,0,1,0.0,27,78,34.61538461538461,34.177215189873415,18,22,81.81818181818183,15,15,30,10,3,7,21,37,72
Zaza Pachulia,16.0,2004 - 2019,C,1171,23440,2727,5826,46.80741503604531,0,33,0.0,2727,5793,47.07405489383739,46.80741503604531,2322,3095,75.02423263327948,2480,4159,6639,1492,803,398,1509,2932,7776
Zeljko Rebraca,5.0,2002 - 2006,C,227,3400,500,957,52.2466039707419,0,0,,500,957,52.2466039707419,52.2466039707419,316,400,79.0,203,504,707,88,58,162,210,541,1316
Zendon Hamilton,6.0,2001 - 2006,C,134,1560,176,400,44.0,0,0,,176,400,44.0,44.0,233,353,66.0056657223796,184,280,464,33,39,28,108,215,585
Zhaire Smith,1.0,2019 - 2019,SG,6,111,14,34,41.17647058823529,6,16,37.5,8,18,44.44444444444444,50.0,6,8,75.0,3,10,13,10,2,2,6,8,40
Zhou Qi,2.0,2018 - 2019,PF,22,131,8,34,23.52941176470588,2,19,10.526315789473683,6,15,40.0,26.47058823529412,8,12,66.66666666666666,6,17,23,2,2,14,10,14,26
Zoran Dragic,1.0,2015 - 2015,SG,16,75,11,30,36.666666666666664,3,14,21.428571428571427,8,16,50.0,41.66666666666667,3,5,60.0,5,3,8,5,2,0,5,6,28
Zoran Planinic,3.0,2004 - 2006,PG,160,1608,197,489,40.286298568507156,37,129,28.68217054263566,160,360,44.44444444444444,44.06952965235173,131,196,66.83673469387756,47,153,200,169,59,7,123,240,562
Zydrunas Ilgauskas,13.0,1998 - 2011,C,923,25088,4534,9528,47.586062132661624,33,113,29.20353982300885,4501,9415,47.806691449814124,47.75923593618808,2691,3458,77.81954887218046,2639,4107,6746,1028,447,1412,1615,3012,11792
