Player,Years,Seasons,Pos,G,MP,FG,FGA,FG%,3P,3PA,3P%,2P,2PA,2P%,eFG%,FT,FTA,FT%,ORB,DRB,TRB,AST,STL,BLK,TOV,PF,PTS
Tariq Abdul-Wahad,4.0,2000 - 2003,SG,128,2643,399,962,41.476091476091476,8,36,22.22222222222222,391,926,42.22462203023758,41.891891891891895,194,268,72.38805970149254,170,304,474,165,99,54,174,283,1000
Shareef Abdur-Rahim,9.0,2000 - 2008,PF,618,21109,3845,8061,47.69879667535045,115,405,28.39506172839506,3730,7656,48.719958202716825,48.41210767894802,2748,3345,82.152466367713,1312,3417,4729,1549,583,428,1468,1787,10553
Cory Alexander,3.0,2000 - 2005,PG,71,757,62,203,30.541871921182267,21,70,30.0,41,133,30.82706766917293,35.714285714285715,38,52,73.07692307692307,16,80,96,131,49,3,72,97,183
Ray Allen,15.0,2000 - 2014,SG,1086,38806,7311,16059,45.525873342051185,2648,6555,40.39664378337147,4663,9504,49.06355218855219,53.77047138676132,3675,4085,89.96328029375765,949,3380,4329,3617,1212,215,2175,2279,20945
Rafer Alston,11.0,2000 - 2010,PG,671,19392,2450,6391,38.33515881708653,996,2815,35.38188277087034,1454,3576,40.65995525727069,46.12736660929432,903,1238,72.94022617124394,247,1644,1891,3202,813,105,1195,1408,6799
John Amaechi,4.0,2000 - 2003,C,266,4454,634,1576,40.22842639593909,1,13,7.6923076923076925,633,1563,40.49904030710173,40.26015228426396,491,727,67.53782668500688,217,503,720,219,84,83,352,450,1760
Derek Anderson,9.0,2000 - 2008,SG,511,15158,2055,5022,40.91995221027479,607,1738,34.92520138089758,1448,3284,44.0925700365408,46.963361210673035,1461,1718,85.04074505238648,365,1327,1692,1711,557,70,842,1021,6178
Kenny Anderson,6.0,2000 - 2005,PG,339,8655,1195,2768,43.171965317919074,113,310,36.45161290322581,1082,2458,44.019528071602934,45.21315028901734,460,598,76.92307692307693,202,672,874,1383,441,30,475,768,2963
Nick Anderson,3.0,2000 - 2002,SG,108,2482,341,915,37.267759562841526,155,484,32.02479338842975,186,431,43.1554524361949,45.73770491803278,42,85,49.411764705882355,87,310,397,150,110,26,116,148,879
Shandon Anderson,7.0,2000 - 2006,SF,522,12206,1418,3185,44.521193092621665,262,852,30.751173708920188,1156,2333,49.54993570510073,48.6342229199372,735,983,74.77110885045778,396,1318,1714,813,424,144,728,1090,3833
Chris Anstey,1.0,2000 - 2000,C,73,1007,161,364,44.230769230769226,1,6,16.666666666666664,160,358,44.6927374301676,44.36813186813187,116,147,78.91156462585033,90,190,280,65,29,25,80,180,439
Greg Anthony,3.0,2000 - 2002,PG,200,3918,449,1144,39.24825174825175,201,555,36.21621621621622,248,589,42.10526315789473,48.03321678321678,171,240,71.25,60,266,326,572,176,17,222,320,1270
B.J. Armstrong,1.0,2000 - 2000,PG,27,583,83,186,44.623655913978496,13,29,44.827586206896555,70,157,44.5859872611465,48.11827956989247,22,25,88.0,2,45,47,78,7,1,40,34,201
Darrell Armstrong,9.0,2000 - 2008,PG,659,16118,2126,5220,40.727969348659,766,2307,33.20329432162982,1360,2913,46.68726398901476,48.065134099616856,1099,1266,86.8088467614534,500,1351,1851,2640,899,80,1180,1091,6117
Chucky Atkins,11.0,2000 - 2010,PG,696,17304,2479,6022,41.165725672534045,934,2565,36.41325536062378,1545,3457,44.691929418571014,48.920624377283296,971,1258,77.18600953895071,194,992,1186,2396,465,36,1018,1284,6863
Stacey Augmon,7.0,2000 - 2006,SG,432,6519,665,1548,42.958656330749356,1,23,4.3478260869565215,664,1525,43.540983606557376,42.99095607235142,413,561,73.61853832442068,302,643,945,467,248,82,298,606,1744
Isaac Austin,3.0,2000 - 2002,C,132,2325,283,714,39.635854341736696,7,31,22.58064516129032,276,683,40.4099560761347,40.12605042016807,126,181,69.61325966850829,125,450,575,145,46,66,172,258,699
Anthony Avent,1.0,2000 - 2000,PF,49,377,29,96,30.208333333333332,0,0,,29,96,30.208333333333332,30.208333333333332,23,32,71.875,23,51,74,11,16,15,24,62,81
William Avery,3.0,2000 - 2002,PG,142,1205,137,415,33.01204819277108,40,157,25.477707006369428,97,258,37.5968992248062,37.83132530120482,65,91,71.42857142857143,17,76,93,199,34,6,106,125,379
Toby Bailey,1.0,2000 - 2000,SG,46,449,58,140,41.42857142857143,2,10,20.0,56,130,43.07692307692308,42.142857142857146,45,65,69.23076923076923,26,46,72,30,13,4,24,55,163
Vin Baker,7.0,2000 - 2006,C,351,9232,1503,3296,45.6007281553398,5,40,12.5,1498,3256,46.007371007371006,45.67657766990291,864,1258,68.68044515103338,795,1126,1921,419,164,245,662,1106,3875
Charles Barkley,1.0,2000 - 2000,PF,20,620,106,222,47.74774774774775,6,26,23.076923076923077,100,196,51.02040816326531,49.0990990990991,71,110,64.54545454545455,71,138,209,63,14,4,44,48,289
Dana Barros,4.0,2000 - 2004,PG,162,2811,455,1042,43.66602687140115,127,320,39.6875,328,722,45.42936288088642,49.76007677543186,157,185,84.86486486486487,20,230,250,321,75,8,159,182,1194
Brent Barry,10.0,2000 - 2009,SG,679,17870,2104,4463,47.143177235043694,1074,2572,41.75738724727838,1030,1891,54.468535166578526,59.175442527447906,921,1116,82.52688172043011,314,1873,2187,2239,703,178,917,1254,6203
Drew Barry,1.0,2000 - 2000,PG,16,159,15,33,45.45454545454545,7,18,38.88888888888889,8,15,53.333333333333336,56.060606060606055,4,5,80.0,0,12,12,33,2,0,13,23,41
Jon Barry,7.0,2000 - 2006,SG,432,8697,1016,2277,44.62011418533158,454,1093,41.537053979871914,562,1184,47.46621621621622,54.589371980676326,511,576,88.71527777777779,181,799,980,1100,390,65,472,594,2997
Tony Battie,12.0,2000 - 2012,C,722,15022,1762,3579,49.23162894663314,9,57,15.789473684210526,1753,3522,49.772856331629754,49.35736239172953,670,972,68.93004115226337,1142,2494,3636,409,337,573,561,1845,4203
Jonathan Bender,8.0,2000 - 2010,SF,262,3847,509,1221,41.68714168714169,101,297,34.00673400673401,408,924,44.15584415584416,45.82309582309582,334,438,76.25570776255708,153,429,582,170,43,169,258,391,1453
Benoit Benjamin,1.0,2000 - 2000,C,3,8,1,3,33.33333333333333,0,0,,1,3,33.33333333333333,33.33333333333333,0,0,,0,1,1,0,0,1,0,1,2
Corey Benjamin,3.0,2000 - 2003,SG,122,1871,273,695,39.280575539568346,54,183,29.508196721311474,219,512,42.7734375,43.16546762589928,117,181,64.64088397790056,69,150,219,133,60,40,143,270,717
Mario Bennett,1.0,2000 - 2000,PF,1,3,0,3,0.0,0,0,,0,3,0.0,0.0,0,0,,1,1,2,0,0,0,0,1,0
Travis Best,6.0,2000 - 2005,PG,442,9925,1331,3074,43.298633702016915,158,463,34.12526997840173,1173,2611,44.92531597089238,45.86857514638907,700,823,85.05467800729039,136,701,837,1579,416,43,539,1011,3520
Mike Bibby,13.0,2000 - 2012,PG,951,32204,5150,11807,43.61819259761159,1502,3925,38.26751592356688,3648,7882,46.28266937325552,49.97882612009825,2234,2774,80.53352559480894,499,2468,2967,5192,1094,144,1988,1809,14036
Chauncey Billups,15.0,2000 - 2014,PG,918,29304,4267,10169,41.96086144163635,1638,4165,39.32773109243698,2629,6004,43.78747501665556,50.01475071295113,4113,4591,89.5883249836637,394,2312,2706,5149,886,150,1866,1882,14285
Mookie Blaylock,3.0,2000 - 2002,PG,177,5410,694,1784,38.90134529147982,189,568,33.274647887323944,505,1216,41.52960526315789,44.19843049327354,124,179,69.27374301675978,134,460,594,1065,333,46,308,276,1701
Corie Blount,5.0,2000 - 2004,PF,290,5063,469,1021,45.93535749265426,2,14,14.285714285714285,467,1007,46.375372393247275,46.03330068560235,134,223,60.0896860986547,548,813,1361,218,188,98,239,675,1074
Muggsy Bogues,2.0,2000 - 2001,PG,83,1765,157,360,43.611111111111114,17,52,32.69230769230769,140,308,45.45454545454545,45.97222222222222,79,87,90.80459770114942,25,113,138,304,67,4,63,122,410
Etdrick Bohannon,2.0,2000 - 2001,PF,19,137,9,17,52.94117647058824,0,0,,9,17,52.94117647058824,52.94117647058824,19,28,67.85714285714286,16,22,38,5,2,8,11,29,37
Calvin Booth,10.0,2000 - 2009,C,366,4477,472,1047,45.08118433619867,2,9,22.22222222222222,470,1038,45.27938342967245,45.176695319961794,244,326,74.84662576687117,316,694,1010,151,101,358,180,678,1190
Lazaro Borrell,1.0,2000 - 2000,SF,17,167,28,63,44.44444444444444,0,3,0.0,28,60,46.666666666666664,44.44444444444444,6,11,54.54545454545454,14,26,40,10,6,3,6,9,62
Cal Bowdler,3.0,2000 - 2002,SF,142,1383,163,403,40.44665012406948,2,11,18.181818181818183,161,392,41.07142857142857,40.69478908188586,96,125,76.8,90,182,272,29,42,45,43,155,424
Bruce Bowen,10.0,2000 - 2009,SF,781,22252,1797,4370,41.12128146453089,791,1997,39.60941412118177,1006,2373,42.393594605983985,50.171624713958806,495,867,57.09342560553633,375,1827,2202,980,604,297,581,1705,4880
Ryan Bowen,10.0,2000 - 2010,SF,507,6502,544,1192,45.63758389261745,14,68,20.588235294117645,530,1124,47.15302491103203,46.2248322147651,217,313,69.32907348242811,506,554,1060,250,325,138,168,752,1319
Ira Bowman,3.0,2000 - 2002,SG,17,68,7,11,63.63636363636363,0,1,0.0,7,10,70.0,63.63636363636363,1,2,50.0,1,4,5,9,3,0,2,3,15
Earl Boykins,12.0,2000 - 2012,PG,630,12743,2046,4901,41.746582330136704,381,1086,35.0828729281768,1665,3815,43.6435124508519,45.63354417465823,1253,1430,87.62237762237763,268,592,860,2059,384,34,736,639,5726
Shawn Bradley,6.0,2000 - 2005,C,436,8048,937,1914,48.95506792058516,2,14,14.285714285714285,935,1900,49.21052631578947,49.00731452455591,538,678,79.35103244837758,666,1478,2144,207,258,789,304,1169,2414
A.J. Bramlett,1.0,2000 - 2000,C,8,61,4,21,19.047619047619047,0,0,,4,21,19.047619047619047,19.047619047619047,0,0,,12,10,22,0,1,0,3,13,8
Elton Brand,17.0,2000 - 2016,PF,1058,34910,6599,13185,50.049298445202886,2,21,9.523809523809524,6597,13164,50.11394712853237,50.05688282138794,3627,4929,73.58490566037736,3304,5736,9040,2184,940,1828,2060,3115,16827
Terrell Brandon,3.0,2000 - 2002,PG,181,6370,1152,2541,45.336481700118064,90,246,36.58536585365854,1062,2295,46.27450980392157,47.107438016528924,465,516,90.11627906976744,121,508,629,1476,347,57,382,345,2859
Chucky Brown,3.0,2000 - 2002,SF,107,1527,198,450,44.0,2,13,15.384615384615385,196,437,44.8512585812357,44.22222222222222,59,88,67.04545454545455,53,201,254,83,31,29,58,163,457
Dee Brown,5.0,2000 - 2009,PG,120,1604,162,469,34.54157782515991,93,283,32.86219081272085,69,186,37.096774193548384,44.456289978678036,42,63,66.66666666666666,24,119,143,219,63,13,98,155,459
Marcus Brown,1.0,2000 - 2000,SG,6,45,4,14,28.57142857142857,0,7,0.0,4,7,57.14285714285714,28.57142857142857,2,2,100.0,3,4,7,3,0,0,3,8,10
P.J. Brown,9.0,2000 - 2008,PF,645,19900,2270,4872,46.592775041050906,0,12,0.0,2270,4860,46.70781893004115,46.592775041050906,1275,1531,83.27890267798824,1832,3386,5218,1007,496,544,778,1817,5815
Randy Brown,4.0,2000 - 2003,PG,146,3131,273,716,38.12849162011173,3,9,33.33333333333333,270,707,38.189533239038184,38.337988826815646,94,136,69.11764705882352,49,220,269,393,140,28,178,289,643
Rick Brunson,7.0,2000 - 2006,PG,282,3816,342,888,38.513513513513516,78,210,37.142857142857146,264,678,38.93805309734513,42.9054054054054,149,203,73.39901477832512,68,313,381,757,167,18,292,299,911
Kobe Bryant,17.0,2000 - 2016,SG,1146,43582,10790,24086,44.79780785518558,1674,5089,32.894478286500295,9116,18997,47.98652418802969,48.27285560076393,7634,9096,83.92700087950747,1320,5089,6409,5826,1749,527,3584,2918,30888
Mark Bryant,4.0,2000 - 2003,PF,139,2119,212,440,48.18181818181818,0,0,,212,440,48.18181818181818,48.18181818181818,88,111,79.27927927927928,163,274,437,78,40,36,105,335,512
Greg Buckner,10.0,2000 - 2009,SG,570,10895,1120,2491,44.96186270574067,239,716,33.37988826815643,881,1775,49.63380281690141,49.7591328783621,399,527,75.71157495256166,457,1136,1593,719,454,111,394,1342,2878
Jud Buechler,3.0,2000 - 2002,SF,181,2078,175,438,39.95433789954338,71,220,32.27272727272727,104,218,47.706422018348626,48.05936073059361,13,23,56.52173913043478,79,222,301,104,67,34,53,186,434
Rodney Buford,5.0,2000 - 2005,SF,230,4182,630,1530,41.17647058823529,74,247,29.959514170040485,556,1283,43.33593141075604,43.59477124183007,138,182,75.82417582417582,117,481,598,179,115,31,140,332,1472
Matt Bullard,3.0,2000 - 2002,PF,148,2374,307,760,40.39473684210526,181,447,40.49217002237137,126,313,40.2555910543131,52.30263157894737,46,56,82.14285714285714,45,270,315,121,31,24,60,190,841
Scott Burrell,2.0,2000 - 2001,SF,78,1377,172,434,39.63133640552996,84,238,35.294117647058826,88,196,44.89795918367347,49.30875576036866,40,54,74.07407407407408,66,193,259,73,70,44,38,181,468
Jason Caffey,4.0,2000 - 2003,PF,215,4796,651,1362,47.797356828193834,0,3,0.0,651,1359,47.90286975717439,47.797356828193834,444,705,62.97872340425532,416,645,1061,222,123,65,322,614,1746
Michael Cage,1.0,2000 - 2000,C,20,242,12,24,50.0,0,0,,12,24,50.0,50.0,3,3,100.0,33,48,81,9,8,8,4,30,27
Marcus Camby,14.0,2000 - 2013,C,801,23840,2948,6291,46.86059450007948,16,72,22.22222222222222,2932,6219,47.145843383180576,46.987760292481326,1321,1940,68.09278350515464,2175,6225,8400,1617,804,1897,1055,2142,7233
Elden Campbell,6.0,2000 - 2005,C,394,9182,1415,3189,44.37127626215114,0,17,0.0,1415,3172,44.609079445145014,44.37127626215114,1077,1463,73.61585782638414,585,1626,2211,450,238,523,551,1136,3907
Antoine Carr,1.0,2000 - 2000,SF,21,221,28,64,43.75,0,0,,28,64,43.75,43.75,11,14,78.57142857142857,8,24,32,7,3,6,9,42,67
Chris Carr,2.0,2000 - 2001,SF-SG,92,1475,249,608,40.95394736842105,49,138,35.507246376811594,200,470,42.5531914893617,44.98355263157895,153,185,82.70270270270271,52,165,217,95,34,18,136,158,700
Anthony Carter,13.0,2000 - 2012,PG,623,12184,1230,3043,40.42063752875452,116,464,25.0,1114,2579,43.19503683598294,42.32665133092343,433,613,70.63621533442088,244,1058,1302,2363,601,115,958,1103,3009
Vince Carter,20.0,2000 - 2019,SG,1431,43731,8841,20269,43.618333415560706,2210,5900,37.45762711864407,6631,14369,46.14795740830955,49.07000838719227,4625,5785,79.94814174589455,1546,4653,6199,4517,1452,786,2447,3765,24517
Sam Cassell,9.0,2000 - 2008,PG,640,20607,4108,8887,46.22482277483965,412,1219,33.79819524200164,3696,7668,48.200312989045386,48.542815348261506,2333,2690,86.72862453531599,379,1884,2263,4120,645,99,1543,1749,10961
Kelvin Cato,8.0,2000 - 2007,C,424,9065,967,1858,52.04520990312164,0,9,0.0,967,1849,52.29853975121688,52.04520990312164,593,915,64.80874316939891,744,1728,2472,202,240,535,377,1083,2527
Duane Causwell,2.0,2000 - 2001,C,56,569,52,122,42.62295081967213,0,0,,52,122,42.62295081967213,42.62295081967213,38,63,60.317460317460316,34,96,130,7,10,34,33,109,142
Cedric Ceballos,2.0,2000 - 2001,SF,109,2623,548,1231,44.51665312753859,66,207,31.88405797101449,482,1024,47.0703125,47.19740048740861,246,291,84.5360824742268,206,362,568,110,72,31,157,226,1408
John Celestand,1.0,2000 - 2000,PG,16,185,15,45,33.33333333333333,2,9,22.22222222222222,13,36,36.11111111111111,35.55555555555556,5,6,83.33333333333334,1,10,11,20,7,0,16,22,37
Rex Chapman,1.0,2000 - 2000,SG,53,957,124,320,38.75,41,123,33.33333333333333,83,197,42.13197969543147,45.15625,59,78,75.64102564102564,10,70,80,62,22,1,38,70,348
Calbert Cheaney,7.0,2000 - 2006,SG,401,8910,1112,2371,46.90004217629692,28,104,26.923076923076923,1084,2267,47.81649757388619,47.490510333192745,175,281,62.27758007117438,287,840,1127,581,237,79,366,870,2427
Pete Chilcutt,1.0,2000 - 2000,PF,56,601,53,127,41.732283464566926,6,26,23.076923076923077,47,101,46.53465346534654,44.09448818897638,8,8,100.0,46,85,131,27,15,10,20,73,120
Chris Childs,4.0,2000 - 2003,PG,229,5216,384,1008,38.095238095238095,103,336,30.654761904761905,281,672,41.81547619047619,43.20436507936508,167,204,81.86274509803921,62,446,508,1007,159,25,390,676,1038
Doug Christie,8.0,2000 - 2007,SG,463,15283,1688,3907,43.204504735090865,421,1177,35.76890399320306,1267,2730,46.41025641025641,48.59227028410545,1037,1209,85.7733664185277,405,1481,1886,1894,868,211,876,1099,4834
Keon Clark,5.0,2000 - 2004,C,325,7562,1143,2279,50.15357612988153,1,18,5.555555555555555,1142,2261,50.50862450243255,50.17551557700746,502,774,64.85788113695091,619,1381,2000,312,174,540,449,961,2789
Keith Closs,1.0,2000 - 2000,C,57,820,96,197,48.73096446700508,0,3,0.0,96,194,49.48453608247423,48.73096446700508,46,78,58.97435897435898,65,114,179,25,13,73,34,80,238
Derrick Coleman,6.0,2000 - 2005,C,269,7745,1207,2740,44.05109489051095,129,380,33.94736842105263,1078,2360,45.67796610169491,46.40510948905109,730,935,78.07486631016043,536,1446,1982,445,162,297,489,662,3273
Bimbo Coles,5.0,2000 - 2004,PG,231,4282,491,1194,41.12227805695142,21,107,19.626168224299064,470,1087,43.23827046918123,42.00167504187605,205,245,83.6734693877551,64,280,344,622,118,25,230,411,1208
Marty Conlon,1.0,2000 - 2000,C,3,9,1,2,50.0,0,0,,1,2,50.0,50.0,0,0,,1,1,2,0,0,0,0,1,2
Tyrone Corbin,2.0,2000 - 2001,SF,69,1058,97,285,34.03508771929825,10,49,20.408163265306122,87,236,36.86440677966102,35.78947368421053,35,43,81.3953488372093,43,135,178,64,38,5,32,117,239
Chris Crawford,5.0,2000 - 2004,PF,170,2945,453,1028,44.066147859922175,58,166,34.93975903614458,395,862,45.82366589327146,46.88715953307393,252,306,82.35294117647058,149,267,416,121,79,60,166,359,1216
Austin Croshere,10.0,2000 - 2009,PF,606,10988,1427,3498,40.79473985134363,417,1220,34.18032786885246,1010,2278,44.33713784021071,46.755288736420816,1036,1199,86.40533778148458,674,1885,2559,609,229,203,620,1030,4307
John Crotty,4.0,2000 - 2003,PG,153,2183,240,565,42.47787610619469,72,169,42.60355029585799,168,396,42.42424242424242,48.849557522123895,163,193,84.4559585492228,47,146,193,332,55,6,133,229,715
Terry Cummings,1.0,2000 - 2000,PF,22,398,76,177,42.93785310734463,0,0,,76,177,42.93785310734463,42.93785310734463,32,39,82.05128205128204,45,62,107,21,13,8,27,74,184
Vonteego Cummings,3.0,2000 - 2002,PG,199,3789,521,1359,38.33701250919794,109,340,32.05882352941177,412,1019,40.43179587831207,42.347314201618836,230,317,72.55520504731862,118,255,373,534,176,32,259,387,1381
Bill Curley,2.0,2000 - 2001,PF,48,501,54,115,46.95652173913044,1,3,33.33333333333333,53,112,47.32142857142857,47.391304347826086,30,44,68.18181818181817,39,48,87,17,20,13,37,106,139
Dell Curry,3.0,2000 - 2002,SG,194,2937,497,1183,42.01183431952663,202,518,38.996138996138995,295,665,44.3609022556391,50.54945054945055,100,120,83.33333333333334,50,216,266,225,81,23,120,182,1296
Michael Curry,6.0,2000 - 2005,SG,398,8041,633,1428,44.32773109243697,31,109,28.440366972477065,602,1319,45.640636846095525,45.41316526610644,364,443,82.16704288939052,103,531,634,518,179,31,290,944,1661
Erick Dampier,13.0,2000 - 2012,C,783,18881,2140,4054,52.78737049827331,1,13,7.6923076923076925,2139,4041,52.932442464736454,52.79970399605328,1245,2008,62.00199203187251,2191,3423,5614,626,246,1128,1084,2270,5526
Antonio Daniels,11.0,2000 - 2011,PG,751,17101,1959,4378,44.74645957058017,343,1085,31.61290322580645,1616,3293,49.073792894017615,48.66377341251713,1563,1938,80.6501547987616,184,1232,1416,2494,479,69,720,790,5824
Kornel David,2.0,2000 - 2001,SF,59,683,92,208,44.230769230769226,0,3,0.0,92,205,44.87804878048781,44.230769230769226,57,69,82.6086956521739,41,92,133,24,23,7,44,84,241
Antonio Davis,7.0,2000 - 2006,C,483,15433,1900,4451,42.687036620984045,0,3,0.0,1900,4448,42.7158273381295,42.687036620984045,1455,1895,76.78100263852242,1342,2625,3967,735,224,512,794,1350,5255
Baron Davis,13.0,2000 - 2012,PG,835,28592,4888,11951,40.90034306752573,1332,4159,32.026929550372685,3556,7792,45.63655030800821,46.47309848548238,2339,3292,71.05103280680437,762,2421,3183,6025,1530,360,2308,2361,13447
Ben Davis,1.0,2000 - 2000,PF,5,22,2,6,33.33333333333333,0,0,,2,6,33.33333333333333,33.33333333333333,0,0,,3,6,9,2,1,1,3,2,4
Dale Davis,8.0,2000 - 2007,C,522,12649,1364,2720,50.14705882352941,0,5,0.0,1364,2715,50.23941068139963,50.14705882352941,640,979,65.37282941777323,1374,2176,3550,494,294,493,393,1182,3368
Emanual Davis,4.0,2000 - 2003,SG,168,3105,315,824,38.228155339805824,117,344,34.01162790697674,198,480,41.25,45.32766990291262,104,133,78.19548872180451,67,304,371,311,141,24,198,269,851
Hubert Davis,5.0,2000 - 2004,SG,256,5146,591,1313,45.01142421934501,229,501,45.70858283433134,362,812,44.58128078817734,53.73191165270374,144,168,85.71428571428571,60,334,394,391,94,7,209,323,1555
Mark Davis,1.0,2000 - 2000,SF,23,464,56,137,40.87591240875913,0,2,0.0,56,135,41.48148148148148,40.87591240875913,31,47,65.95744680851064,31,53,84,38,25,4,40,52,143
Ricky Davis,11.0,2000 - 2010,SG,690,21370,3666,8210,44.65286236297199,581,1602,36.26716604244694,3085,6608,46.68583535108959,48.19123020706456,1790,2290,78.16593886462883,526,1940,2466,2368,702,180,1552,1384,9703
Todd Day,2.0,2000 - 2001,SG,89,1286,174,448,38.839285714285715,90,234,38.46153846153847,84,214,39.25233644859813,48.88392857142857,90,131,68.70229007633588,41,125,166,93,54,29,74,179,528
Andrew DeClercq,6.0,2000 - 2005,C,366,5954,645,1268,50.86750788643533,0,0,,645,1268,50.86750788643533,50.86750788643533,281,453,62.03090507726269,601,903,1504,208,215,191,332,1092,1571
Vinny Del Negro,3.0,2000 - 2002,PG,134,2139,260,563,46.181172291296626,9,37,24.324324324324326,251,526,47.71863117870723,46.98046181172291,76,83,91.56626506024097,21,168,189,288,62,3,82,159,605
Tony Delk,7.0,2000 - 2006,SG,371,8524,1349,3286,41.05295191722459,362,1041,34.77425552353506,987,2245,43.96436525612472,46.5611685940353,538,685,78.54014598540145,269,757,1026,658,322,53,351,648,3598
Derrick Dial,4.0,2000 - 2004,SG,82,687,103,277,37.18411552346571,8,42,19.047619047619047,95,235,40.42553191489361,38.628158844765345,39,58,67.24137931034483,45,88,133,63,21,11,35,51,253
Michael Dickerson,4.0,2000 - 2003,SG,162,5932,1004,2362,42.506350550381036,217,553,39.24050632911392,787,1809,43.50469872857933,47.09991532599492,485,605,80.16528925619835,152,374,526,458,186,74,341,461,2710
Vlade Divac,6.0,2000 - 2005,C,419,12045,1718,3589,47.86848704374478,22,91,24.175824175824175,1696,3498,48.484848484848484,48.174979102814156,1038,1546,67.14100905562742,897,2172,3069,1497,413,473,879,1208,4496
Michael Doleac,9.0,2000 - 2008,C,538,8009,1121,2571,43.60171139634383,1,8,12.5,1120,2563,43.69879047990636,43.621159082069234,335,412,81.31067961165049,516,1291,1807,323,181,192,350,1198,2578
Sherman Douglas,2.0,2000 - 2001,PG,79,1403,167,393,42.49363867684479,13,56,23.214285714285715,154,337,45.6973293768546,44.14758269720102,111,143,77.62237762237763,34,69,103,178,53,4,103,119,458
Bryce Drew,5.0,2000 - 2004,PG,209,3529,372,967,38.46949327817994,134,355,37.74647887323944,238,612,38.88888888888889,45.39813857290589,85,104,81.73076923076923,53,210,263,472,111,6,178,230,963
Chris Dudley,4.0,2000 - 2003,C,146,1410,72,191,37.696335078534034,0,2,0.0,72,189,38.095238095238095,37.696335078534034,31,78,39.743589743589745,156,245,401,36,24,64,58,251,175
Tim Duncan,17.0,2000 - 2016,C,1260,42201,9161,18202,50.32963410614219,29,151,19.205298013245034,9132,18051,50.58999501412664,50.40929568179321,5330,7628,69.8741478762454,3426,10117,13543,3880,925,2688,2956,2903,23681
Howard Eisley,7.0,2000 - 2006,PG,458,10653,1229,3112,39.49228791773779,404,1135,35.59471365638767,825,1977,41.7298937784522,45.98329048843188,478,578,82.69896193771626,117,737,854,1778,365,49,666,1045,3340
Obinna Ekezie,4.0,2000 - 2005,PF,143,1516,165,390,42.30769230769231,0,1,0.0,165,389,42.41645244215938,42.30769230769231,180,250,72.0,146,237,383,31,38,27,95,254,510
Mario Elie,2.0,2000 - 2001,SF,147,3723,299,703,42.53200568990042,110,286,38.46153846153847,189,417,45.32374100719424,50.355618776671406,181,218,83.02752293577981,86,318,404,324,131,21,190,268,889
Sean Elliott,2.0,2000 - 2001,SF,71,1620,185,445,41.57303370786517,68,166,40.963855421686745,117,279,41.935483870967744,49.21348314606742,85,116,73.27586206896551,23,194,217,109,35,27,70,114,523
Dale Ellis,1.0,2000 - 2000,SG,42,564,66,159,41.509433962264154,37,100,37.0,29,59,49.152542372881356,53.144654088050316,9,13,69.23076923076923,13,43,56,14,13,0,20,45,178
LaPhonso Ellis,4.0,2000 - 2003,PF,261,5725,796,1820,43.73626373626374,75,274,27.37226277372263,721,1546,46.636481241914616,45.79670329670329,338,459,73.63834422657952,448,780,1228,223,144,151,264,707,2005
Pervis Ellison,2.0,2000 - 2001,C,39,309,21,50,42.0,0,0,,21,50,42.0,42.0,17,23,73.91304347826086,31,48,79,16,10,10,16,80,59
Evan Eschmeyer,4.0,2000 - 2003,C,153,2138,158,341,46.33431085043988,0,0,,158,341,46.33431085043988,46.33431085043988,105,169,62.1301775147929,220,381,601,76,69,95,96,399,421
Patrick Ewing,4.0,2000 - 2011,C,213,5062,803,1797,44.68558708959377,0,7,0.0,803,1790,44.86033519553072,44.68558708959377,476,672,70.83333333333334,325,1129,1454,187,111,221,359,555,2082
Tony Farmer,1.0,2000 - 2000,PF,74,1199,127,312,40.705128205128204,8,44,18.181818181818183,119,268,44.40298507462687,41.98717948717949,203,265,76.60377358490567,118,177,295,74,66,16,82,167,465
Jamie Feick,2.0,2000 - 2001,C,87,2390,189,446,42.37668161434978,3,3,100.0,186,443,41.98645598194131,42.71300448430493,100,145,68.96551724137932,276,535,811,73,51,41,66,221,481
Danny Ferry,4.0,2000 - 2003,SF,257,4414,487,1056,46.11742424242424,167,390,42.82051282051282,320,666,48.048048048048045,54.02462121212122,118,136,86.76470588235294,145,481,626,207,73,63,154,475,1259
Michael Finley,11.0,2000 - 2010,SF,806,26549,4692,10667,43.986125433580206,1160,3034,38.23335530652604,3532,7633,46.27276300275121,49.42345551701509,1508,1822,82.7661909989023,675,2682,3357,2109,645,223,1006,1216,12052
Derek Fisher,15.0,2000 - 2014,PG,1075,28907,3353,8426,39.793496320911466,1157,3090,37.44336569579288,2196,5336,41.1544227886057,46.659150249228574,1771,2128,83.22368421052632,330,1947,2277,3155,1175,87,1206,2376,9634
Danny Fortson,8.0,2000 - 2007,C,310,5604,729,1537,47.430058555627845,1,6,16.666666666666664,728,1531,47.55062050947094,47.46258945998699,790,986,80.12170385395537,803,1352,2155,193,107,42,421,1027,2249
Greg Foster,4.0,2000 - 2003,C,157,1732,196,488,40.16393442622951,7,32,21.875,189,456,41.44736842105263,40.88114754098361,57,78,73.07692307692307,75,254,329,87,20,39,83,267,456
Jeff Foster,13.0,2000 - 2012,C,764,15750,1472,2961,49.7129348193178,7,54,12.962962962962962,1465,2907,50.39559683522532,49.83113812901047,796,1295,61.46718146718146,2101,3147,5248,703,507,308,613,1921,3747
Rick Fox,5.0,2000 - 2004,SF,360,9080,1083,2556,42.370892018779344,362,1030,35.14563106796116,721,1526,47.24770642201835,49.45226917057903,302,384,78.64583333333334,326,1011,1337,1034,287,94,524,986,2830
Adonal Foyle,10.0,2000 - 2009,C,634,11790,1197,2475,48.36363636363637,0,1,0.0,1197,2474,48.38318512530315,48.36363636363637,301,594,50.67340067340067,1149,1934,3083,312,236,1098,516,1391,2695
Steve Francis,9.0,2000 - 2008,PG,576,21632,3543,8267,42.857142857142854,575,1684,34.14489311163896,2968,6583,45.08582713048762,46.33482520866094,2785,3494,79.70807097882083,960,2255,3215,3473,846,223,2030,1813,10446
Todd Fuller,2.0,2000 - 2001,C,51,476,61,157,38.853503184713375,0,0,,61,157,38.853503184713375,38.853503184713375,40,61,65.57377049180327,43,85,128,6,12,10,30,56,162
Lawrence Funderburke,5.0,2000 - 2005,PF,219,2696,454,917,49.5092693565976,0,5,0.0,454,912,49.780701754385966,49.5092693565976,210,318,66.0377358490566,266,420,686,90,53,62,111,227,1118
Kevin Garnett,17.0,2000 - 2016,PF,1176,40128,8546,17114,49.93572513731448,153,553,27.66726943942134,8393,16561,50.67930680514462,50.3827275914456,4187,5231,80.04205696807493,2456,9812,12268,4514,1451,1510,2567,2797,21432
Dean Garrett,3.0,2000 - 2002,C,160,1618,141,319,44.20062695924764,0,0,,141,319,44.20062695924764,44.20062695924764,45,68,66.17647058823529,122,292,414,48,41,99,56,219,327
Kiwane Garris,1.0,2000 - 2000,SG,3,23,2,10,20.0,0,1,0.0,2,9,22.22222222222222,20.0,0,0,,0,1,1,2,0,0,1,0,4
Pat Garrity,9.0,2000 - 2008,PF,513,10524,1394,3373,41.32819448562111,624,1569,39.77055449330784,770,1804,42.68292682926829,50.57812036762526,388,475,81.6842105263158,317,1065,1382,425,238,101,397,1212,3800
Chris Gatling,3.0,2000 - 2002,PF,213,4290,825,1828,45.13129102844639,47,170,27.647058823529413,778,1658,46.92400482509047,46.41684901531728,504,718,70.19498607242339,324,775,1099,157,151,61,346,540,2201
Matt Geiger,3.0,2000 - 2002,C,104,1984,349,821,42.50913520097443,0,6,0.0,349,815,42.82208588957055,42.50913520097443,147,196,75.0,207,325,532,53,41,32,118,269,845
Devean George,11.0,2000 - 2010,SF,630,11682,1318,3360,39.226190476190474,427,1246,34.26966292134831,891,2114,42.147587511825925,45.58035714285714,473,656,72.10365853658537,546,1429,1975,543,436,230,447,1270,3536
Kendall Gill,6.0,2000 - 2005,SG,324,8420,1198,3006,39.85362608117099,61,242,25.206611570247933,1137,2764,41.13603473227207,40.86826347305389,529,724,73.06629834254143,266,807,1073,669,387,91,392,735,2986
Armen Gilliam,1.0,2000 - 2000,PF,50,782,133,305,43.606557377049185,0,1,0.0,133,304,43.75,43.606557377049185,67,86,77.90697674418605,72,137,209,42,12,16,55,83,333
Dion Glover,6.0,2000 - 2005,SG,294,6132,914,2222,41.13411341134113,148,467,31.69164882226981,766,1755,43.64672364672364,44.46444644464446,431,570,75.6140350877193,213,684,897,455,233,65,370,487,2407
Brian Grant,7.0,2000 - 2006,C,465,12677,1706,3535,48.26025459688826,1,6,16.666666666666664,1705,3529,48.313969963162364,48.27439886845827,803,1041,77.13736791546589,1033,2279,3312,516,282,238,637,1469,4216
Gary Grant,2.0,2000 - 2001,PG,7,41,11,21,52.38095238095239,0,0,,11,21,52.38095238095239,52.38095238095239,0,0,,0,3,3,2,1,0,2,4,22
Horace Grant,5.0,2000 - 2004,PF,289,8479,898,1932,46.48033126293996,0,8,0.0,898,1924,46.67359667359668,46.48033126293996,330,445,74.15730337078652,627,1231,1858,491,190,191,190,566,2126
Devin Gray,1.0,2000 - 2000,SF,21,124,15,37,40.54054054054054,0,0,,15,37,40.54054054054054,40.54054054054054,19,29,65.51724137931035,11,14,25,5,5,3,4,22,49
A.C. Green,2.0,2000 - 2001,PF,164,3340,317,711,44.585091420534454,1,10,10.0,316,701,45.07845934379458,44.655414908579466,145,206,70.3883495145631,267,532,799,119,83,26,98,246,780
Adrian Griffin,9.0,2000 - 2008,SG,477,7997,785,1794,43.75696767001115,50,180,27.77777777777778,735,1614,45.539033457249076,45.1505016722408,299,392,76.27551020408163,507,1005,1512,653,436,59,331,879,1919
Tom Gugliotta,6.0,2000 - 2005,PF,284,6287,815,1902,42.84963196635121,16,60,26.666666666666668,799,1842,43.37676438653638,43.27024185068349,268,345,77.68115942028986,422,957,1379,418,252,116,345,598,1914
Darvin Ham,6.0,2000 - 2005,SF,310,4225,355,690,51.449275362318836,4,16,25.0,351,674,52.07715133531158,51.73913043478261,197,395,49.87341772151899,371,405,776,199,106,121,249,591,911
Richard Hamilton,14.0,2000 - 2013,SG,921,29559,5969,13288,44.92022877784467,530,1530,34.64052287581699,5439,11758,46.257866984180986,46.91450933172788,3240,3805,85.15111695137976,794,2058,2852,3125,714,131,1977,2329,15708
Thomas Hamilton,1.0,2000 - 2000,C,22,273,35,79,44.303797468354425,0,0,,35,79,44.303797468354425,44.303797468354425,12,23,52.17391304347826,31,59,90,15,4,14,28,25,82
Tom Hammonds,2.0,2000 - 2001,PF,63,402,45,107,42.05607476635514,0,0,,45,107,42.05607476635514,42.05607476635514,34,58,58.620689655172406,36,69,105,11,8,3,24,63,124
Anfernee Hardaway,8.0,2000 - 2008,SG,335,9990,1453,3351,43.360190987764845,137,415,33.01204819277108,1316,2936,44.822888283378745,45.40435690838556,623,784,79.46428571428571,351,1043,1394,1182,407,121,666,760,3666
Tim Hardaway,10.0,2000 - 2019,SG,610,16529,2750,6779,40.566455229384864,1157,3316,34.89143546441496,1593,3463,46.00057753393012,49.10016226582092,1157,1424,81.25,204,1322,1526,1910,461,81,885,1062,7814
Ron Harper,2.0,2000 - 2001,PG,127,3181,339,802,42.269326683291766,52,178,29.213483146067414,287,624,45.993589743589745,45.51122194513716,134,195,68.71794871794872,142,361,503,383,124,64,194,234,864
Matt Harpring,10.0,2000 - 2009,SF,615,16470,2752,5713,48.170838438648694,148,449,32.962138084632514,2604,5264,49.46808510638298,49.46612987922283,1585,2096,75.62022900763358,1193,1959,3152,862,467,106,927,1636,7237
Al Harrington,15.0,2000 - 2014,PF,960,27849,5010,11262,44.485881726158766,977,2773,35.23260007212406,4033,8489,47.50854046413005,48.823477179897004,2195,3015,72.80265339966833,1475,3968,5443,1644,854,244,1827,3043,13192
Othella Harrington,9.0,2000 - 2008,PF,553,11258,1624,3227,50.32537960954448,0,7,0.0,1624,3220,50.43478260869565,50.32537960954448,941,1260,74.68253968253968,867,1612,2479,386,157,212,783,1541,4189
Lucious Harris,6.0,2000 - 2005,SG,443,9739,1315,3107,42.323785001609274,234,667,35.08245877061469,1081,2440,44.303278688524586,46.08947537817831,593,732,81.01092896174863,314,861,1175,690,313,44,320,561,3457
Antonio Harvey,4.0,2000 - 2003,PF,40,288,36,75,48.0,0,0,,36,75,48.0,48.0,13,20,65.0,19,43,62,14,4,19,21,45,85
Hersey Hawkins,2.0,2000 - 2001,SG,120,2303,215,512,41.9921875,72,187,38.50267379679144,143,325,44.0,49.0234375,161,182,88.46153846153845,48,207,255,206,107,24,119,191,663
Michael Hawkins,2.0,2000 - 2001,PG,22,112,6,22,27.27272727272727,3,9,33.33333333333333,3,13,23.076923076923077,34.090909090909086,1,2,50.0,2,10,12,26,2,0,9,15,16
Alan Henderson,8.0,2000 - 2007,PF,436,8721,1155,2443,47.277936962750715,2,16,12.5,1153,2427,47.50721054800165,47.318870241506346,620,966,64.18219461697723,915,1170,2085,222,224,193,433,875,2932
Cedric Henderson,3.0,2000 - 2002,SF,128,2138,246,619,39.74151857835218,4,27,14.814814814814813,242,592,40.87837837837838,40.064620355411954,103,157,65.60509554140127,54,179,233,138,74,42,139,204,599
Mark Hendrickson,1.0,2000 - 2000,PF,15,71,5,8,62.5,0,0,,5,8,62.5,62.5,3,4,75.0,3,10,13,6,2,1,3,8,13
Chris Herren,2.0,2000 - 2001,PG,70,1005,74,220,33.63636363636363,40,122,32.78688524590164,34,98,34.69387755102041,42.72727272727273,36,52,69.23076923076923,16,57,73,167,29,2,62,117,224
Grant Hill,13.0,2000 - 2013,SF,665,20545,3649,7419,49.18452621647123,197,576,34.20138888888889,3452,6843,50.44571094549174,50.51219840948915,2155,2682,80.35048471290082,643,2599,3242,1917,657,338,1266,1436,9650
Tyrone Hill,5.0,2000 - 2004,PF,231,6717,799,1736,46.025345622119815,0,3,0.0,799,1733,46.105020196191575,46.025345622119815,475,719,66.06397774687065,669,1316,1985,164,164,94,369,769,2073
Fred Hoiberg,6.0,2000 - 2005,SG,402,8360,793,1809,43.83637368711996,310,774,40.05167958656331,483,1035,46.666666666666664,52.40464344941957,512,595,86.05042016806723,110,1104,1214,748,355,49,238,608,2408
Derek Hood,1.0,2000 - 2000,PF,2,4,0,3,0.0,0,0,,0,3,0.0,0.0,0,0,,0,1,1,0,0,0,0,0,0
Jeff Hornacek,1.0,2000 - 2000,SG,77,2133,358,728,49.175824175824175,66,138,47.82608695652174,292,590,49.49152542372882,53.708791208791204,171,180,95.0,49,133,182,202,66,16,113,149,953
Robert Horry,9.0,2000 - 2008,PF,648,13330,1211,3064,39.523498694516974,423,1239,34.14043583535109,788,1825,43.17808219178082,46.42624020887728,614,844,72.74881516587678,915,1855,2770,1095,535,504,583,1432,3459
Allan Houston,6.0,2000 - 2005,SG,389,14380,2801,6231,44.95265607446638,634,1573,40.30514939605849,2167,4658,46.522112494632886,50.040121970791205,1410,1590,88.67924528301887,145,1036,1181,948,271,45,818,927,7646
Juwan Howard,14.0,2000 - 2013,PF,880,23699,3968,8611,46.08059458831727,2,23,8.695652173913043,3966,8588,46.180717279925474,46.092207641388924,1892,2403,78.73491468997086,1523,3306,4829,1512,482,198,1474,2374,9830
Troy Hudson,9.0,2000 - 2008,PG,484,10733,1648,4114,40.05833738454059,437,1283,34.06079501169135,1211,2831,42.776404097492055,45.369470102090425,723,844,85.66350710900474,177,643,820,1652,260,28,779,661,4456
Larry Hughes,12.0,2000 - 2012,SG,677,21380,3568,8786,40.61006146141589,516,1644,31.386861313868614,3052,7142,42.73312797535704,43.54655133166401,2135,2812,75.92460881934566,655,2195,2850,2213,1048,241,1486,1548,9787
Rick Hughes,1.0,2000 - 2000,PF,21,224,35,72,48.61111111111111,0,1,0.0,35,71,49.29577464788733,48.61111111111111,12,26,46.15384615384615,24,25,49,9,3,1,14,30,82
Lindsey Hunter,11.0,2000 - 2010,PG,531,10716,1312,3432,38.22843822843823,543,1494,36.34538152610442,769,1938,39.680082559339525,46.13927738927739,343,456,75.21929824561403,177,738,915,1198,526,88,518,898,3510
Allen Iverson,11.0,2000 - 2010,SG,710,29399,6758,15939,42.39914674697283,776,2494,31.11467522052927,5982,13445,44.49237634808479,44.83342744212309,5247,6615,79.31972789115646,478,2072,2550,4340,1540,108,2514,1246,19539
Bobby Jackson,10.0,2000 - 2009,PG,637,13807,2304,5462,42.18235078725742,658,1839,35.780315388798265,1646,3623,45.43196246204803,48.20578542658367,935,1182,79.10321489001691,502,1408,1910,1461,560,54,755,1137,6201
Jaren Jackson,4.0,2000 - 2019,SG,164,3464,515,1154,44.62738301559792,173,486,35.59670781893004,342,668,51.19760479041916,52.12305025996534,186,254,73.22834645669292,109,373,482,197,116,89,175,403,1389
Jermaine Jackson,5.0,2000 - 2006,SG,135,1344,89,222,40.090090090090094,3,19,15.789473684210526,86,203,42.364532019704434,40.765765765765764,81,114,71.05263157894737,34,111,145,184,42,9,78,127,262
Jim Jackson,7.0,2000 - 2006,SF,437,13209,1865,4509,41.361721002439566,515,1309,39.34300993124523,1350,3200,42.1875,47.072521623419824,617,721,85.5755894590846,388,1614,2002,1095,316,72,826,1014,4862
Mark Jackson,5.0,2000 - 2004,PG,370,9189,931,2214,42.05058717253839,272,759,35.83662714097497,659,1455,45.292096219931274,48.193315266485996,328,420,78.0952380952381,226,930,1156,2410,299,22,704,543,2462
Randell Jackson,1.0,2000 - 2000,PF,1,1,0,0,,0,0,,0,0,,,0,0,,0,0,0,0,0,0,0,0,0
Sam Jacobson,2.0,2000 - 2001,PG,66,740,117,230,50.8695652173913,9,24,37.5,108,206,52.42718446601942,52.826086956521735,32,44,72.72727272727273,28,49,77,36,33,3,33,132,275
Tim James,3.0,2000 - 2002,SF,43,261,26,79,32.91139240506329,1,3,33.33333333333333,25,76,32.89473684210527,33.54430379746836,15,23,65.21739130434783,23,23,46,11,2,9,13,33,68
Antawn Jamison,15.0,2000 - 2014,PF,1036,36580,7501,16630,45.105231509320504,1160,3355,34.575260804769,6341,13275,47.76647834274953,48.59290438965724,3431,4707,72.8914382834077,2426,5430,7856,1727,1010,405,1646,2478,19593
Harold Jamison,2.0,2000 - 2002,PF,37,250,29,63,46.03174603174603,0,0,,29,63,46.03174603174603,46.03174603174603,14,33,42.42424242424242,40,20,60,10,7,2,10,40,72
Anthony Johnson,11.0,2000 - 2010,PG,667,12401,1392,3297,42.22020018198362,285,786,36.25954198473282,1107,2511,44.086021505376344,46.54231119199272,545,724,75.27624309392266,226,886,1112,1838,452,79,681,1034,3614
Avery Johnson,5.0,2000 - 2004,PG,299,6280,886,1931,45.88296219575349,2,25,8.0,884,1906,46.37985309548793,45.93474883480062,358,495,72.32323232323232,81,295,376,1189,190,35,356,386,2132
DeMarco Johnson,1.0,2000 - 2000,PF,5,37,3,9,33.33333333333333,0,0,,3,9,33.33333333333333,33.33333333333333,0,0,,3,4,7,0,1,0,3,5,6
Ervin Johnson,7.0,2000 - 2006,C,442,8396,492,979,50.25536261491318,1,4,25.0,491,975,50.358974358974365,50.30643513789581,239,415,57.59036144578313,806,1584,2390,167,231,427,266,1217,1224
Kevin Johnson,1.0,2000 - 2000,PG,6,113,16,28,57.14285714285714,1,1,100.0,15,27,55.55555555555556,58.92857142857143,7,7,100.0,0,16,16,24,2,0,7,6,40
Larry Johnson,2.0,2000 - 2001,PF,135,4386,528,1250,42.24,109,337,32.34421364985163,419,913,45.89266155531216,46.6,230,295,77.96610169491525,177,566,743,302,81,36,191,414,1395
Charles Jones,1.0,2000 - 2000,PG,56,662,66,201,32.83582089552239,39,118,33.05084745762712,27,83,32.53012048192771,42.53731343283582,17,23,73.91304347826086,17,45,62,94,30,5,28,46,188
Damon Jones,10.0,2000 - 2009,PG,633,13117,1474,3611,40.819717529770145,916,2352,38.945578231292515,558,1259,44.3208895949166,53.503184713375795,337,466,72.3175965665236,109,921,1030,1764,244,20,534,665,4201
Eddie Jones,9.0,2000 - 2008,SG,610,20824,3034,7176,42.27982162764771,1029,2775,37.08108108108108,2005,4401,45.55782776641672,49.44955406911929,1765,2127,82.98072402444758,412,2141,2553,1736,886,332,925,1628,8862
Jumaine Jones,8.0,2000 - 2007,SF,471,9780,1294,3052,42.39842726081258,425,1218,34.893267651888344,869,1834,47.38276990185387,49.3610747051114,312,443,70.42889390519187,552,1435,1987,408,307,144,388,870,3325
Popeye Jones,5.0,2000 - 2004,PF,195,3120,350,829,42.21954161640531,7,20,35.0,343,809,42.398022249690975,42.64173703256936,166,215,77.20930232558139,387,574,961,185,77,34,137,387,873
Reggie Jordan,1.0,2000 - 2000,PG,36,243,17,53,32.075471698113205,0,1,0.0,17,52,32.69230769230769,32.075471698113205,7,13,53.84615384615385,16,25,41,32,12,2,19,29,41
Adam Keefe,2.0,2000 - 2001,C,129,1440,117,289,40.484429065743946,1,4,25.0,116,285,40.70175438596491,40.65743944636678,68,99,68.68686868686868,135,210,345,70,45,33,86,192,303
Shawn Kemp,4.0,2000 - 2003,C,304,6440,1038,2485,41.770623742454724,6,22,27.27272727272727,1032,2463,41.90012180267966,41.89134808853119,813,1052,77.28136882129277,531,1192,1723,310,254,185,573,978,2895
Steve Kerr,4.0,2000 - 2003,PG,227,2645,311,706,44.05099150141643,124,298,41.61073825503356,187,408,45.83333333333333,52.8328611898017,92,100,92.0,27,147,174,202,60,5,87,142,838
Jerome Kersey,2.0,2000 - 2001,SF,94,1553,178,423,42.08037825059102,0,10,0.0,178,413,43.09927360774818,42.08037825059102,37,57,64.91228070175438,66,204,270,84,81,55,57,197,393
Lari Ketner,2.0,2000 - 2001,PF,25,139,13,32,40.625,0,0,,13,32,40.625,40.625,8,12,66.66666666666666,12,22,34,2,4,3,12,20,34
Jason Kidd,14.0,2000 - 2013,PG,1044,37267,4516,11321,39.89046903983747,1606,4527,35.476032692732495,2910,6794,42.83191050927289,46.98348202455613,2222,2735,81.24314442413163,1154,5490,6644,8921,1958,335,2872,1907,12860
Gerard King,2.0,2000 - 2001,SF,107,1766,229,453,50.55187637969095,0,0,,229,453,50.55187637969095,50.55187637969095,85,111,76.57657657657657,123,256,379,80,48,26,88,226,543
Kerry Kittles,5.0,2000 - 2005,SG,302,9533,1537,3381,45.459923099674654,376,998,37.675350701402806,1161,2383,48.720100713386486,51.02040816326531,448,580,77.24137931034483,223,888,1111,754,443,123,322,494,3898
Joe Kleine,1.0,2000 - 2000,C,7,31,4,11,36.36363636363637,0,0,,4,11,36.36363636363637,36.36363636363637,3,3,100.0,0,6,6,2,1,0,2,7,11
Brevin Knight,10.0,2000 - 2009,PG,610,14507,1624,3990,40.70175438596491,16,107,14.953271028037381,1608,3883,41.411279938192116,40.902255639097746,982,1240,79.19354838709678,199,1202,1401,3523,963,62,1068,1470,4246
Travis Knight,4.0,2000 - 2003,C,189,1382,122,349,34.95702005730659,0,2,0.0,122,347,35.158501440922194,34.95702005730659,52,80,65.0,131,217,348,50,30,53,73,274,296
Toni Kukoc,7.0,2000 - 2006,SF,434,10218,1464,3451,42.422486235873656,398,1190,33.4453781512605,1066,2261,47.147279964617425,48.188930744711676,768,1088,70.58823529411765,368,1229,1597,1403,385,136,732,702,4094
Christian Laettner,6.0,2000 - 2005,PF,390,9485,1305,2670,48.87640449438202,22,91,24.175824175824175,1283,2579,49.74796432725863,49.28838951310862,678,825,82.18181818181817,567,1517,2084,826,365,199,566,1083,3310
Raef LaFrentz,9.0,2000 - 2008,C,551,14158,2168,4652,46.603611349957006,466,1284,36.29283489096573,1702,3368,50.53444180522565,51.6122098022356,722,1018,70.92337917485266,961,2371,3332,598,267,902,502,1825,5524
Andrew Lang,1.0,2000 - 2000,C,19,244,28,64,43.75,0,0,,28,64,43.75,43.75,3,7,42.857142857142854,16,44,60,3,8,6,5,31,59
Antonio Lang,1.0,2000 - 2000,SF,10,38,1,6,16.666666666666664,0,0,,1,6,16.666666666666664,16.666666666666664,4,5,80.0,0,5,5,2,4,1,2,8,6
Trajan Langdon,3.0,2000 - 2002,SG,119,1738,220,529,41.58790170132325,86,217,39.63133640552996,134,312,42.94871794871795,49.7164461247637,121,133,90.97744360902256,29,130,159,152,56,14,98,179,647
Rusty LaRue,3.0,2000 - 2004,PG,41,693,89,231,38.52813852813853,20,65,30.76923076923077,69,166,41.566265060240966,42.857142857142854,36,44,81.81818181818183,12,50,62,84,26,7,54,69,234
Tim Legler,1.0,2000 - 2000,SG,23,284,28,78,35.8974358974359,7,21,33.33333333333333,21,57,36.84210526315789,40.38461538461539,14,18,77.77777777777779,4,19,23,24,4,1,6,33,77
Voshon Lenard,7.0,2000 - 2006,SG,369,10104,1683,4134,40.711175616835995,552,1481,37.27211343686698,1131,2653,42.63098379193366,47.38751814223512,652,833,78.27130852340936,221,811,1032,798,307,95,510,776,4570
Quincy Lewis,4.0,2000 - 2004,SG,159,1853,232,584,39.726027397260275,37,111,33.33333333333333,195,473,41.2262156448203,42.89383561643836,66,93,70.96774193548387,71,139,210,96,59,36,98,335,567
Rashard Lewis,15.0,2000 - 2014,SF,1029,33396,5625,12427,45.264343767602796,1786,4619,38.666378003896945,3839,7808,49.16752049180328,52.45030980928623,2496,3097,80.59412334517275,1405,4003,5408,1761,1107,540,1557,2411,15532
Randy Livingston,8.0,2000 - 2007,PG,126,1599,196,500,39.2,25,75,33.33333333333333,171,425,40.23529411764706,41.699999999999996,83,98,84.6938775510204,41,139,180,252,73,17,114,183,500
Grant Long,4.0,2000 - 2003,PF,215,4783,405,941,43.03931987247609,7,39,17.94871794871795,398,902,44.12416851441242,43.41126461211477,271,374,72.45989304812835,217,605,822,287,189,38,233,453,1088
Luc Longley,2.0,2000 - 2001,C,97,1718,204,453,45.033112582781456,0,0,,204,453,45.033112582781456,45.033112582781456,93,114,81.57894736842105,126,263,389,84,25,51,158,272,501
Felipe Lopez,3.0,2000 - 2002,SG,202,2927,381,895,42.56983240223464,36,103,34.95145631067961,345,792,43.56060606060606,44.58100558659218,213,320,66.5625,143,295,438,190,112,48,172,323,1011
Tyronn Lue,10.0,2000 - 2009,PG,539,12376,1737,3974,43.70910920986412,453,1159,39.085418464193275,1284,2815,45.612788632326826,49.408656265727224,708,847,83.58913813459267,130,807,937,1702,281,10,648,1029,4635
George Lynch,6.0,2000 - 2005,SF,405,10089,1008,2381,42.33515329693407,113,354,31.92090395480226,895,2027,44.15392205229403,44.708105837883245,353,542,65.12915129151291,776,1421,2197,638,404,131,443,906,2482
Todd MacCulloch,4.0,2000 - 2003,C,223,3439,568,1049,54.14680648236415,0,0,,568,1049,54.14680648236415,54.14680648236415,233,363,64.18732782369146,340,548,888,121,61,177,154,478,1369
Sam Mack,2.0,2000 - 2002,SF,35,492,51,171,29.82456140350877,28,92,30.434782608695656,23,79,29.11392405063291,38.01169590643275,24,27,88.88888888888889,9,44,53,28,23,2,26,62,154
Don MacLean,2.0,2000 - 2001,PF,24,219,28,69,40.57971014492754,4,8,50.0,24,61,39.34426229508197,43.47826086956522,13,18,72.22222222222221,13,28,41,12,7,2,18,33,73
Corey Maggette,14.0,2000 - 2013,SF,827,23358,4065,8969,45.32277845913703,463,1431,32.3549965059399,3602,7538,47.784558238259486,47.90389118073364,4605,5599,82.24682979103412,915,3107,4022,1696,590,139,1874,2338,13198
Dan Majerle,3.0,2000 - 2002,SG,187,4794,356,970,36.70103092783505,246,720,34.166666666666664,110,250,44.0,49.381443298969074,115,152,75.6578947368421,75,600,675,384,190,47,132,358,1073
Karl Malone,5.0,2000 - 2004,PF,366,13191,2845,5909,48.14689456760873,16,53,30.18867924528302,2829,5856,48.3094262295082,48.28228126586563,2276,2900,78.48275862068965,599,2530,3129,1548,510,243,1051,994,7982
Matt Maloney,3.0,2000 - 2003,PG,120,2681,268,691,38.78437047756874,118,331,35.64954682779456,150,360,41.66666666666667,47.32272069464544,66,84,78.57142857142857,25,163,188,309,92,8,138,145,720
Danny Manning,4.0,2000 - 2003,PF,208,3163,480,1020,47.05882352941176,12,47,25.53191489361702,468,973,48.098663926002054,47.647058823529406,163,231,70.56277056277057,148,400,548,202,139,82,183,493,1135
Stephon Marbury,10.0,2000 - 2009,PG,648,24560,4523,10333,43.77237975418562,728,2259,32.226648959716684,3795,8074,47.002724795640326,47.29507403464628,2972,3739,79.48649371489704,430,1530,1960,4808,792,87,1917,1508,12746
Shawn Marion,16.0,2000 - 2015,SF,1163,40097,7289,15056,48.41259298618491,791,2390,33.096234309623426,6498,12666,51.30270014211275,51.03945270988311,2331,2877,81.02189781021897,2732,7369,10101,2198,1759,1233,1750,2535,17700
Sean Marks,10.0,2000 - 2011,C,222,2247,254,570,44.56140350877193,5,25,20.0,249,545,45.68807339449542,45.0,114,171,66.66666666666666,158,342,500,50,32,87,113,339,627
Donny Marshall,3.0,2000 - 2003,SF,29,163,11,43,25.581395348837212,2,8,25.0,9,35,25.71428571428571,27.906976744186046,17,24,70.83333333333334,8,17,25,5,5,0,6,21,41
Donyell Marshall,10.0,2000 - 2009,PF,641,17124,2793,6215,44.9396621078037,681,1857,36.67205169628433,2112,4358,48.46259752179899,50.418342719227674,1104,1479,74.64503042596348,1279,3233,4512,872,556,573,847,1488,7371
Darrick Martin,8.0,2000 - 2008,PG,220,2153,275,787,34.9428208386277,94,290,32.41379310344827,181,497,36.41851106639839,40.9148665819568,182,224,81.25,21,96,117,311,71,3,114,238,826
Jamal Mashburn,5.0,2000 - 2004,SF,293,11469,2217,5274,42.03640500568828,394,1052,37.452471482889734,1823,4222,43.17858834675509,45.77171027682973,1054,1293,81.51585460170146,272,1542,1814,1389,306,55,768,718,5882
Anthony Mason,4.0,2000 - 2003,PF,309,11649,1284,2634,48.747152619589976,1,3,33.33333333333333,1283,2631,48.76472824021285,48.7661351556568,922,1233,74.77696674776966,528,2003,2531,1170,243,88,548,785,3491
Tony Massenburg,6.0,2000 - 2005,PF,313,4459,549,1217,45.11092851273624,1,2,50.0,548,1215,45.10288065843621,45.15201314708299,303,413,73.36561743341404,352,716,1068,98,91,121,257,719,1402
Vernon Maxwell,2.0,2000 - 2001,SG,90,1649,242,713,33.94109396914446,101,334,30.239520958083833,141,379,37.203166226912934,41.02384291725105,129,180,71.66666666666667,19,126,145,124,59,12,88,147,714
Walter McCarty,7.0,2000 - 2006,PF,444,7183,707,1811,39.039204859193816,385,1079,35.68118628359592,322,732,43.98907103825137,49.66869133075649,224,331,67.6737160120846,225,827,1052,440,239,107,322,811,2023
George McCloud,3.0,2000 - 2002,SF,223,5955,722,1869,38.6302835741038,244,739,33.01759133964817,478,1130,42.30088495575221,45.157838416265385,432,525,82.28571428571428,194,566,760,729,159,72,395,520,2120
Jelani McCoy,7.0,2000 - 2008,C,234,3493,454,871,52.123995407577496,0,0,,454,871,52.123995407577496,52.123995407577496,159,325,48.92307692307693,258,584,842,131,64,173,235,479,1067
Antonio McDyess,11.0,2000 - 2011,PF,734,18830,3171,6314,50.22172949002217,0,10,0.0,3171,6304,50.30139593908629,50.22172949002217,1227,1881,65.23125996810208,1720,3659,5379,931,493,612,990,2084,7569
Tracy McGrady,13.0,2000 - 2012,SG,825,28373,6362,14630,43.48598769651401,1059,3122,33.92056374119154,5303,11508,46.0809871393813,47.10526315789474,3689,4934,74.76692338873126,1075,3654,4729,3950,1035,680,1883,1481,17472
Jim McIlvaine,2.0,2000 - 2001,C,84,1241,74,182,40.65934065934066,0,0,,74,182,40.65934065934066,40.65934065934066,37,68,54.41176470588235,114,151,265,40,33,132,47,240,185
Jeff McInnis,9.0,2000 - 2008,PG,528,15383,2116,4898,43.20130665577786,284,868,32.71889400921659,1832,4030,45.459057071960295,46.10044916292364,685,858,79.83682983682984,232,911,1143,2423,350,29,746,1142,5201
Derrick McKey,3.0,2000 - 2002,SF,139,2405,155,366,42.349726775956285,19,55,34.54545454545455,136,311,43.729903536977496,44.94535519125683,74,97,76.28865979381443,126,312,438,154,118,30,88,307,403
Aaron McKie,8.0,2000 - 2007,SG,453,11673,1428,3211,44.47212706322018,280,767,36.50586701434159,1148,2444,46.9721767594108,48.832139520398634,573,725,79.0344827586207,236,1326,1562,1396,543,89,662,902,3709
Roshown McLeod,2.0,2000 - 2001,SF,79,1782,276,664,41.566265060240966,4,35,11.428571428571429,272,629,43.24324324324324,41.86746987951807,99,121,81.81818181818183,79,179,258,110,39,13,117,174,655
Ron Mercer,6.0,2000 - 2005,SG,311,9205,1670,3951,42.26778030878259,52,182,28.57142857142857,1618,3769,42.929158928097635,42.92584155909896,581,725,80.13793103448276,237,670,907,641,264,84,462,587,3973
Andre Miller,17.0,2000 - 2016,PG,1304,40268,6035,13104,46.054639804639805,193,888,21.734234234234233,5842,12216,47.822527832351014,46.791056166056165,4015,4975,80.7035175879397,1373,3422,4795,8524,1546,227,3121,2882,16278
Anthony Miller,3.0,2000 - 2005,PF,41,496,55,102,53.92156862745098,0,0,,55,102,53.92156862745098,53.92156862745098,26,51,50.98039215686274,49,118,167,17,12,10,21,71,136
Brad Miller,13.0,2000 - 2012,C,830,24068,3368,7036,47.86810687890847,200,608,32.89473684210527,3168,6428,49.2843808338519,49.28936895963616,2550,3171,80.4162724692526,1673,4409,6082,2448,630,574,1335,2318,9486
Oliver Miller,2.0,2000 - 2004,C,99,1594,190,333,57.05705705705706,0,1,0.0,190,332,57.22891566265061,57.05705705705706,64,96,66.66666666666666,133,258,391,104,61,106,107,223,444
Reggie Miller,6.0,2000 - 2005,SG,457,15533,2252,5080,44.330708661417326,858,2261,37.947810703228654,1394,2819,49.45015963107485,52.775590551181104,1595,1742,91.5614236509759,168,1091,1259,1265,431,70,593,725,6957
Chris Mills,4.0,2000 - 2003,SF,122,2641,411,1016,40.452755905511815,70,207,33.81642512077295,341,809,42.15080346106304,43.89763779527559,200,245,81.63265306122449,140,316,456,159,65,25,111,252,1092
Terry Mills,2.0,2000 - 2001,PF,96,1955,225,522,43.103448275862064,98,259,37.83783783783784,127,263,48.28897338403042,52.490421455938694,25,34,73.52941176470588,54,357,411,90,41,25,56,262,573
Jason Miskiri,1.0,2000 - 2000,PG,1,3,0,1,0.0,0,1,0.0,0,0,,0.0,0,0,,0,0,0,1,0,0,0,2,0
Sam Mitchell,3.0,2000 - 2002,SF,222,2936,384,892,43.04932735426009,29,101,28.71287128712871,355,791,44.879898862199745,44.67488789237668,159,196,81.12244897959184,74,269,343,213,65,28,106,312,956
Cuttino Mobley,10.0,2000 - 2009,SG,698,26162,4147,9574,43.315228744516396,1032,2719,37.95513056270688,3115,6855,45.44128373450037,48.704825569250055,2151,2574,83.56643356643356,521,2270,2791,1894,834,290,1441,1612,11477
Nazr Mohammed,17.0,2000 - 2016,C,979,15770,2387,4897,48.744129058607314,0,8,0.0,2387,4889,48.82389036612804,48.744129058607314,1011,1578,64.06844106463878,1790,2881,4671,373,427,635,907,2134,5785
Eric Montross,3.0,2000 - 2002,C,154,1636,126,325,38.76923076923077,0,1,0.0,126,324,38.88888888888889,38.76923076923077,24,74,32.432432432432435,106,279,385,42,29,58,88,288,276
Mikki Moore,12.0,2000 - 2012,C,562,10251,1268,2303,55.058619192357796,2,13,15.384615384615385,1266,2290,55.28384279475983,55.10204081632652,715,963,74.24714434060229,777,1418,2195,409,179,306,537,1541,3253
Alonzo Mourning,8.0,2000 - 2008,C,383,9689,1783,3309,53.88334844363855,1,9,11.11111111111111,1782,3300,54.0,53.89845874886673,1203,1851,64.99189627228526,778,1735,2513,284,111,984,727,1156,4770
Chris Mullin,2.0,2000 - 2001,SG,67,956,116,293,39.59044368600683,64,162,39.50617283950617,52,131,39.69465648854962,50.51194539249146,61,69,88.40579710144928,24,93,117,56,44,19,47,88,357
Eric Murdock,1.0,2000 - 2000,PG,40,693,79,205,38.53658536585366,16,42,38.095238095238095,63,163,38.65030674846626,42.4390243902439,51,80,63.74999999999999,15,62,77,108,47,5,58,67,225
Gheorghe Muresan,1.0,2000 - 2000,C,30,267,41,90,45.55555555555556,0,0,,41,90,45.55555555555556,45.55555555555556,23,38,60.526315789473685,24,44,68,9,0,12,16,52,105
Lamond Murray,6.0,2000 - 2006,SF,375,8914,1561,3636,42.931793179317935,307,785,39.10828025477707,1254,2851,43.98456681866012,47.15346534653465,684,897,76.2541806020067,399,1122,1521,501,322,136,580,727,4113
Tracy Murray,5.0,2000 - 2004,SF,209,3120,495,1208,40.97682119205298,199,513,38.79142300194932,296,695,42.589928057553955,49.2135761589404,177,214,82.71028037383178,111,322,433,127,74,42,151,301,1366
Dikembe Mutombo,10.0,2000 - 2009,C,593,14661,1393,2754,50.580973129992735,0,0,,1393,2754,50.580973129992735,50.580973129992735,1181,1625,72.67692307692307,1558,3519,5077,340,172,1115,709,1374,3967
Steve Nash,15.0,2000 - 2014,PG,1036,34452,5865,11819,49.623487604704295,1532,3558,43.05789769533446,4333,8261,52.45127708509866,56.10457737541247,2906,3201,90.7841299593877,563,2742,3305,9716,779,96,3234,1647,16168
Tyrone Nesby,3.0,2000 - 2002,SG,205,5371,736,1866,39.442658092175776,156,508,30.708661417322837,580,1358,42.70986745213549,43.62272240085745,300,390,76.92307692307693,238,528,766,288,187,73,216,524,1928
Rasho Nesterovic,11.0,2000 - 2010,C,809,17953,2567,5109,50.24466627520062,1,13,7.6923076923076925,2566,5096,50.35321821036107,50.25445292620865,376,644,58.38509316770186,1510,2625,4135,835,330,934,747,2182,5511
Johnny Newman,3.0,2000 - 2002,SF,211,4536,636,1466,43.38335607094134,153,423,36.17021276595745,483,1043,46.308724832214764,48.60163710777626,488,584,83.56164383561644,82,297,379,194,145,25,216,524,1913
Moochie Norris,7.0,2000 - 2006,PG,425,7411,799,1971,40.537798072044644,108,381,28.346456692913385,691,1590,43.45911949685535,43.277524099441905,516,687,75.10917030567686,202,634,836,1186,310,19,503,462,2222
Dirk Nowitzki,20.0,2000 - 2019,PF,1475,50410,11033,23398,47.153602872040345,1968,5142,38.2730455075846,9065,18256,49.65490797546012,51.35909052055732,7141,8111,88.04093206756257,1427,9900,11327,3604,1181,1254,2421,3496,31175
Jermaine O'Neal,15.0,2000 - 2014,C,870,25787,4927,10558,46.66603523394583,14,91,15.384615384615385,4913,10467,46.9379956052355,46.7323356696344,2897,4006,72.31652521218173,1830,5009,6839,1331,449,1722,1776,2708,12765
Shaquille O'Neal,12.0,2000 - 2011,C,752,24933,6390,10912,58.55938416422287,0,6,0.0,6390,10906,58.59160095360352,58.55938416422287,3473,6658,52.1628116551517,2383,5179,7562,1895,375,1535,1979,2565,16253
Charles Oakley,5.0,2000 - 2004,PF,264,7120,661,1670,39.5808383233533,26,96,27.083333333333332,635,1574,40.3430749682338,40.35928143712575,247,305,80.98360655737706,368,1368,1736,673,240,110,402,825,1595
Lamar Odom,14.0,2000 - 2013,PF,961,32131,4811,10393,46.29077263542769,664,2126,31.23236124176858,4147,8267,50.16329986694085,49.48523044356779,2495,3599,69.32481244790219,1821,6238,8059,3554,848,892,2253,2916,12781
Hakeem Olajuwon,3.0,2000 - 2002,C,163,3972,670,1407,47.61904761904761,0,5,0.0,670,1402,47.78887303851641,47.61904761904761,239,394,60.659898477157356,287,784,1071,199,185,248,252,376,1579
Kevin Ollie,11.0,2000 - 2010,PG,619,9795,804,1948,41.27310061601643,9,28,32.142857142857146,795,1920,41.40625,41.5041067761807,743,929,79.97847147470398,137,835,972,1433,319,24,445,767,2360
Michael Olowokandi,8.0,2000 - 2007,C,455,11850,1616,3710,43.55795148247979,0,0,,1616,3710,43.55795148247979,43.55795148247979,502,818,61.36919315403423,831,2226,3057,302,199,642,813,1381,3734
Greg Ostertag,7.0,2000 - 2006,C,511,9646,829,1720,48.19767441860465,1,6,16.666666666666664,828,1714,48.30805134189031,48.22674418604651,516,945,54.6031746031746,999,1684,2683,363,120,815,466,1243,2175
Bo Outlaw,9.0,2000 - 2008,PF,521,11230,991,1742,56.888633754305395,2,13,15.384615384615385,989,1729,57.200694042799306,56.946039035591276,410,760,53.94736842105263,913,1541,2454,842,444,548,562,1150,2394
Doug Overton,4.0,2000 - 2004,PG,148,2070,226,582,38.83161512027492,31,114,27.192982456140353,195,468,41.66666666666667,41.49484536082475,57,75,76.0,35,135,170,276,47,3,121,182,540
Billy Owens,2.0,2000 - 2001,PF,107,2098,238,588,40.476190476190474,14,54,25.925925925925924,224,534,41.947565543071164,41.66666666666667,82,146,56.16438356164384,183,323,506,152,65,33,124,259,572
Robert Pack,5.0,2000 - 2004,PG,173,2837,376,905,41.546961325966855,17,51,33.33333333333333,359,854,42.03747072599532,42.48618784530387,225,291,77.31958762886599,59,212,271,618,146,5,287,245,994
Scott Padgett,8.0,2000 - 2007,PF,448,5613,679,1658,40.95295536791315,240,644,37.267080745341616,439,1014,43.293885601577905,48.19059107358263,276,375,73.6,402,825,1227,325,182,86,253,681,1874
Milt Palacio,7.0,2000 - 2006,PG,470,8421,863,2060,41.89320388349515,40,170,23.52941176470588,823,1890,43.544973544973544,42.86407766990291,477,663,71.94570135746606,159,672,831,1194,302,58,596,685,2243
Anthony Parker,7.0,2000 - 2012,SG,455,13553,1635,3680,44.42934782608695,587,1446,40.594744121715074,1048,2234,46.91136974037601,52.40489130434782,547,685,79.85401459854015,233,1315,1548,1110,428,82,484,775,4404
Cherokee Parks,5.0,2000 - 2004,C,205,2808,322,675,47.7037037037037,1,9,11.11111111111111,321,666,48.1981981981982,47.77777777777778,85,133,63.90977443609023,200,412,612,113,77,112,103,330,730
Andrae Patterson,1.0,2000 - 2000,PF,5,20,3,4,75.0,0,0,,3,4,75.0,75.0,0,0,,1,1,2,1,1,0,1,4,6
Ruben Patterson,9.0,2000 - 2008,SF,625,15811,2657,5129,51.80347046207838,34,190,17.894736842105264,2623,4939,53.107916582304114,52.134919087541434,1540,2405,64.03326403326403,1263,1404,2667,1148,746,246,1154,1402,6888
Gary Payton,11.0,2000 - 2019,PG,663,22688,4112,9067,45.35127385022609,610,1893,32.223983095615424,3502,7174,48.81516587677725,48.715120767618835,1576,2114,74.55061494796594,518,2103,2621,4188,855,142,1314,1339,10410
Anthony Peeler,6.0,2000 - 2005,SG,436,10424,1376,3248,42.364532019704434,476,1212,39.273927392739274,900,2036,44.20432220039292,49.69211822660098,318,383,83.02872062663185,224,865,1089,985,360,64,453,777,3546
Will Perdue,2.0,2000 - 2001,C,80,1070,65,177,36.72316384180791,0,0,,65,177,36.72316384180791,36.72316384180791,52,109,47.706422018348626,94,186,280,67,17,44,78,134,182
Sam Perkins,2.0,2000 - 2001,PF,145,2619,270,667,40.479760119940025,127,328,38.71951219512195,143,339,42.18289085545723,50.0,112,135,82.96296296296296,96,361,457,109,64,51,82,197,779
Elliot Perry,3.0,2000 - 2002,PG,111,1350,198,444,44.5945945945946,12,44,27.27272727272727,186,400,46.5,45.94594594594595,67,86,77.90697674418605,22,89,111,225,64,2,105,82,475
Chuck Person,1.0,2000 - 2000,SF,37,340,37,123,30.081300813008134,24,95,25.263157894736842,13,28,46.42857142857143,39.83739837398374,4,8,50.0,6,47,53,22,5,2,12,56,102
Wesley Person,6.0,2000 - 2005,SG,366,9452,1382,3031,45.595513032002636,479,1114,42.998204667863554,903,1917,47.104851330203445,53.497195645001646,303,380,79.73684210526316,148,935,1083,600,224,99,285,406,3546
Bobby Phills,1.0,2000 - 2000,SG,28,825,152,335,45.37313432835821,30,91,32.967032967032964,122,244,50.0,49.850746268656714,47,65,72.3076923076923,17,54,71,79,41,8,48,72,381
Eric Piatkowski,9.0,2000 - 2008,SG,462,8892,1174,2730,43.00366300366301,531,1312,40.47256097560975,643,1418,45.345557122708044,52.72893772893773,512,599,85.47579298831386,247,752,999,463,215,62,341,611,3391
Paul Pierce,18.0,2000 - 2017,SF,1295,44248,8384,18818,44.553087469444144,2059,5612,36.689237348538846,6325,13206,47.89489625927609,50.02391327452439,6779,8383,80.86603841107002,975,6243,7218,4593,1670,695,3419,3504,25606
Scottie Pippen,5.0,2000 - 2004,SF,295,9201,1221,2792,43.73209169054441,255,807,31.59851301115242,966,1985,48.66498740554156,48.29871060171919,530,705,75.177304964539,338,1175,1513,1398,438,145,726,715,3227
Scot Pollard,9.0,2000 - 2008,C,457,7796,790,1607,49.159925326695706,0,2,0.0,790,1605,49.22118380062305,49.159925326695706,471,668,70.50898203592814,829,1366,2195,207,283,324,287,1089,2051
Olden Polynice,3.0,2000 - 2004,C,165,3450,409,813,50.307503075030745,1,3,33.33333333333333,408,810,50.37037037037037,50.3690036900369,45,155,29.03225806451613,324,509,833,69,58,161,152,503,864
Terry Porter,3.0,2000 - 2002,PG,220,4585,540,1224,44.11764705882353,236,554,42.59927797833935,304,670,45.37313432835821,53.75816993464052,297,369,80.48780487804879,60,496,556,677,147,36,289,256,1613
James Posey,12.0,2000 - 2011,SF,864,23260,2495,6091,40.96207519290757,1035,2967,34.883720930232556,1460,3124,46.73495518565941,49.45821704153669,1394,1701,81.95179306290417,755,3306,4061,1413,917,298,981,2330,7419
Vitaly Potapenko,8.0,2000 - 2007,C,400,7564,1015,2101,48.31032841504045,0,2,0.0,1015,2099,48.35636017151025,48.31032841504045,431,607,71.00494233937397,738,1125,1863,246,170,111,445,954,2461
Brent Price,3.0,2000 - 2002,PG,67,543,53,157,33.75796178343949,30,87,34.48275862068966,23,70,32.857142857142854,43.31210191082803,49,59,83.05084745762711,13,36,49,83,22,2,61,84,185
Laron Profit,4.0,2000 - 2006,SG,135,1537,173,413,41.88861985472155,21,89,23.595505617977526,152,324,46.913580246913575,44.43099273607748,74,104,71.15384615384616,52,157,209,166,70,25,116,138,441
Aleksandar Radojevic,2.0,2000 - 2005,C,15,152,8,26,30.76923076923077,0,0,,8,26,30.76923076923077,30.76923076923077,10,16,62.5,11,25,36,7,2,3,20,37,26
Theo Ratliff,12.0,2000 - 2011,C,527,13829,1397,2868,48.709902370990235,0,1,0.0,1397,2867,48.726892221834675,48.709902370990235,866,1219,71.04183757178015,964,2125,3089,352,253,1334,681,1491,3660
Eldridge Recasner,3.0,2000 - 2002,PG,56,464,43,127,33.85826771653544,14,44,31.818181818181817,29,83,34.93975903614458,39.37007874015748,15,19,78.94736842105263,13,41,54,49,7,1,28,35,115
Bryant Reeves,2.0,2000 - 2001,C,144,3605,506,1114,45.421903052064636,1,8,12.5,505,1106,45.66003616636528,45.46678635547576,220,307,71.66123778501628,258,584,842,162,76,92,209,488,1233
Khalid Reeves,1.0,2000 - 2000,PG,3,48,3,12,25.0,0,3,0.0,3,9,33.33333333333333,25.0,5,5,100.0,2,2,4,13,2,0,6,8,11
Don Reid,4.0,2000 - 2003,PF,172,1986,232,450,51.55555555555556,0,0,,232,450,51.55555555555556,51.55555555555556,115,179,64.24581005586593,180,340,520,59,67,129,125,492,579
J.R. Reid,2.0,2000 - 2001,PF,40,641,55,132,41.66666666666667,1,7,14.285714285714285,54,125,43.2,42.04545454545455,49,64,76.5625,34,91,125,19,21,6,21,85,160
Rodrick Rhodes,1.0,2000 - 2000,SF,1,8,0,3,0.0,0,0,,0,3,0.0,0.0,0,0,,1,0,1,0,2,0,2,0,0
Glen Rice,7.0,2000 - 2015,SF,271,7294,1049,2484,42.230273752012884,296,810,36.54320987654321,753,1674,44.982078853046595,48.188405797101446,614,721,85.15950069348128,165,735,900,394,135,34,313,531,3008
Mitch Richmond,3.0,2000 - 2002,SG,175,4322,752,1800,41.77777777777778,156,436,35.77981651376147,596,1364,43.6950146627566,46.111111111111114,483,544,88.78676470588235,66,350,416,353,171,26,278,338,2143
Isaiah Rider,3.0,2000 - 2002,SG,137,3463,687,1625,42.276923076923076,96,287,33.44947735191638,591,1338,44.17040358744394,45.230769230769226,288,360,80.0,117,330,447,342,71,15,280,248,1758
Stanley Roberts,1.0,2000 - 2000,C,5,51,5,16,31.25,0,1,0.0,5,15,33.33333333333333,31.25,0,3,0.0,6,9,15,3,1,1,2,15,10
Ryan Robertson,1.0,2000 - 2000,SG,1,25,2,6,33.33333333333333,0,2,0.0,2,4,50.0,33.33333333333333,1,1,100.0,0,0,0,0,0,0,0,0,5
Clifford Robinson,8.0,2000 - 2007,PF,606,18623,2725,6531,41.72408513244526,676,1884,35.881104033970274,2049,4647,44.092963202065846,46.8994028479559,1108,1567,70.70835992342055,564,1753,2317,1446,539,515,992,1721,7234
David Robinson,4.0,2000 - 2003,C,302,8907,1466,2946,49.762389680923285,0,3,0.0,1466,2943,49.81311586816174,49.762389680923285,1143,1590,71.88679245283018,755,1861,2616,413,315,631,473,778,4075
Eddie Robinson,5.0,2000 - 2004,SF,278,5345,852,1681,50.684116597263525,8,32,25.0,844,1649,51.182534869617946,50.92207019631172,226,306,73.8562091503268,241,523,764,252,216,91,215,345,1938
Glenn Robinson,11.0,2000 - 2019,SF,562,15296,3117,6824,45.67702227432591,425,1245,34.13654618473896,2692,5579,48.252374977594556,48.791031652989446,1254,1527,82.12180746561886,549,1999,2548,1005,489,221,1066,1032,7913
Dennis Rodman,1.0,2000 - 2000,PF,12,389,12,31,38.70967741935484,0,1,0.0,12,30,40.0,38.70967741935484,10,14,71.42857142857143,48,123,171,14,2,1,19,41,34
Carlos Rogers,3.0,2000 - 2002,C,114,1813,269,477,56.39412997903563,2,21,9.523809523809524,267,456,58.55263157894737,56.60377358490566,120,208,57.692307692307686,160,292,452,54,29,58,85,127,660
Rodney Rogers,6.0,2000 - 2005,PF,436,10428,1723,3923,43.92046902880449,401,1138,35.23725834797891,1322,2785,47.46858168761221,49.03135355595208,659,903,72.97895902547066,583,1387,1970,792,407,201,703,1332,4506
Roy Rogers,1.0,2000 - 2000,PF,40,355,35,88,39.77272727272727,0,1,0.0,35,87,40.229885057471265,39.77272727272727,19,41,46.34146341463415,33,47,80,9,2,38,10,36,89
Sean Rooks,5.0,2000 - 2004,C,339,5221,551,1320,41.74242424242424,1,4,25.0,550,1316,41.79331306990882,41.78030303030303,273,356,76.68539325842697,282,706,988,268,123,191,251,743,1376
Jalen Rose,8.0,2000 - 2007,SF,565,19861,3673,8361,43.93015189570625,615,1670,36.82634730538922,3058,6691,45.70318338066059,47.607941633775866,1998,2404,83.11148086522464,299,1947,2246,2240,448,207,1397,1538,9959
Malik Rose,10.0,2000 - 2009,PF,659,11842,1579,3639,43.39104149491619,13,73,17.80821917808219,1566,3566,43.91475042063937,43.569661995053586,1230,1623,75.78558225508318,966,1969,2935,604,398,247,918,1583,4401
Michael Ruffin,9.0,2000 - 2009,PF,414,5966,258,634,40.694006309148264,0,3,0.0,258,631,40.88748019017432,40.694006309148264,200,436,45.87155963302752,729,903,1632,250,199,193,273,942,716
Bryon Russell,7.0,2000 - 2006,SF,439,10733,1239,3000,41.3,423,1125,37.6,816,1875,43.519999999999996,48.35,738,952,77.52100840336135,397,1182,1579,670,434,92,451,1059,3639
Arvydas Sabonis,3.0,2000 - 2003,C,205,4196,721,1475,48.88135593220339,11,40,27.500000000000004,710,1435,49.47735191637631,49.25423728813559,417,518,80.5019305019305,236,943,1179,351,144,189,257,462,1870
John Salley,1.0,2000 - 2000,C,45,303,25,69,36.231884057971016,0,0,,25,69,36.231884057971016,36.231884057971016,21,28,75.0,20,45,65,26,8,14,18,67,71
Detlef Schrempf,2.0,2000 - 2001,SF,103,2059,226,528,42.803030303030305,24,60,40.0,202,468,43.162393162393165,45.07575757575758,202,242,83.47107438016529,96,314,410,241,44,20,128,225,678
Dennis Scott,1.0,2000 - 2000,SF,66,1263,125,333,37.53753753753754,71,189,37.56613756613756,54,144,37.5,48.1981981981982,48,57,84.21052631578947,16,90,106,69,28,9,30,104,369
Malik Sealy,1.0,2000 - 2000,SF,82,2392,371,780,47.56410256410256,10,35,28.57142857142857,361,745,48.45637583892618,48.205128205128204,177,218,81.19266055045871,119,233,352,197,76,19,110,197,929
Brian Shaw,4.0,2000 - 2003,SG,284,4613,449,1167,38.47472150814053,127,390,32.56410256410256,322,777,41.44144144144144,43.91602399314481,120,159,75.47169811320755,132,619,751,651,141,57,258,369,1145
Dickey Simpkins,2.0,2000 - 2002,PF,70,1654,111,274,40.51094890510949,0,1,0.0,111,273,40.65934065934066,40.51094890510949,65,120,54.166666666666664,124,248,372,101,22,22,128,217,287
Brian Skinner,13.0,2000 - 2012,PF,587,10652,1161,2348,49.44633730834753,2,6,33.33333333333333,1159,2342,49.487617421007684,49.48892674616695,466,825,56.484848484848484,899,1889,2788,287,246,519,500,1250,2790
Joe Smith,12.0,2000 - 2011,PF,746,17353,2582,5603,46.08245582723541,8,41,19.51219512195122,2574,5562,46.27831715210356,46.15384615384615,1549,1950,79.43589743589745,1542,2812,4354,644,353,531,736,2096,6721
Michael Smith,2.0,2000 - 2001,PF,125,2755,214,410,52.19512195121951,0,2,0.0,214,408,52.450980392156865,52.19512195121951,162,255,63.52941176470588,293,600,893,157,84,60,107,283,590
Steve Smith,6.0,2000 - 2005,SG,414,10153,1423,3202,44.440974391005625,413,1047,39.44603629417383,1010,2155,46.8677494199536,50.89006870705809,998,1145,87.16157205240175,318,705,1023,770,230,92,474,827,4257
Rik Smits,1.0,2000 - 2000,C,79,1852,431,890,48.426966292134836,0,1,0.0,431,889,48.4814398200225,48.426966292134836,156,211,73.93364928909952,94,307,401,85,20,100,108,249,1018
Eric Snow,9.0,2000 - 2008,PG,624,19334,1800,4258,42.27336777829967,42,202,20.792079207920793,1758,4056,43.34319526627219,42.7665570690465,1213,1561,77.70659833440102,349,1436,1785,3535,750,96,1131,1603,4855
Felton Spencer,3.0,2000 - 2002,C,76,510,33,79,41.77215189873418,0,0,,33,79,41.77215189873418,41.77215189873418,52,88,59.09090909090909,47,77,124,8,15,18,32,129,118
Latrell Sprewell,6.0,2000 - 2005,SF,476,18028,3035,7297,41.592435247361934,532,1535,34.65798045602606,2503,5762,43.43977785491149,45.237768946142246,1472,1795,82.00557103064067,323,1520,1843,1711,552,128,1124,863,8074
Ryan Stack,1.0,2000 - 2000,PF,25,198,17,51,33.33333333333333,0,1,0.0,17,50,34.0,33.33333333333333,18,27,66.66666666666666,15,30,45,5,4,11,17,47,52
Jerry Stackhouse,14.0,2000 - 2013,SG,696,20622,3796,9320,40.72961373390558,711,2247,31.64218958611482,3085,7073,43.61657005513926,44.54399141630901,3187,3777,84.37913688112259,549,1542,2091,2350,577,217,1728,1158,11490
John Starks,3.0,2000 - 2002,SG,178,4241,590,1538,38.36150845253576,152,448,33.92857142857143,438,1090,40.18348623853211,43.30299089726918,172,211,81.51658767772511,54,269,323,429,148,14,213,445,1504
Vladimir Stepania,5.0,2000 - 2004,C,247,3413,402,946,42.49471458773784,2,12,16.666666666666664,400,934,42.82655246252677,42.600422832980975,185,344,53.779069767441854,417,688,1105,82,100,121,181,424,991
Joe Stephens,1.0,2000 - 2000,SF,13,181,19,51,37.254901960784316,0,8,0.0,19,43,44.18604651162791,37.254901960784316,3,4,75.0,13,23,36,11,7,3,6,9,41
Michael Stewart,6.0,2000 - 2005,C,163,1148,69,180,38.333333333333336,0,0,,69,180,38.333333333333336,38.333333333333336,49,84,58.333333333333336,109,163,272,22,23,55,45,230,187
Bryant Stith,3.0,2000 - 2002,SG,173,3860,401,988,40.58704453441296,132,366,36.0655737704918,269,622,43.247588424437296,47.26720647773279,283,336,84.22619047619048,108,345,453,271,140,32,153,280,1217
John Stockton,4.0,2000 - 2003,PG,328,9670,1401,2791,50.19706198495163,158,411,38.44282238442822,1243,2380,52.226890756302524,53.027588677893235,960,1143,83.98950131233596,209,697,906,2719,564,76,772,779,3920
Peja Stojakovic,12.0,2000 - 2011,SF,756,25941,4684,10346,45.27353566595786,1703,4214,40.412909349786425,2981,6132,48.61382909328115,53.503769572781756,2174,2426,89.61253091508657,704,2935,3639,1336,706,99,1037,1355,13245
Damon Stoudamire,9.0,2000 - 2008,PG,606,18418,2587,6406,40.38401498595067,792,2185,36.24713958810069,1795,4221,42.52546789860222,46.56571963783953,976,1138,85.76449912126537,430,1533,1963,3117,570,38,1151,1146,6942
Erick Strickland,6.0,2000 - 2005,SG,373,7358,943,2365,39.87315010570824,310,837,37.03703703703704,633,1528,41.42670157068063,46.42706131078224,527,631,83.51822503961965,156,827,983,904,299,26,460,700,2723
Mark Strickland,4.0,2000 - 2003,SF,163,2049,318,672,47.32142857142857,2,6,33.33333333333333,316,666,47.44744744744745,47.470238095238095,110,170,64.70588235294117,144,295,439,66,50,57,87,189,748
Rod Strickland,6.0,2000 - 2005,PG,323,8202,1104,2579,42.80728964715006,25,113,22.123893805309734,1079,2466,43.75506893755069,43.29197363319116,658,894,73.60178970917227,215,693,908,1783,313,53,630,483,2891
Derek Strong,2.0,2000 - 2001,PF,48,639,66,165,40.0,1,5,20.0,65,160,40.625,40.303030303030305,39,51,76.47058823529412,45,107,152,11,19,3,34,45,172
Bruno Sundov,6.0,2000 - 2005,C,99,513,77,215,35.81395348837209,5,24,20.833333333333336,72,191,37.696335078534034,36.97674418604651,10,19,52.63157894736842,32,75,107,17,15,14,29,102,169
Bob Sura,6.0,2000 - 2005,SG,400,10395,1360,3240,41.9753086419753,315,956,32.94979079497908,1045,2284,45.75306479859895,46.836419753086425,961,1330,72.25563909774436,430,1171,1601,1528,405,67,775,922,3996
Wally Szczerbiak,10.0,2000 - 2009,SF,651,20052,3486,7193,48.463784234672595,590,1453,40.605643496214725,2896,5740,50.452961672473876,52.5649937439177,1633,1899,85.99262769878884,671,1931,2602,1532,388,160,970,1380,9195
Zan Tabak,2.0,2000 - 2001,C,73,891,114,220,51.81818181818182,0,0,,114,220,51.81818181818182,51.81818181818182,25,55,45.45454545454545,81,164,245,37,13,39,68,138,253
Johnny Taylor,1.0,2000 - 2000,SF,6,34,5,14,35.714285714285715,1,1,100.0,4,13,30.76923076923077,39.285714285714285,0,0,,2,4,6,1,1,1,2,5,11
Maurice Taylor,7.0,2000 - 2007,PF,417,10306,1839,3948,46.58054711246201,4,26,15.384615384615385,1835,3922,46.78735339112697,46.63120567375886,619,874,70.82379862700229,573,1341,1914,503,196,190,746,1202,4301
Jason Terry,19.0,2000 - 2018,SG,1410,42034,6914,15585,44.363169714469045,2282,6010,37.97004991680532,4632,9575,48.37597911227154,51.684311838306066,2771,3278,84.53325198291641,502,2772,3274,5415,1603,275,2415,2577,18881
Jamel Thomas,2.0,2000 - 2001,SF,12,102,14,37,37.83783783783784,1,6,16.666666666666664,13,31,41.935483870967744,39.189189189189186,1,1,100.0,5,9,14,6,4,0,11,8,30
John Thomas,3.0,2000 - 2006,C,115,1125,97,208,46.63461538461539,0,1,0.0,97,207,46.85990338164252,46.63461538461539,46,91,50.54945054945055,86,106,192,28,30,29,40,205,240
Kenny Thomas,11.0,2000 - 2010,PF,632,17306,2309,4966,46.49617398308498,59,242,24.380165289256198,2250,4724,47.62912785774767,47.09021345147,1199,1715,69.91253644314868,1447,2894,4341,975,527,276,1054,1581,5876
Kurt Thomas,14.0,2000 - 2013,PF,963,23876,3336,6829,48.85049055498609,9,28,32.142857142857146,3327,6801,48.91927657697398,48.9163860008786,1070,1366,78.33089311859443,1679,4793,6472,1091,619,779,1035,3063,7751
Tim Thomas,11.0,2000 - 2010,SF,697,18745,3020,6959,43.39703980456962,879,2370,37.088607594936704,2141,4589,46.65504467204184,49.7126023854002,1332,1736,76.72811059907833,651,2314,2965,1136,529,271,1053,1969,8251
Otis Thorpe,2.0,2000 - 2001,PF,100,1424,184,374,49.19786096256685,0,3,0.0,184,371,49.59568733153639,49.19786096256685,49,72,68.05555555555556,106,205,311,62,38,16,91,244,417
Robert Traylor,6.0,2000 - 2005,C,389,5457,733,1573,46.598855689764775,4,23,17.391304347826086,729,1550,47.03225806451613,46.72600127145582,356,611,58.265139116202946,591,867,1458,274,236,262,358,939,1826
Gary Trent,6.0,2000 - 2019,SF,271,4118,699,1420,49.225352112676056,5,34,14.705882352941178,694,1386,50.072150072150066,49.401408450704224,254,400,63.5,353,579,932,223,87,80,222,515,1657
Mirsad Turkcan,1.0,2000 - 2000,PF,17,90,14,38,36.84210526315789,0,6,0.0,14,32,43.75,36.84210526315789,5,8,62.5,13,20,33,5,3,1,8,14,33
Wayne Turner,1.0,2000 - 2000,PG,3,41,1,6,16.666666666666664,0,0,,1,6,16.666666666666664,16.666666666666664,2,6,33.33333333333333,1,2,3,5,0,0,3,4,4
Nick Van Exel,7.0,2000 - 2006,PG,452,14020,2313,5765,40.12142237640936,706,1982,35.62058526740666,1607,3783,42.47951361353423,46.244579358196006,867,1098,78.96174863387978,183,1187,1370,2660,295,49,892,634,6199
Keith Van Horn,7.0,2000 - 2006,SF,471,14249,2628,5860,44.846416382252556,512,1378,37.15529753265602,2116,4482,47.21106648817492,49.215017064846414,1303,1574,82.78271918678526,866,2277,3143,729,365,217,965,1386,7071
Jacque Vaughn,10.0,2000 - 2009,PG,712,12152,1245,2876,43.28929068150209,90,254,35.43307086614173,1155,2622,44.05034324942792,44.85396383866481,700,894,78.29977628635348,143,836,979,1823,389,14,722,1190,3280
Loy Vaught,2.0,2000 - 2001,PF,94,841,112,258,43.41085271317829,0,3,0.0,112,255,43.92156862745098,43.41085271317829,19,26,73.07692307692307,77,187,264,34,27,11,37,119,243
Fred Vinson,1.0,2000 - 2000,SG,8,40,5,17,29.411764705882355,2,7,28.57142857142857,3,10,30.0,35.294117647058826,1,2,50.0,0,1,1,0,3,0,4,2,13
Antoine Walker,9.0,2000 - 2008,PF,687,23744,4484,10916,41.077317698790765,1178,3637,32.389331866923285,3306,7279,45.41832669322709,46.47306705753023,1442,2262,63.748894783377544,1230,3725,4955,2505,775,328,1863,1841,11588
Samaki Walker,7.0,2000 - 2006,PF,322,5415,609,1328,45.85843373493976,1,6,16.666666666666664,608,1322,45.99092284417549,45.89608433734939,349,529,65.97353497164461,438,1059,1497,205,80,238,266,610,1568
Ben Wallace,13.0,2000 - 2012,C,941,29533,2353,5012,46.94732641660016,7,51,13.725490196078432,2346,4961,47.28885305381979,47.0171588188348,1021,2429,42.03375874845616,3170,6546,9716,1399,1250,1964,979,1824,5734
John Wallace,4.0,2000 - 2004,SF,183,2183,409,927,44.12081984897519,12,44,27.27272727272727,397,883,44.960362400906,44.7680690399137,188,233,80.68669527896995,106,256,362,88,39,47,152,273,1018
Rasheed Wallace,12.0,2000 - 2013,PF,856,28253,4957,10932,45.3439443834614,1029,3043,33.81531383503122,3928,7889,49.79084801622513,50.05031101353824,1718,2320,74.05172413793103,1174,4789,5963,1580,877,1205,1229,2412,12661
Rex Walters,1.0,2000 - 2000,PG,33,389,38,91,41.75824175824176,5,20,25.0,33,71,46.478873239436616,44.505494505494504,12,16,75.0,8,28,36,65,6,0,29,44,93
Charlie Ward,6.0,2000 - 2005,PG,347,7613,806,2004,40.21956087824351,423,1127,37.53327417923691,383,877,43.671607753705814,50.77345309381237,223,279,79.92831541218638,112,762,874,1340,390,62,498,683,2258
Clarence Weatherspoon,6.0,2000 - 2005,PF,387,9534,1088,2302,47.2632493483927,0,1,0.0,1088,2301,47.28378965667101,47.2632493483927,712,921,77.30727470141152,823,1807,2630,371,281,259,372,791,2888
Chris Webber,9.0,2000 - 2008,PF,501,18450,4377,9487,46.13681880468009,80,300,26.666666666666668,4297,9187,46.7726134755633,46.5584484030779,1735,2429,71.42857142857143,1166,3670,4836,2146,701,592,1328,1544,10569
Bonzi Wells,9.0,2000 - 2008,SG,584,15098,2803,6091,46.0187161385651,222,680,32.64705882352941,2581,5411,47.699131399002034,47.84107699885076,1288,1842,69.92399565689468,796,1932,2728,1246,768,191,1209,1521,7116
Bill Wennington,1.0,2000 - 2000,C,7,57,6,19,31.57894736842105,0,0,,6,19,31.57894736842105,31.57894736842105,2,2,100.0,5,14,19,1,2,2,1,13,14
David Wesley,8.0,2000 - 2007,SG,551,18562,2636,6417,41.078385538413585,722,1987,36.33618520382486,1914,4430,43.20541760722348,46.70406732117812,1278,1625,78.64615384615384,278,1064,1342,1992,658,84,931,1332,7272
Doug West,2.0,2000 - 2001,SG,53,752,70,183,38.25136612021858,0,5,0.0,70,178,39.325842696629216,38.25136612021858,40,47,85.1063829787234,22,64,86,57,15,12,23,101,180
Mark West,1.0,2000 - 2000,C,22,127,5,12,41.66666666666667,0,0,,5,12,41.66666666666667,41.66666666666667,5,8,62.5,6,25,31,2,2,4,6,23,15
Jahidi White,6.0,2000 - 2005,C,314,5722,719,1411,50.95676824946847,0,1,0.0,719,1410,50.99290780141844,50.95676824946847,467,868,53.801843317972356,684,1202,1886,62,116,344,381,848,1905
Chris Whitney,5.0,2000 - 2004,PG,290,6568,814,2041,39.88241058304753,378,1008,37.5,436,1033,42.20716360116166,49.14257716805487,429,494,86.8421052631579,49,425,474,1034,217,18,372,596,2435
Aaron Williams,9.0,2000 - 2008,C,556,10138,1310,2667,49.11886014248219,1,12,8.333333333333332,1309,2655,49.303201506591336,49.137607799025126,814,1097,74.20237010027347,846,1504,2350,433,231,442,543,1466,3435
Alvin Williams,7.0,2000 - 2007,PG,356,10488,1444,3431,42.0868551442728,185,594,31.14478114478115,1259,2837,44.37786394078252,44.78286213931798,516,680,75.88235294117646,209,768,977,1644,460,94,509,724,3589
Eric Williams,8.0,2000 - 2007,SF,480,10901,1146,2844,40.29535864978903,208,644,32.298136645962735,938,2200,42.63636363636364,43.9521800281294,1023,1383,73.96963123644251,442,1049,1491,688,389,71,504,1151,3523
Jason Williams,11.0,2000 - 2011,PG,738,21383,2834,7082,40.016944365998306,1138,3461,32.880670326495235,1696,3621,46.83789008561171,48.05139791019486,819,999,81.98198198198197,178,1479,1657,4312,838,59,1500,1009,7625
Jerome Williams,6.0,2000 - 2005,PF,427,10119,1130,2252,50.17761989342806,1,25,4.0,1129,2227,50.696003592276604,50.199822380106575,790,1231,64.17546709991878,1098,1867,2965,396,491,110,473,959,3051
Lorenzo Williams,1.0,2000 - 2000,PF,8,76,7,9,77.77777777777779,0,0,,7,9,77.77777777777779,77.77777777777779,0,0,,12,13,25,1,3,6,3,13,14
Monty Williams,4.0,2000 - 2003,SF,246,4272,657,1344,48.88392857142857,3,24,12.5,654,1320,49.54545454545455,48.995535714285715,320,465,68.81720430107528,274,499,773,307,136,55,297,490,1637
Scott Williams,6.0,2000 - 2005,C,306,5048,692,1523,45.436638214051214,3,12,25.0,689,1511,45.59894109861019,45.535128036769535,242,320,75.625,481,895,1376,123,156,174,194,790,1629
Shammond Williams,6.0,2000 - 2007,PG,323,5347,676,1683,40.16636957813429,256,700,36.57142857142857,420,983,42.726347914547304,47.771836007130126,281,352,79.82954545454545,106,412,518,764,196,14,331,379,1889
Walt Williams,4.0,2000 - 2003,SF,262,5720,814,1931,42.15432418436043,342,863,39.62920046349942,472,1068,44.19475655430712,51.00983946141895,269,350,76.85714285714286,190,730,920,382,139,108,274,590,2239
Corliss Williamson,8.0,2000 - 2007,SF,561,11955,2277,4653,48.93617021276596,5,24,20.833333333333336,2272,4629,49.08187513501836,48.98989898989899,1316,1744,75.45871559633028,772,1319,2091,529,285,147,809,1502,5875
Kevin Willis,7.0,2000 - 2007,C,362,5974,898,2053,43.740867023867516,2,15,13.333333333333334,896,2038,43.96467124631992,43.78957622990745,403,545,73.94495412844037,634,1087,1721,158,169,160,335,815,2201
Dedric Willoughby,1.0,2000 - 2000,PG,25,508,61,179,34.07821229050279,29,98,29.591836734693878,32,81,39.50617283950617,42.17877094972067,39,51,76.47058823529412,11,40,51,66,23,2,37,32,190
David Wingate,2.0,2000 - 2001,SG,8,41,4,12,33.33333333333333,0,0,,4,12,33.33333333333333,33.33333333333333,0,0,,1,1,2,5,1,2,2,8,8
Haywoode Workman,1.0,2000 - 2000,PG,36,350,31,90,34.44444444444444,14,43,32.55813953488372,17,47,36.17021276595745,42.22222222222222,10,15,66.66666666666666,1,25,26,61,20,0,18,37,86
Metta World Peace,17.0,2000 - 2017,SF,991,31440,4666,11266,41.41665187289188,1154,3402,33.9212228101117,3512,7864,44.659206510681585,46.538256701579975,2572,3596,71.52391546162403,1159,3289,4448,2631,1721,522,1791,2586,13058
Lorenzen Wright,10.0,2000 - 2009,C,584,13397,1960,4280,45.794392523364486,1,22,4.545454545454546,1959,4258,46.00751526538281,45.806074766355145,767,1189,64.50798990748528,1160,2345,3505,485,342,389,669,1666,4688
Tim Young,1.0,2000 - 2000,C,25,137,13,39,33.33333333333333,0,0,,13,39,33.33333333333333,33.33333333333333,28,36,77.77777777777779,13,22,35,5,2,1,9,18,54
Mahmoud Abdul-Rauf,1.0,2001 - 2001,PG,41,486,120,246,48.78048780487805,4,14,28.57142857142857,116,232,50.0,49.59349593495935,22,29,75.86206896551724,5,20,25,76,9,1,26,50,266
Courtney Alexander,3.0,2001 - 2003,PG,187,4067,655,1552,42.20360824742268,41,121,33.88429752066116,614,1431,42.90705800139762,43.524484536082475,339,417,81.29496402877699,124,285,409,227,111,18,203,377,1690
Dalibor Bagaric,3.0,2001 - 2003,C,95,973,97,269,36.059479553903344,0,2,0.0,97,267,36.329588014981276,36.059479553903344,57,102,55.88235294117647,84,154,238,37,29,43,72,163,251
Erick Barkley,2.0,2001 - 2002,PG,27,266,32,90,35.55555555555556,4,15,26.666666666666668,28,75,37.333333333333336,37.77777777777778,9,10,90.0,5,16,21,40,19,1,17,31,77
Raja Bell,12.0,2001 - 2012,SG,706,19813,2581,5949,43.38544293158514,956,2357,40.560033941450996,1625,3592,45.23942093541203,51.42040679105732,880,1101,79.92733878292462,408,1560,1968,1208,484,130,695,1840,6998
David Benoit,1.0,2001 - 2001,SF,49,446,71,147,48.29931972789115,5,13,38.46153846153847,66,134,49.25373134328358,50.0,31,39,79.48717948717949,20,61,81,22,6,6,28,75,178
Mark Blount,9.0,2001 - 2009,C,605,13981,2020,4011,50.36150585888806,37,103,35.92233009708738,1983,3908,50.74206755373593,50.82273747195213,864,1195,72.30125523012553,895,1889,2784,513,327,508,933,1554,4941
Brian Cardinal,12.0,2001 - 2012,PF,456,6477,664,1628,40.78624078624078,243,653,37.21286370597244,421,975,43.17948717948718,48.249385749385745,537,624,86.0576923076923,286,764,1050,465,295,69,330,890,2108
Mateen Cleaves,6.0,2001 - 2006,PG,167,1863,233,599,38.898163606010016,12,45,26.666666666666668,221,554,39.891696750902526,39.89983305509182,131,180,72.77777777777777,33,142,175,310,67,5,201,213,609
John Coker,1.0,2001 - 2001,C,6,32,1,8,12.5,0,0,,1,8,12.5,12.5,0,0,,3,2,5,2,1,0,2,4,2
Jason Collier,5.0,2001 - 2005,C,151,2178,338,743,45.49125168236878,7,20,35.0,331,723,45.78146611341632,45.96231493943472,158,214,73.83177570093457,175,268,443,51,36,32,120,295,841
Sean Colson,1.0,2001 - 2001,PG,13,44,6,24,25.0,1,5,20.0,5,19,26.31578947368421,27.083333333333332,2,4,50.0,2,4,6,10,1,0,2,6,15
Jamal Crawford,19.0,2001 - 2019,SG,1326,38988,6750,16463,41.00103261859928,2220,6377,34.81260780931473,4530,10086,44.91374182034503,47.74342464921339,3694,4286,86.18758749416705,466,2482,2948,4538,1179,271,2476,2007,19414
Terry Davis,1.0,2001 - 2001,PF,19,228,12,25,48.0,0,0,,12,25,48.0,48.0,9,22,40.909090909090914,24,29,53,7,1,1,5,34,33
Keyon Dooling,13.0,2001 - 2013,PG,728,14134,1810,4356,41.551882460973374,446,1277,34.92560689115113,1364,3079,44.300097434231894,46.6712580348944,1001,1253,79.88826815642457,132,832,964,1601,463,75,803,1221,5067
Tyus Edney,1.0,2001 - 2001,PG,24,263,35,91,38.46153846153847,1,6,16.666666666666664,34,85,40.0,39.010989010989015,35,39,89.74358974358975,5,19,24,54,17,0,25,17,106
Kevin Edwards,1.0,2001 - 2001,SG,46,634,56,170,32.94117647058823,5,19,26.31578947368421,51,151,33.77483443708609,34.411764705882355,43,53,81.13207547169812,23,59,82,52,29,8,37,46,160
Khalid El-Amin,1.0,2001 - 2001,PG,50,936,115,311,36.97749196141479,28,84,33.33333333333333,87,227,38.32599118942731,41.47909967845659,56,72,77.77777777777779,21,60,81,145,48,2,54,99,314
Marcus Fizer,6.0,2001 - 2006,PF,289,6032,1103,2536,43.49369085173502,21,110,19.090909090909093,1082,2426,44.60016488046167,43.9077287066246,555,803,69.11581569115816,375,965,1340,352,134,81,428,648,2782
Ruben Garces,1.0,2001 - 2001,PF,13,73,7,22,31.818181818181817,0,0,,7,22,31.818181818181817,31.818181818181817,2,8,25.0,16,13,29,5,3,2,5,14,16
Chris Garner,1.0,2001 - 2001,PG,8,149,7,37,18.91891891891892,0,7,0.0,7,30,23.333333333333332,18.91891891891892,5,6,83.33333333333334,2,10,12,18,7,1,9,18,19
Eddie Gill,7.0,2001 - 2009,PG,187,2033,179,496,36.08870967741936,63,197,31.979695431472084,116,299,38.79598662207358,42.439516129032256,150,177,84.7457627118644,28,179,207,217,104,14,139,209,571
Anthony Goldwire,5.0,2001 - 2006,PG,82,930,104,270,38.51851851851852,46,133,34.58646616541353,58,137,42.33576642335766,47.03703703703704,44,56,78.57142857142857,12,73,85,129,32,0,40,56,298
Steve Goodrich,2.0,2001 - 2002,PF,21,183,9,28,32.142857142857146,1,3,33.33333333333333,8,25,32.0,33.92857142857143,5,9,55.55555555555556,8,18,26,11,3,3,11,24,24
A.J. Guyton,3.0,2001 - 2003,PG,80,1246,166,440,37.72727272727273,73,193,37.82383419689119,93,247,37.65182186234818,46.02272727272727,37,45,82.22222222222221,22,58,80,147,20,12,62,58,442
Zendon Hamilton,6.0,2001 - 2006,C,134,1560,176,400,44.0,0,0,,176,400,44.0,44.0,233,353,66.0056657223796,184,280,464,33,39,28,108,215,585
Jason Hart,9.0,2001 - 2010,PG,341,5289,614,1473,41.683638832315,64,203,31.527093596059114,550,1270,43.30708661417323,43.8560760353021,331,420,78.80952380952381,76,491,567,774,253,34,275,528,1623
Donnell Harvey,5.0,2001 - 2005,PF,205,3318,453,985,45.98984771573604,1,10,10.0,452,975,46.35897435897436,46.04060913705584,243,369,65.85365853658537,261,566,827,161,97,80,209,464,1150
Eddie House,11.0,2001 - 2011,PG,717,12405,2078,5077,40.92968288359267,817,2096,38.979007633587784,1261,2981,42.30124119423012,48.975773094347055,383,450,85.11111111111111,164,1059,1223,1112,470,58,569,927,5356
Zydrunas Ilgauskas,11.0,2001 - 2011,C,756,20415,3724,7909,47.085598685042356,30,96,31.25,3694,7813,47.280174068859594,47.27525603742572,2283,2911,78.42665750601168,2148,3276,5424,880,365,1185,1354,2464,9761
Marc Jackson,7.0,2001 - 2007,C,387,7572,1194,2680,44.55223880597015,7,31,22.58064516129032,1187,2649,44.80936202340506,44.68283582089552,843,1036,81.37065637065636,630,1025,1655,311,147,102,467,775,3238
Stephen Jackson,14.0,2001 - 2014,SF,858,27398,4604,11112,41.43268538516919,1252,3763,33.2713260696253,3352,7349,45.61164784324398,47.066234701223905,2516,3154,79.7717184527584,674,2654,3328,2634,1109,317,2141,2043,12976
DerMarr Johnson,7.0,2001 - 2008,SF,344,5930,770,1872,41.13247863247863,274,815,33.61963190184049,496,1057,46.925260170293285,48.4508547008547,307,389,78.9203084832905,192,577,769,304,198,149,349,598,2121
Garth Joseph,1.0,2001 - 2001,C,4,16,1,5,20.0,0,0,,1,5,20.0,20.0,0,2,0.0,2,0,2,1,0,1,2,1,2
Dan Langhi,4.0,2001 - 2004,SF,133,1253,172,440,39.09090909090909,11,38,28.947368421052634,161,402,40.049751243781095,40.340909090909086,38,62,61.29032258064516,54,145,199,39,30,12,35,106,393
Art Long,3.0,2001 - 2003,SF,98,1220,148,323,45.82043343653251,2,3,66.66666666666666,146,320,45.625,46.13003095975232,47,97,48.45360824742268,130,189,319,48,27,42,85,220,345
Mark Madsen,9.0,2001 - 2009,C,453,5335,381,834,45.68345323741007,1,16,6.25,380,818,46.454767726161364,45.743405275779374,212,402,52.736318407960205,559,598,1157,181,116,102,206,866,975
Jamaal Magloire,12.0,2001 - 2012,C,680,14621,1763,3675,47.97278911564626,0,7,0.0,1763,3668,48.06434023991276,47.97278911564626,1391,2176,63.92463235294118,1418,2990,4408,386,224,603,998,1792,4917
Kenyon Martin,15.0,2001 - 2015,PF,757,23134,3875,8031,48.25052919935251,66,282,23.404255319148938,3809,7749,49.15472964253452,48.66143693188893,1509,2398,62.92743953294412,1312,3847,5159,1439,893,864,1318,2498,9325
Desmond Mason,10.0,2001 - 2010,SF,643,19641,2931,6535,44.85080336648814,66,254,25.984251968503933,2865,6281,45.61375577137399,45.3557765876052,1839,2485,74.00402414486922,804,2059,2863,1049,441,230,1032,1432,7767
Dan McClintock,1.0,2001 - 2001,C,6,58,9,18,50.0,0,0,,9,18,50.0,50.0,0,5,0.0,10,7,17,1,0,2,3,11,18
Paul McPherson,1.0,2001 - 2001,PG,55,595,109,216,50.46296296296296,2,12,16.666666666666664,107,204,52.450980392156865,50.92592592592593,42,58,72.41379310344827,40,39,79,38,25,4,47,80,262
Stanislav Medvedenko,7.0,2001 - 2007,PF,263,3340,590,1311,45.00381388253242,2,13,15.384615384615385,588,1298,45.300462249614796,45.08009153318078,208,281,74.02135231316726,335,409,744,136,88,42,159,518,1390
Chris Mihm,8.0,2001 - 2009,C,436,8758,1253,2731,45.880629805931896,3,13,23.076923076923077,1250,2718,45.989698307579104,45.935554741852805,753,1069,70.43966323666979,865,1437,2302,223,128,444,535,1264,3262
Darius Miles,7.0,2001 - 2009,SF,446,11730,1874,3973,47.1683866096149,22,131,16.793893129770993,1852,3842,48.20406038521604,47.44525547445255,737,1250,58.96,575,1615,2190,840,384,495,892,1023,4507
Mike Miller,17.0,2001 - 2017,SF,1032,27812,4016,8747,45.912884417514576,1590,3910,40.66496163682864,2426,4837,50.1550547860244,55.00171487367097,1351,1757,76.89243027888446,632,3744,4376,2666,573,229,1561,2043,10973
Jerome Moiso,5.0,2001 - 2005,C,145,1392,158,323,48.91640866873065,0,3,0.0,158,320,49.375,48.91640866873065,70,118,59.32203389830508,126,269,395,38,45,68,104,183,386
Hanno Mottola,2.0,2001 - 2002,C,155,2360,292,661,44.175491679273826,1,16,6.25,291,645,45.11627906976744,44.251134644478064,130,166,78.3132530120482,130,312,442,75,31,28,137,337,715
Mamadou N'Diaye,5.0,2001 - 2005,C,69,858,85,199,42.71356783919598,0,1,0.0,85,198,42.92929292929293,42.71356783919598,92,125,73.6,88,137,225,8,17,64,40,146,262
Lee Nailon,6.0,2001 - 2006,SF,306,5820,1121,2366,47.37954353338969,1,9,11.11111111111111,1120,2357,47.51803139584217,47.400676246830095,379,482,78.63070539419087,379,557,936,298,133,53,320,596,2622
Eduardo Najera,12.0,2001 - 2012,PF,619,11213,1204,2505,48.063872255489024,110,354,31.07344632768362,1094,2151,50.860065086006514,50.25948103792415,534,796,67.08542713567839,897,1410,2307,493,446,231,402,1378,3052
Ira Newble,8.0,2001 - 2008,SF,380,7645,782,1753,44.609241300627495,85,249,34.13654618473896,697,1504,46.34308510638298,47.03365658870508,281,361,77.8393351800554,403,711,1114,342,204,105,289,695,1930
Olumide Oyedeji,3.0,2001 - 2003,C,93,587,50,101,49.504950495049506,0,0,,50,101,49.504950495049506,49.504950495049506,27,41,65.85365853658537,61,135,196,11,16,15,30,106,127
Andy Panko,1.0,2001 - 2001,SF,1,1,0,0,,0,0,,0,0,,,0,0,,0,0,0,0,0,0,0,0,0
Mike Penberthy,2.0,2001 - 2002,PG,56,863,93,224,41.517857142857146,55,139,39.568345323741006,38,85,44.70588235294118,53.79464285714286,31,35,88.57142857142857,10,55,65,73,24,2,34,57,272
Morris Peterson,11.0,2001 - 2011,SG,711,19366,2747,6567,41.830363940916705,1009,2702,37.34270910436713,1738,3865,44.96765847347995,49.51271509060454,1125,1456,77.26648351648352,569,1914,2483,1090,639,136,716,1606,7628
Mark Pope,4.0,2001 - 2005,PF,121,1415,101,241,41.90871369294606,9,49,18.367346938775512,92,192,47.91666666666667,43.77593360995851,33,57,57.89473684210527,81,150,231,56,29,39,36,200,244
Chris Porter,1.0,2001 - 2001,SF,51,1147,173,445,38.87640449438202,0,5,0.0,173,440,39.31818181818182,38.87640449438202,94,141,66.66666666666666,89,100,189,61,45,6,59,111,440
Lavor Postell,3.0,2001 - 2003,SG,61,446,59,176,33.52272727272727,11,44,25.0,48,132,36.36363636363637,36.64772727272727,66,83,79.51807228915662,11,34,45,13,12,2,35,28,195
Joel Przybilla,13.0,2001 - 2013,C,592,11733,896,1624,55.172413793103445,0,3,0.0,896,1621,55.27452190006169,55.172413793103445,501,900,55.666666666666664,1112,2553,3665,256,157,836,574,1604,2293
Michael Redd,12.0,2001 - 2012,SG,629,20104,4207,9405,44.73152578415736,1045,2751,37.98618684114867,3162,6654,47.52028854824166,50.28708133971291,2513,2998,83.82254836557705,622,1789,2411,1338,579,66,963,1002,11972
Quentin Richardson,13.0,2001 - 2013,SF,783,20785,2923,7360,39.71467391304348,1167,3288,35.49270072992701,1756,4072,43.1237721021611,47.642663043478265,1019,1420,71.7605633802817,933,2733,3666,1138,607,148,868,1529,8032
Terrance Roberson,1.0,2001 - 2001,SF,3,13,0,2,0.0,0,1,0.0,0,1,0.0,0.0,0,0,,0,1,1,1,0,0,2,3,0
Jamal Robinson,1.0,2001 - 2001,SF,6,72,3,22,13.636363636363635,0,2,0.0,3,20,15.0,13.636363636363635,0,0,,3,8,11,2,6,0,3,7,6
James Robinson,1.0,2001 - 2001,PG,6,50,4,11,36.36363636363637,2,5,40.0,2,6,33.33333333333333,45.45454545454545,0,0,,0,8,8,0,4,1,4,5,10
Larry Robinson,2.0,2001 - 2002,PG-SG,36,642,68,188,36.17021276595745,45,118,38.13559322033898,23,70,32.857142857142854,48.138297872340424,21,24,87.5,23,66,89,36,28,2,25,47,202
Soumaila Samake,2.0,2001 - 2003,C,47,303,28,72,38.88888888888889,0,0,,28,72,38.88888888888889,38.88888888888889,12,26,46.15384615384615,32,44,76,5,2,19,6,36,68
Pepe Sanchez,2.0,2001 - 2003,PG,38,187,9,33,27.27272727272727,0,1,0.0,9,32,28.125,27.27272727272727,2,2,100.0,7,14,21,49,16,1,8,24,20
Daniel Santiago,4.0,2001 - 2005,C,122,1418,153,326,46.93251533742331,0,0,,153,326,46.93251533742331,46.93251533742331,111,162,68.51851851851852,76,184,260,38,39,47,85,231,417
Shawnelle Scott,2.0,2001 - 2002,C,48,396,54,116,46.55172413793103,0,0,,54,116,46.55172413793103,46.55172413793103,17,42,40.476190476190474,76,77,153,12,8,12,26,72,125
Reggie Slater,3.0,2001 - 2003,PF,89,874,124,240,51.66666666666667,0,0,,124,240,51.66666666666667,51.66666666666667,108,165,65.45454545454545,101,125,226,31,25,11,53,160,356
Jabari Smith,4.0,2001 - 2005,C,108,1063,125,303,41.254125412541256,1,8,12.5,124,295,42.03389830508474,41.41914191419142,78,113,69.02654867256636,49,129,178,66,37,26,54,166,329
Mike Smith,1.0,2001 - 2001,SF,17,180,19,59,32.20338983050847,3,18,16.666666666666664,16,41,39.02439024390244,34.74576271186441,10,16,62.5,10,12,22,10,5,3,7,8,51
Tony Smith,1.0,2001 - 2001,SG,6,78,8,23,34.78260869565217,0,2,0.0,8,21,38.095238095238095,34.78260869565217,1,2,50.0,2,1,3,10,7,0,9,12,17
DeShawn Stevenson,13.0,2001 - 2013,SG,824,18396,2238,5515,40.58023572076156,550,1617,34.01360544217687,1688,3898,43.304258594150845,45.56663644605621,904,1296,69.75308641975309,410,1422,1832,1355,423,134,814,1140,5930
Stromile Swift,9.0,2001 - 2009,PF,547,10804,1713,3623,47.28125862544852,2,27,7.4074074074074066,1711,3596,47.58064516129033,47.308860060723156,1154,1650,69.93939393939394,885,1650,2535,275,354,683,690,1357,4582
Dragan Tarlac,1.0,2001 - 2001,C,43,598,39,99,39.39393939393939,0,0,,39,99,39.39393939393939,39.39393939393939,25,33,75.75757575757575,37,85,122,31,7,19,38,95,103
Jake Tsakalidis,7.0,2001 - 2007,C,315,5005,580,1184,48.986486486486484,0,1,0.0,580,1183,49.027895181741336,48.986486486486484,337,513,65.69200779727096,436,802,1238,101,73,223,268,689,1497
Hedo Turkoglu,15.0,2001 - 2015,SF,997,26695,3851,9034,42.627850343148104,1246,3246,38.38570548367221,2605,5788,45.00691085003455,49.524020367500555,2074,2645,78.41209829867675,647,3324,3971,2832,750,299,1578,2403,11022
David Vanterpool,1.0,2001 - 2001,PG,22,411,46,110,41.81818181818181,0,6,0.0,46,104,44.230769230769226,41.81818181818181,30,50,60.0,15,22,37,66,23,3,37,44,122
Jake Voskuhl,9.0,2001 - 2009,C,450,6443,673,1381,48.73280231716148,1,3,33.33333333333333,672,1378,48.76632801161103,48.76900796524258,467,654,71.40672782874617,562,977,1539,237,148,166,340,1166,1814
Ruben Wolkowyski,2.0,2001 - 2003,PF,41,329,27,83,32.53012048192771,0,3,0.0,27,80,33.75,32.53012048192771,26,38,68.42105263157895,12,35,47,4,6,18,13,41,80
Wang Zhizhi,5.0,2001 - 2005,C,137,1256,213,511,41.68297455968688,70,182,38.46153846153847,143,329,43.46504559270517,48.53228962818004,108,147,73.46938775510205,56,175,231,39,25,35,68,155,604
Victor Alexander,1.0,2002 - 2002,C,15,97,18,51,35.294117647058826,0,2,0.0,18,49,36.734693877551024,35.294117647058826,4,8,50.0,7,22,29,6,0,1,5,6,40
Malik Allen,10.0,2002 - 2011,PF,478,7262,1039,2365,43.9323467230444,3,16,18.75,1036,2349,44.10387398893146,43.99577167019027,253,325,77.84615384615384,466,887,1353,228,130,220,320,897,2334
Chris Andersen,15.0,2002 - 2017,C,695,12273,1336,2512,53.18471337579618,15,68,22.058823529411764,1321,2444,54.050736497545,53.483280254777064,1068,1632,65.44117647058823,1176,2317,3493,337,312,991,513,1342,3755
Gilbert Arenas,11.0,2002 - 2012,PG,552,19351,3722,8850,42.056497175141246,1079,3077,35.06662333441664,2643,5773,45.78208903516369,48.152542372881356,2879,3584,80.32924107142857,444,1724,2168,2909,884,134,1744,1683,11402
Brandon Armstrong,3.0,2002 - 2004,SG,108,699,101,287,35.19163763066202,25,75,33.33333333333333,76,212,35.84905660377358,39.54703832752614,12,20,60.0,22,41,63,24,22,4,37,83,239
Carlos Arroyo,9.0,2002 - 2011,PG,569,10651,1431,3269,43.77485469562558,137,405,33.827160493827165,1294,2864,45.18156424581006,45.870296726827775,771,956,80.64853556485355,210,755,965,1761,290,26,680,874,3770
Mengke Bateer,3.0,2002 - 2004,C,46,494,61,156,39.1025641025641,5,15,33.33333333333333,56,141,39.71631205673759,40.705128205128204,29,39,74.35897435897436,39,75,114,27,11,5,40,118,156
Shane Battier,13.0,2002 - 2014,SF,977,30004,2982,6819,43.73075230972283,1250,3254,38.41425937307928,1732,3565,48.58345021037868,52.89631910837366,1194,1606,74.34620174346202,1273,2809,4082,1717,988,906,878,2208,8408
Charlie Bell,7.0,2002 - 2011,SG,376,9368,1192,2891,41.231407817364236,438,1213,36.108821104699096,754,1678,44.93444576877235,48.80664130058803,382,497,76.86116700201208,180,634,814,857,303,31,362,750,3204
Ruben Boumtje-Boumtje,3.0,2002 - 2004,C,44,276,14,38,36.84210526315789,0,0,,14,38,36.84210526315789,36.84210526315789,15,27,55.55555555555556,22,35,57,6,4,17,14,40,43
Michael Bradley,5.0,2002 - 2006,PF,173,2016,218,457,47.70240700218819,2,14,14.285714285714285,216,443,48.75846501128668,47.921225382932164,45,88,51.13636363636363,223,368,591,93,25,47,113,200,483
Jamison Brewer,4.0,2002 - 2005,PG,54,468,35,94,37.234042553191486,8,32,25.0,27,62,43.54838709677419,41.48936170212766,11,28,39.285714285714285,15,35,50,56,19,2,32,34,89
Primoz Brezec,8.0,2002 - 2010,C,342,6192,1012,2034,49.75417895771878,1,6,16.666666666666664,1011,2028,49.85207100591716,49.7787610619469,427,609,70.11494252873564,563,764,1327,179,69,134,274,730,2452
Damone Brown,4.0,2002 - 2005,PF,39,351,43,128,33.59375,4,14,28.57142857142857,39,114,34.21052631578947,35.15625,18,27,66.66666666666666,18,34,52,19,5,7,31,44,108
Ernest Brown,1.0,2002 - 2002,C,3,21,1,6,16.666666666666664,0,0,,1,6,16.666666666666664,16.666666666666664,1,4,25.0,1,5,6,0,0,1,3,4,3
Kedrick Brown,4.0,2002 - 2005,SF,143,1935,203,501,40.5189620758483,46,168,27.380952380952383,157,333,47.147147147147145,45.10978043912176,57,89,64.04494382022472,98,249,347,103,85,28,64,170,509
Kwame Brown,12.0,2002 - 2013,C,607,13389,1518,3088,49.15803108808291,1,9,11.11111111111111,1517,3079,49.26924326079896,49.17422279792746,998,1750,57.028571428571425,1085,2248,3333,554,324,376,771,1385,4035
Tierre Brown,4.0,2002 - 2005,PG,134,1654,202,526,38.40304182509506,30,85,35.294117647058826,172,441,39.002267573696145,41.254752851711025,93,121,76.85950413223141,41,125,166,266,64,4,143,95,527
Mitchell Butler,2.0,2002 - 2004,SG,52,642,64,147,43.53741496598639,12,33,36.36363636363637,52,114,45.614035087719294,47.61904761904761,23,36,63.888888888888886,30,55,85,37,22,5,29,64,163
Tyson Chandler,18.0,2002 - 2019,C,1134,31398,3544,5946,59.603094517322575,0,11,0.0,3544,5935,59.71356360572872,59.603094517322575,2387,3701,64.49608213996217,3504,6897,10401,961,624,1327,1648,3236,9475
Speedy Claxton,7.0,2002 - 2009,PG,334,8548,1126,2753,40.90083545223393,42,218,19.26605504587156,1084,2535,42.761341222879686,41.663639665819105,802,1053,76.1633428300095,194,636,830,1441,503,40,580,827,3096
Jarron Collins,10.0,2002 - 2011,C,542,8542,682,1500,45.46666666666667,0,5,0.0,682,1495,45.618729096989966,45.46666666666667,731,1046,69.88527724665391,645,934,1579,419,138,98,334,1316,2095
Jason Collins,13.0,2002 - 2014,C,735,14974,918,2234,41.09221128021486,7,34,20.588235294117645,911,2200,41.40909090909091,41.24888093106535,778,1202,64.72545757071548,915,1791,2706,626,368,359,605,2056,2621
Joe Crispin,1.0,2002 - 2002,PG,21,156,26,68,38.23529411764706,15,39,38.46153846153847,11,29,37.93103448275862,49.26470588235294,12,13,92.3076923076923,2,9,11,26,5,0,10,10,79
Eddy Curry,11.0,2002 - 2013,C,527,13109,2578,4734,54.45711871567384,2,2,100.0,2576,4732,54.437869822485204,54.47824250105619,1662,2588,64.2194744976816,947,1778,2725,287,155,384,1174,1562,6820
Samuel Dalembert,13.0,2002 - 2015,C,886,21646,2810,5393,52.104580011125535,1,12,8.333333333333332,2809,5381,52.20219290094777,52.11385128870758,1193,1689,70.63351095322676,2289,4653,6942,465,437,1546,1271,2601,6814
DeSagana Diop,12.0,2002 - 2013,C,601,8403,503,1177,42.735768903993204,1,6,16.666666666666664,502,1171,42.86934244235696,42.778249787595584,178,381,46.71916010498688,834,1385,2219,270,227,630,355,1219,1185
Predrag Drobnjak,4.0,2002 - 2005,C,278,5542,903,2125,42.49411764705882,66,194,34.02061855670103,837,1931,43.34541688244433,44.04705882352941,315,394,79.94923857868021,313,660,973,225,132,117,242,512,2187
Maurice Evans,9.0,2002 - 2012,SG,562,10918,1429,3231,44.22779325286289,426,1172,36.3481228668942,1003,2059,48.712967459932,50.82017951098731,463,590,78.47457627118644,559,825,1384,420,294,88,278,956,3747
Isaac Fontaine,1.0,2002 - 2002,SG,6,75,3,14,21.428571428571427,1,5,20.0,2,9,22.22222222222222,25.0,4,6,66.66666666666666,0,5,5,4,0,0,4,6,11
Alton Ford,3.0,2002 - 2004,PF,73,524,70,138,50.72463768115942,0,0,,70,138,50.72463768115942,50.72463768115942,46,66,69.6969696969697,35,89,124,11,6,8,37,115,186
Joseph Forte,2.0,2002 - 2003,SG,25,125,11,47,23.404255319148938,0,6,0.0,11,41,26.82926829268293,23.404255319148938,8,10,80.0,5,12,17,17,6,0,13,7,30
Antonis Fotsis,1.0,2002 - 2002,PF,28,320,42,104,40.38461538461539,7,23,30.434782608695656,35,81,43.20987654320987,43.75,17,20,85.0,25,37,62,10,9,11,21,22,108
Tremaine Fowlkes,4.0,2002 - 2005,SF,103,1233,105,257,40.856031128404666,4,20,20.0,101,237,42.616033755274266,41.63424124513619,87,110,79.0909090909091,94,134,228,54,47,6,50,146,301
Pau Gasol,18.0,2002 - 2019,C,1226,41001,7980,15729,50.734312416555404,179,486,36.831275720164605,7801,15243,51.17758971331102,51.303325068345096,4755,6311,75.3446363492315,3085,8220,11305,3925,606,1941,2638,2632,20894
Eddie Griffin,5.0,2002 - 2007,PF,303,6729,854,2263,37.73751657092355,237,752,31.515957446808514,617,1511,40.833884844473864,42.97392841361025,226,337,67.06231454005935,497,1247,1744,236,105,518,227,506,2171
Tang Hamilton,1.0,2002 - 2002,SF,9,98,10,19,52.63157894736842,0,1,0.0,10,18,55.55555555555556,52.63157894736842,0,1,0.0,6,12,18,5,4,0,2,10,20
Trenton Hassell,9.0,2002 - 2010,SG,644,16278,1549,3480,44.51149425287356,95,299,31.77257525083612,1454,3181,45.70889657340459,45.8764367816092,548,716,76.53631284916202,541,1285,1826,1132,282,272,597,1399,3741
Kirk Haston,2.0,2002 - 2003,PF,27,134,13,56,23.214285714285715,0,6,0.0,13,50,26.0,23.214285714285715,6,12,50.0,5,22,27,8,0,6,10,19,32
Brendan Haywood,13.0,2002 - 2015,C,816,18680,2110,3999,52.76319079769942,0,4,0.0,2110,3995,52.816020025031285,52.76319079769942,1318,2246,58.68210151380232,2081,2794,4875,442,320,1109,851,2043,5538
Steven Hunter,8.0,2002 - 2010,C,400,5993,735,1313,55.978674790555985,0,1,0.0,735,1312,56.02134146341463,55.978674790555985,347,715,48.53146853146853,482,782,1264,79,49,422,249,656,1817
Jerome James,8.0,2002 - 2009,C,342,4729,641,1315,48.745247148288975,0,2,0.0,641,1313,48.819497334348824,48.745247148288975,234,377,62.06896551724138,387,695,1082,117,90,378,394,978,1516
Mike James,13.0,2002 - 2018,PG,631,15051,2262,5453,41.4817531633963,713,1911,37.31030873888017,1549,3542,43.73235460191982,48.019438841004956,962,1204,79.90033222591362,225,1189,1414,2201,486,45,944,1249,6199
Richard Jefferson,17.0,2002 - 2018,SF,1181,34293,5150,11102,46.38803819131688,1042,2769,37.63091368725171,4108,8333,49.297971918876755,51.08088632678797,3562,4639,76.7837896098297,917,3803,4720,2412,787,347,1768,2637,14904
Joe Johnson,17.0,2002 - 2018,SG,1276,44234,7822,17719,44.14470342570122,1978,5331,37.10373288313637,5844,12388,47.17468517920568,49.726282521586995,2783,3468,80.2479815455594,1067,3992,5059,5001,1071,260,2451,2252,20405
Alvin Jones,1.0,2002 - 2002,C,23,126,8,20,40.0,0,0,,8,20,40.0,40.0,10,20,50.0,13,23,36,3,3,9,11,35,26
Michael Jordan,2.0,2002 - 2003,SF,142,5124,1230,2851,43.1427569273939,26,108,24.074074074074073,1204,2743,43.893547211082755,43.598737285163104,529,657,80.51750380517504,121,715,836,621,208,65,335,290,3015
Andrei Kirilenko,13.0,2002 - 2015,SF,797,23916,3146,6637,47.400934156998645,367,1185,30.970464135021096,2779,5452,50.97212032281732,50.165737532017474,2772,3675,75.42857142857143,1400,2952,4352,2169,1097,1461,1518,1605,9431
Amal McCaskill,3.0,2002 - 2004,C,97,859,71,183,38.79781420765027,0,1,0.0,71,182,39.010989010989015,38.79781420765027,34,57,59.64912280701754,71,120,191,29,21,31,41,125,176
Terence Morris,3.0,2002 - 2006,SF,139,1934,209,514,40.66147859922179,22,112,19.642857142857142,187,402,46.517412935323385,42.80155642023346,32,45,71.11111111111111,123,254,377,93,35,49,81,126,472
Troy Murphy,12.0,2002 - 2013,PF,729,19921,2848,6400,44.5,613,1578,38.846641318124206,2235,4822,46.350062214848606,49.2890625,1551,1977,78.45220030349014,1373,4335,5708,1088,478,294,886,1890,7860
Dean Oliver,2.0,2002 - 2003,PG,35,232,24,75,32.0,3,19,15.789473684210526,21,56,37.5,34.0,13,17,76.47058823529412,8,16,24,44,10,0,21,25,64
Tony Parker,18.0,2002 - 2019,PG,1254,38279,7777,15830,49.1282375236892,519,1603,32.376793512164696,7258,14227,51.015674421873904,50.767530006317116,3400,4525,75.13812154696133,441,2955,3396,7036,1053,98,2865,2059,19473
Vladimir Radmanovic,12.0,2002 - 2013,PF,737,16164,2148,5177,41.49121112613482,971,2567,37.82625633034671,1177,2610,45.09578544061303,50.869229283368746,612,807,75.8364312267658,654,2130,2784,998,537,263,837,1552,5879
Zach Randolph,17.0,2002 - 2018,PF,1116,34616,7436,15774,47.140864714086476,199,729,27.29766803840878,7237,15045,48.10235958790296,47.771649549892224,3507,4592,76.3719512195122,3279,6929,10208,2049,834,301,2290,2629,18578
Zeljko Rebraca,5.0,2002 - 2006,C,215,3280,488,926,52.69978401727862,0,0,,488,926,52.69978401727862,52.69978401727862,300,379,79.15567282321899,196,492,688,88,57,160,203,512,1276
Jason Richardson,13.0,2002 - 2015,SG,857,29241,5558,12681,43.8293509975554,1608,4344,37.01657458563536,3950,8337,47.379153172604056,50.169544988565576,1920,2714,70.7442888725129,1033,3212,4245,2284,995,367,1503,1963,14644
Norm Richardson,1.0,2002 - 2002,SG,11,67,10,26,38.46153846153847,4,8,50.0,6,18,33.33333333333333,46.15384615384615,6,9,66.66666666666666,3,5,8,2,0,0,3,5,30
Jeryl Sasser,2.0,2002 - 2003,SG,82,1061,67,221,30.316742081447963,13,44,29.545454545454547,54,177,30.508474576271187,33.257918552036195,57,83,68.67469879518072,67,124,191,67,48,12,41,94,204
Kenny Satterfield,2.0,2002 - 2003,PG,75,1062,128,382,33.50785340314136,12,55,21.818181818181817,116,327,35.47400611620795,35.07853403141361,53,71,74.64788732394366,33,62,95,176,51,3,96,79,321
Brian Scalabrine,11.0,2002 - 2012,PF,520,6772,590,1512,39.021164021164026,180,523,34.41682600382409,410,989,41.45601617795754,44.97354497354497,234,299,78.26086956521739,275,759,1034,436,157,121,341,819,1594
Ansu Sesay,4.0,2002 - 2005,SF,127,1301,161,371,43.39622641509434,8,29,27.586206896551722,153,342,44.73684210526316,44.474393530997304,71,111,63.96396396396396,102,121,223,62,38,30,58,162,401
Bobby Simmons,10.0,2002 - 2012,SF,466,11513,1551,3552,43.66554054054054,378,955,39.58115183246073,1173,2597,45.16750096264921,48.986486486486484,709,862,82.25058004640371,559,1232,1791,710,396,83,522,1153,4189
Charles Smith,3.0,2002 - 2006,SG,85,1364,213,504,42.26190476190476,50,170,29.411764705882355,163,334,48.80239520958084,47.22222222222222,50,77,64.93506493506493,37,112,149,90,58,50,64,145,526
Leon Smith,2.0,2002 - 2004,C,15,104,11,28,39.285714285714285,0,0,,11,28,39.285714285714285,39.285714285714285,11,17,64.70588235294117,11,22,33,3,5,1,3,13,33
Will Solomon,2.0,2002 - 2009,SG,115,1584,218,576,37.84722222222222,74,248,29.838709677419356,144,328,43.90243902439025,44.27083333333333,74,107,69.1588785046729,24,108,132,225,62,11,116,147,584
Etan Thomas,9.0,2002 - 2011,C,409,7084,890,1734,51.326412918108424,0,0,,890,1734,51.326412918108424,51.326412918108424,561,930,60.322580645161295,677,1250,1927,149,128,427,385,889,2341
Jamaal Tinsley,11.0,2002 - 2014,PG,547,14443,1759,4481,39.25463066279848,397,1326,29.939668174962293,1362,3155,43.169572107765454,43.684445436286545,737,1029,71.622934888241,345,1260,1605,3330,776,155,1375,1306,4652
Oscar Torres,2.0,2002 - 2003,SG,82,1184,151,377,40.05305039787798,44,139,31.654676258992804,107,238,44.957983193277315,45.88859416445623,96,125,76.8,50,84,134,43,29,11,57,73,442
Jeff Trepagnier,3.0,2002 - 2004,SG,31,270,34,101,33.663366336633665,6,13,46.15384615384615,28,88,31.818181818181817,36.633663366336634,14,20,70.0,17,26,43,22,19,4,25,20,88
Ratko Varda,1.0,2002 - 2002,C,1,6,2,3,66.66666666666666,0,0,,2,3,66.66666666666666,66.66666666666666,1,1,100.0,0,1,1,0,0,0,1,3,5
Gerald Wallace,14.0,2002 - 2015,SF,832,24731,3516,7492,46.93005872931126,407,1303,31.23561013046815,3109,6189,50.234286637582805,49.646289375333694,2494,3517,70.91270969576343,1145,3693,4838,1725,1200,681,1486,1829,9933
Earl Watson,13.0,2002 - 2014,PG,878,19494,2112,5139,41.09748978400467,502,1551,32.366215344938745,1610,3588,44.871794871794876,45.98170850359992,867,1233,70.31630170316302,462,1523,1985,3871,873,176,1548,1755,5593
Rodney White,4.0,2002 - 2005,SF,218,3354,617,1455,42.40549828178694,91,290,31.379310344827587,526,1165,45.15021459227468,45.53264604810997,215,287,74.91289198606272,113,372,485,237,118,65,285,309,1540
Loren Woods,6.0,2002 - 2008,C,215,2428,208,496,41.935483870967744,1,7,14.285714285714285,207,489,42.331288343558285,42.03629032258064,138,215,64.18604651162791,263,419,682,74,55,128,138,278,555
Robert Archibald,2.0,2003 - 2004,C-PF,44,328,15,53,28.30188679245283,0,0,,15,53,28.30188679245283,28.30188679245283,21,49,42.857142857142854,27,42,69,16,14,6,17,59,51
Maceo Baston,4.0,2003 - 2009,PF,105,831,106,172,61.627906976744185,3,8,37.5,103,164,62.80487804878049,62.5,71,96,73.95833333333334,56,119,175,26,24,43,54,140,286
Mike Batiste,1.0,2003 - 2003,PF,75,1248,197,467,42.184154175588866,18,81,22.22222222222222,179,386,46.373056994818654,44.11134903640257,69,88,78.4090909090909,82,175,257,52,42,16,69,120,481
Lonny Baxter,4.0,2003 - 2006,C-PF,162,1884,247,530,46.60377358490566,1,5,20.0,246,525,46.85714285714286,46.69811320754717,142,216,65.74074074074075,178,299,477,40,37,59,108,324,637
Carlos Boozer,13.0,2003 - 2015,PF,861,26901,5847,11221,52.107655289189914,1,14,7.142857142857142,5846,11207,52.16382618006603,52.11211122003386,2281,3158,72.22925902469918,2037,6155,8192,1928,765,346,1824,2612,13976
J.R. Bremer,2.0,2003 - 2004,PG,100,1946,214,622,34.40514469453376,120,360,33.33333333333333,94,262,35.87786259541985,44.05144694533762,98,131,74.80916030534351,27,154,181,215,56,7,83,112,646
Devin Brown,8.0,2003 - 2010,SG,465,9022,1174,2927,40.10932695592757,300,888,33.78378378378378,874,2039,42.86414909269249,45.23402801503246,704,907,77.61852260198457,336,952,1288,679,263,58,505,747,3352
Pat Burke,3.0,2003 - 2007,C,127,1293,199,488,40.77868852459016,9,36,25.0,190,452,42.0353982300885,41.700819672131146,61,92,66.30434782608695,90,176,266,44,28,40,87,180,468
Caron Butler,14.0,2003 - 2016,SF,881,28333,4596,10592,43.39123867069487,746,2144,34.79477611940299,3850,8448,45.57291666666667,46.91276435045317,2492,2942,84.70428280081576,1103,3284,4387,2007,1163,216,1594,2129,12430
Rasual Butler,13.0,2003 - 2016,SF,809,17219,2293,5686,40.327119240239185,911,2520,36.15079365079365,1382,3166,43.651295009475675,48.338023214913825,595,796,74.74874371859298,297,1637,1934,658,288,408,528,1132,6092
Dan Dickau,6.0,2003 - 2008,PG,300,4617,608,1517,40.07910349373764,179,525,34.095238095238095,429,992,43.24596774193548,45.978905735003295,350,421,83.1353919239905,75,330,405,752,164,11,324,514,1745
Juan Dixon,7.0,2003 - 2009,SG,436,8509,1400,3393,41.2614205717654,331,972,34.05349794238683,1069,2421,44.15530772408096,46.13910993221338,547,657,83.25722983257229,155,661,816,775,341,34,552,733,3678
Mike Dunleavy,15.0,2003 - 2017,SF,986,27340,3935,8926,44.08469639256106,1304,3460,37.6878612716763,2631,5466,48.13391877058178,51.38920008962581,1874,2333,80.32576082297471,698,3513,4211,2185,719,324,1369,1986,11048
Melvin Ely,9.0,2003 - 2014,C,375,6005,783,1702,46.00470035252644,0,3,0.0,783,1699,46.08593290170689,46.00470035252644,426,682,62.4633431085044,448,767,1215,261,99,209,392,765,1992
Reggie Evans,13.0,2003 - 2015,PF,809,15572,1107,2379,46.53215636822195,1,11,9.090909090909092,1106,2368,46.70608108108108,46.55317360235393,1074,2036,52.75049115913556,1984,3781,5765,458,566,115,897,1895,3289
Dan Gadzuric,10.0,2003 - 2012,C,527,7793,1049,2100,49.952380952380956,0,8,0.0,1049,2092,50.1434034416826,49.952380952380956,367,737,49.796472184531886,910,1416,2326,196,242,448,357,1250,2465
Manu Ginobili,16.0,2003 - 2018,SG,1057,26859,4584,10262,44.66965503800429,1495,4055,36.86806411837238,3089,6207,49.766392782342514,51.95381017345546,3380,4089,82.660797260944,685,3012,3697,4001,1392,319,2116,2212,14043
Gordan Giricek,6.0,2003 - 2008,SG,384,8824,1424,3225,44.15503875968992,289,786,36.76844783715013,1135,2439,46.535465354653546,48.63565891472868,533,648,82.25308641975309,167,774,941,584,222,47,517,749,3670
Drew Gooden,14.0,2003 - 2016,PF,790,20127,3432,7435,46.160053799596504,88,342,25.730994152046783,3344,7093,47.14507260679543,46.75184936112979,1701,2239,75.97141581062975,1878,3740,5618,896,544,474,1158,1957,8653
Marcus Haislip,4.0,2003 - 2010,PF,89,854,125,286,43.70629370629371,7,20,35.0,118,266,44.3609022556391,44.93006993006993,54,82,65.85365853658537,51,80,131,16,15,34,39,100,311
Adam Harrington,1.0,2003 - 2003,SG,19,111,11,37,29.72972972972973,5,14,35.714285714285715,6,23,26.08695652173913,36.486486486486484,3,4,75.0,1,7,8,12,2,1,2,8,30
Junior Harrington,3.0,2003 - 2007,PG,140,3096,290,782,37.084398976982094,20,73,27.397260273972602,270,709,38.081805359661494,38.36317135549872,133,193,68.9119170984456,69,312,381,428,126,25,250,401,733
Juaquin Hawkins,1.0,2003 - 2003,SG,58,685,57,148,38.513513513513516,10,24,41.66666666666667,47,124,37.903225806451616,41.891891891891895,10,20,50.0,16,62,78,47,29,6,29,57,134
Nene Hilario,17.0,2003 - 2019,C,965,25237,4175,7621,54.78283689804487,7,53,13.20754716981132,4168,7568,55.07399577167019,54.82876262957617,2552,3864,66.0455486542443,1688,4140,5828,1719,1041,721,1688,2934,10909
Nate Huffman,1.0,2003 - 2003,C,7,76,9,25,36.0,0,0,,9,25,36.0,36.0,5,8,62.5,9,14,23,5,1,3,3,13,23
Ryan Humphrey,3.0,2003 - 2005,PF,85,772,78,227,34.36123348017621,0,3,0.0,78,224,34.82142857142857,34.36123348017621,41,76,53.94736842105263,86,103,189,18,20,19,48,113,197
Casey Jacobsen,4.0,2003 - 2008,SF,287,5320,476,1210,39.33884297520661,209,594,35.18518518518518,267,616,43.34415584415584,47.97520661157025,327,425,76.94117647058823,118,398,516,304,121,24,210,372,1488
Marko Jaric,7.0,2003 - 2009,SG,447,11246,1190,2944,40.421195652173914,289,840,34.404761904761905,901,2104,42.82319391634981,45.32948369565217,524,718,72.98050139275766,274,926,1200,1600,583,128,708,967,3193
Chris Jefferies,2.0,2003 - 2004,SF,72,861,102,266,38.34586466165413,35,96,36.45833333333333,67,170,39.411764705882355,44.92481203007519,42,63,66.66666666666666,21,67,88,29,23,23,64,92,281
Jared Jeffries,11.0,2003 - 2013,PF,629,13579,1163,2728,42.631964809384165,73,292,25.0,1090,2436,44.745484400656814,43.969941348973606,604,1036,58.301158301158296,1166,1397,2563,798,435,323,674,1529,3003
Ken Johnson,1.0,2003 - 2003,C,16,156,15,37,40.54054054054054,0,0,,15,37,40.54054054054054,40.54054054054054,2,6,33.33333333333333,4,28,32,0,1,12,6,20,32
Fred Jones,7.0,2003 - 2009,SG,430,10299,1090,2651,41.11655978875896,346,979,35.34218590398366,744,1672,44.49760765550239,47.64239909468125,680,841,80.85612366230677,157,801,958,990,336,115,511,831,3206
Sean Lampley,2.0,2003 - 2004,SF,45,550,69,149,46.308724832214764,0,4,0.0,69,145,47.58620689655172,46.308724832214764,65,94,69.14893617021278,28,66,94,33,7,4,28,45,203
Tito Maddox,1.0,2003 - 2003,SG,9,35,3,12,25.0,0,3,0.0,3,9,33.33333333333333,25.0,5,8,62.5,1,6,7,5,3,1,3,4,11
Roger Mason,10.0,2003 - 2014,SG,518,9147,1196,2933,40.77736106375725,594,1549,38.34732085216269,602,1384,43.4971098265896,50.903511762700305,303,350,86.57142857142858,78,819,897,677,189,75,370,709,3289
Yao Ming,8.0,2003 - 2011,C,486,15818,3380,6445,52.443754848719934,2,10,20.0,3378,6435,52.494172494172496,52.459270752521334,2485,2984,83.27747989276139,1233,3261,4494,769,189,920,1311,1596,9247
Ronald Murray,8.0,2003 - 2010,SG,487,11077,1806,4360,41.42201834862385,328,1079,30.3985171455051,1478,3281,45.047241694605304,45.18348623853211,877,1210,72.47933884297521,192,814,1006,1096,404,100,742,795,4817
Bostjan Nachbar,6.0,2003 - 2008,SF,317,5628,744,1834,40.56706652126499,325,867,37.48558246828143,419,967,43.32988624612203,49.42748091603054,439,560,78.39285714285714,126,710,836,283,135,84,280,698,2252
Mehmet Okur,10.0,2003 - 2012,C,634,18429,3028,6615,45.77475434618292,596,1590,37.484276729559745,2432,5025,48.398009950248756,50.27966742252457,1909,2396,79.67445742904842,1261,3175,4436,1089,329,453,991,1815,8561
Chris Owens,1.0,2003 - 2003,SF,1,6,2,3,66.66666666666666,0,0,,2,3,66.66666666666666,66.66666666666666,0,0,,1,0,1,0,0,0,1,0,4
Jannero Pargo,11.0,2003 - 2015,PG,499,7449,1228,3140,39.10828025477707,400,1124,35.587188612099645,828,2016,41.07142857142857,45.47770700636943,319,369,86.44986449864498,112,589,701,986,250,28,560,648,3175
Smush Parker,5.0,2003 - 2008,PG,274,7069,908,2129,42.649131047440115,289,838,34.48687350835322,619,1291,47.94732765298219,49.43635509628933,364,514,70.8171206225681,119,540,659,791,336,44,496,606,2469
Tayshaun Prince,14.0,2003 - 2016,SF,1017,31576,4583,10082,45.45725054552668,569,1550,36.70967741935484,4014,8532,47.04641350210971,48.279111287442966,1537,2033,75.60255779636006,1125,3207,4332,2406,571,500,1064,1251,11272
Igor Rakocevic,1.0,2003 - 2003,PG,42,244,22,58,37.93103448275862,5,12,41.66666666666667,17,46,36.95652173913043,42.241379310344826,29,36,80.55555555555556,4,13,17,33,4,0,23,25,78
Efthimi Rentzias,1.0,2003 - 2003,C,35,144,20,59,33.89830508474576,4,8,50.0,16,51,31.372549019607842,37.28813559322034,8,9,88.88888888888889,10,16,26,7,6,2,4,21,52
Antoine Rigaudeau,1.0,2003 - 2003,SG,11,91,8,35,22.857142857142858,1,5,20.0,7,30,23.333333333333332,24.285714285714285,0,0,,4,4,8,6,3,0,6,11,17
Guy Rucker,1.0,2003 - 2003,PF,3,4,0,0,,0,0,,0,0,,,0,0,,0,1,1,1,0,0,0,1,0
Kareem Rush,7.0,2003 - 2010,SG,346,5956,876,2189,40.018273184102334,288,805,35.776397515527954,588,1384,42.48554913294797,46.59661946094107,173,246,70.32520325203252,104,468,572,353,150,74,298,459,2213
John Salmons,13.0,2003 - 2015,SG,895,23672,3007,6979,43.086402063332855,726,1986,36.5558912386707,2281,4993,45.68395754055678,48.28772030376845,1552,1942,79.91761071060762,435,2168,2603,2183,756,239,1185,1667,8292
Jamal Sampson,5.0,2003 - 2007,PF,72,631,53,108,49.074074074074076,0,1,0.0,53,107,49.532710280373834,49.074074074074076,36,67,53.73134328358209,80,162,242,26,9,32,33,91,142
Predrag Savovic,1.0,2003 - 2003,SG,27,256,29,93,31.182795698924732,4,26,15.384615384615385,25,67,37.3134328358209,33.33333333333333,21,29,72.41379310344827,9,16,25,22,14,1,21,33,83
Paul Shirley,3.0,2003 - 2005,PF,18,121,15,38,39.473684210526315,0,1,0.0,15,37,40.54054054054054,39.473684210526315,3,7,42.857142857142854,9,10,19,7,1,1,10,12,33
Tamar Slay,3.0,2003 - 2005,SG,66,517,73,202,36.13861386138614,13,49,26.53061224489796,60,153,39.21568627450981,39.35643564356436,14,26,53.84615384615385,24,46,70,31,26,4,39,71,173
Amar'e Stoudemire,14.0,2003 - 2016,C,846,26254,5911,11009,53.692433463529845,30,127,23.62204724409449,5881,10882,54.043374379709604,53.828685620855666,4142,5444,76.08376193975019,2029,4603,6632,1050,636,1054,1953,2685,15994
Cezary Trybanski,2.0,2003 - 2004,C,22,101,5,24,20.833333333333336,0,0,,5,24,20.833333333333336,20.833333333333336,5,12,41.66666666666667,6,9,15,1,1,7,10,16,15
Nikoloz Tskitishvili,4.0,2003 - 2006,PF,172,1946,190,626,30.35143769968051,43,183,23.497267759562842,147,443,33.182844243792324,33.78594249201278,84,115,73.04347826086956,109,198,307,114,46,50,126,227,507
Dajuan Wagner,4.0,2003 - 2007,SG,103,2202,354,967,36.60806618407445,92,287,32.05574912891986,262,680,38.529411764705884,41.36504653567735,164,213,76.99530516431925,29,113,142,195,69,14,136,212,964
Jiri Welsch,4.0,2003 - 2006,SF,247,4596,516,1280,40.3125,118,344,34.30232558139535,398,936,42.52136752136752,44.921875,369,491,75.15274949083503,120,482,602,375,187,15,262,394,1519
Chris Wilcox,11.0,2003 - 2013,C,628,12474,2101,3884,54.09371781668383,0,18,0.0,2101,3866,54.34557682359027,54.09371781668383,948,1474,64.31478968792402,970,2106,3076,455,322,246,705,1517,5150
Mike Wilks,7.0,2003 - 2010,PG,233,2240,217,540,40.18518518518518,34,106,32.075471698113205,183,434,42.16589861751152,43.333333333333336,123,166,74.09638554216868,57,171,228,271,82,10,117,215,591
Brandon Williams,1.0,2003 - 2003,SF,6,19,1,7,14.285714285714285,0,1,0.0,1,6,16.666666666666664,14.285714285714285,0,0,,2,0,2,0,2,0,3,4,2
Frank Williams,3.0,2003 - 2005,PG,86,952,92,261,35.24904214559387,24,80,30.0,68,181,37.569060773480665,39.84674329501915,45,54,83.33333333333334,13,64,77,166,34,11,83,87,253
Jay Williams,1.0,2003 - 2003,PG,75,1961,273,685,39.85401459854015,65,202,32.17821782178218,208,483,43.064182194616976,44.598540145985396,103,161,63.975155279503106,27,168,195,350,86,17,171,179,714
Qyntel Woods,4.0,2003 - 2006,SF,167,2060,281,621,45.249597423510465,35,98,35.714285714285715,246,523,47.03632887189293,48.06763285024155,94,156,60.256410256410255,107,278,385,105,71,28,138,226,691
Vincent Yarbrough,1.0,2003 - 2003,SG,59,1381,168,428,39.25233644859813,21,78,26.923076923076923,147,350,42.0,41.705607476635514,49,62,79.03225806451613,36,126,162,130,57,33,81,145,406
Carmelo Anthony,16.0,2004 - 2019,SF,1064,38129,9137,20361,44.87500613918766,1362,3925,34.70063694267516,7775,16436,47.30469700657094,48.21963557782034,5915,7290,81.13854595336076,1818,5120,6938,3165,1081,527,2832,3062,25551
Marcus Banks,8.0,2004 - 2011,PG,348,5571,741,1715,43.20699708454811,125,382,32.72251308900523,616,1333,46.21155288822206,46.85131195335277,454,591,76.81895093062606,100,419,519,728,266,57,436,674,2061
Leandro Barbosa,14.0,2004 - 2017,SG,850,18386,3403,7409,45.930624915643136,988,2556,38.654147104851326,2415,4853,49.763033175355446,52.598191388851404,1241,1511,82.13103904698875,319,1401,1720,1775,693,121,1061,1651,9035
Matt Barnes,14.0,2004 - 2017,SF,929,21967,2788,6388,43.64433312460864,982,2931,33.50392357557148,1806,3457,52.241828174717966,51.33061991233563,1031,1384,74.4942196531792,1066,3215,4281,1691,714,444,1172,2353,7589
Jerome Beasley,1.0,2004 - 2004,PF,2,5,1,3,33.33333333333333,0,0,,1,3,33.33333333333333,33.33333333333333,0,0,,0,1,1,0,0,0,0,0,2
Troy Bell,1.0,2004 - 2004,PG,6,34,4,18,22.22222222222222,0,4,0.0,4,14,28.57142857142857,22.22222222222222,3,3,100.0,3,1,4,4,1,0,6,6,11
Steve Blake,13.0,2004 - 2016,PG,870,20823,2061,5145,40.05830903790088,1037,2709,38.27980804724991,1024,2436,42.03612479474548,50.136054421768705,503,646,77.86377708978328,250,1566,1816,3446,587,63,1222,1287,5662
Keith Bogans,11.0,2004 - 2014,SG,671,14527,1482,3759,39.42537909018356,714,2020,35.34653465346535,768,1739,44.16331224841863,48.922585794094175,579,809,71.56983930778739,391,1426,1817,866,429,68,574,1223,4257
Curtis Borchardt,2.0,2004 - 2005,C,83,1117,96,228,42.10526315789473,0,1,0.0,96,227,42.290748898678416,42.10526315789473,66,89,74.15730337078652,99,179,278,64,14,46,70,200,258
Chris Bosh,13.0,2004 - 2016,C,893,31936,6209,12581,49.35219775852476,305,910,33.51648351648351,5904,11671,50.58692485648187,50.5643430569907,4466,5591,79.87837596136647,1927,5665,7592,1795,730,932,1807,2159,17189
Torraye Braggs,2.0,2004 - 2005,PF,22,178,19,40,47.5,0,0,,19,40,47.5,47.5,8,12,66.66666666666666,25,26,51,7,4,2,15,33,46
Zarko Cabarkapa,3.0,2004 - 2006,PF,150,1550,234,548,42.700729927007295,24,88,27.27272727272727,210,460,45.65217391304348,44.89051094890511,148,202,73.26732673267327,98,214,312,85,33,25,119,221,640
Matt Carroll,10.0,2004 - 2013,SG,459,7590,1030,2496,41.266025641025635,344,896,38.392857142857146,686,1600,42.875,48.157051282051285,609,724,84.11602209944752,147,716,863,313,223,60,297,704,3013
Maurice Carter,1.0,2004 - 2004,SG,10,110,11,35,31.428571428571427,4,11,36.36363636363637,7,24,29.166666666666668,37.142857142857146,16,20,80.0,2,9,11,4,0,0,9,10,42
Brian Cook,9.0,2004 - 2012,PF,421,5649,915,2083,43.927028324531925,262,686,38.19241982507289,653,1397,46.743020758768786,50.216034565530485,220,281,78.29181494661923,308,807,1115,252,135,134,252,789,2312
Omar Cook,2.0,2004 - 2005,PG,22,213,17,51,33.33333333333333,0,5,0.0,17,46,36.95652173913043,33.33333333333333,3,6,50.0,5,8,13,46,16,1,16,20,37
Marquis Daniels,10.0,2004 - 2013,SG,548,11707,1772,3933,45.054665649631325,103,439,23.462414578587698,1669,3494,47.76760160274757,46.36409865242817,672,932,72.1030042918455,521,1031,1552,966,509,137,644,882,4319
Josh Davis,4.0,2004 - 2012,PF,67,498,56,150,37.333333333333336,23,70,32.857142857142854,33,80,41.25,45.0,21,29,72.41379310344827,49,66,115,19,17,5,21,70,156
Boris Diaw,14.0,2004 - 2017,PF,1064,28768,3805,7711,49.345091427830376,475,1413,33.61641896673744,3330,6298,52.87392823118451,52.42510699001427,1054,1470,71.70068027210884,1258,3376,4634,3684,648,510,1897,2269,9139
Kaniel Dickens,3.0,2004 - 2008,PF,19,85,8,20,40.0,3,9,33.33333333333333,5,11,45.45454545454545,47.5,3,4,75.0,5,7,12,2,2,2,3,9,22
Ronald Dupree,6.0,2004 - 2011,SF,157,1758,218,510,42.745098039215684,5,13,38.46153846153847,213,497,42.857142857142854,43.23529411764706,114,204,55.88235294117647,116,223,339,100,57,29,90,252,555
Ndudi Ebi,2.0,2004 - 2005,SF,19,86,17,35,48.57142857142857,0,1,0.0,17,34,50.0,48.57142857142857,6,13,46.15384615384615,8,11,19,4,1,5,6,13,40
Francisco Elson,9.0,2004 - 2012,C,472,7207,725,1517,47.79169413315755,3,16,18.75,722,1501,48.10126582278481,47.890573500329594,273,390,70.0,497,1141,1638,260,228,255,355,1000,1726
Desmond Ferguson,1.0,2004 - 2004,SF,7,32,5,12,41.66666666666667,3,8,37.5,2,4,50.0,54.166666666666664,0,2,0.0,0,4,4,1,0,0,1,0,13
T.J. Ford,8.0,2004 - 2012,PG,429,11882,1829,4223,43.31044281316599,127,439,28.929384965831435,1702,3784,44.97885835095137,44.81411318967559,1012,1242,81.48148148148148,296,1035,1331,2495,496,55,1047,972,4797
Richie Frahm,4.0,2004 - 2008,SG,140,1473,178,433,41.10854503464203,95,267,35.580524344569284,83,166,50.0,52.078521939953816,51,63,80.95238095238095,36,128,164,83,37,10,35,122,502
Hiram Fuller,1.0,2004 - 2004,PF,4,43,3,8,37.5,0,0,,3,8,37.5,37.5,2,6,33.33333333333333,4,7,11,2,0,1,4,5,8
Reece Gaines,3.0,2004 - 2006,PG,71,605,48,148,32.432432432432435,7,26,26.923076923076923,41,122,33.60655737704918,34.7972972972973,20,33,60.60606060606061,9,44,53,50,17,3,26,40,123
Alex Garcia,2.0,2004 - 2005,SG,10,159,19,59,32.20338983050847,5,18,27.77777777777778,14,41,34.146341463414636,36.440677966101696,4,6,66.66666666666666,7,8,15,18,6,1,9,15,47
Paul Grant,1.0,2004 - 2004,C,10,98,11,23,47.82608695652174,0,0,,11,23,47.82608695652174,47.82608695652174,3,8,37.5,7,10,17,3,1,1,7,17,25
Willie Green,12.0,2004 - 2015,SG,731,14783,2417,5682,42.53783878915875,517,1494,34.60508701472557,1900,4188,45.36771728748806,47.08729320661739,708,925,76.54054054054053,242,1061,1303,1018,393,108,705,1259,6059
Ben Handlogten,2.0,2004 - 2005,C,38,469,68,130,52.307692307692314,0,1,0.0,68,129,52.71317829457365,52.307692307692314,27,44,61.36363636363637,45,75,120,19,10,9,28,87,163
Travis Hansen,1.0,2004 - 2004,SF,41,507,46,130,35.38461538461539,9,30,30.0,37,100,37.0,38.84615384615385,22,27,81.48148148148148,30,40,70,19,10,9,15,67,123
Udonis Haslem,16.0,2004 - 2019,PF,854,21518,2639,5389,48.97012432733346,4,55,7.2727272727272725,2635,5334,49.400074990626166,49.007236964186305,1229,1627,75.53779963122311,1606,4132,5738,728,422,249,803,2037,6511
Jarvis Hayes,7.0,2004 - 2010,SF,427,9898,1397,3363,41.540291406482304,392,1101,35.60399636693914,1005,2262,44.42970822281167,47.368421052631575,367,460,79.78260869565217,244,1086,1330,459,312,56,374,852,3553
Shane Heal,1.0,2004 - 2004,PG,6,72,7,24,29.166666666666668,4,18,22.22222222222222,3,6,50.0,37.5,4,5,80.0,1,3,4,5,1,0,5,2,22
Kirk Hinrich,13.0,2004 - 2016,PG,879,27015,3503,8522,41.105374325275754,1172,3122,37.54003843689942,2331,5400,43.166666666666664,47.98169443792537,1416,1770,80.0,310,2266,2576,4245,972,243,1617,2487,9594
Josh Howard,10.0,2004 - 2013,SF,507,15350,2759,6161,44.78169128388249,342,1029,33.23615160349854,2417,5132,47.096648480124706,47.557214737867234,1410,1830,77.04918032786885,846,2040,2886,817,530,276,723,1297,7270
Brandon Hunter,2.0,2004 - 2005,PF,67,630,90,189,47.61904761904761,0,3,0.0,90,186,48.38709677419355,47.61904761904761,40,82,48.78048780487805,75,112,187,22,17,8,44,82,220
LeBron James,16.0,2004 - 2019,SF,1198,46235,11838,23478,50.42167135190391,1727,5028,34.34765314240254,10111,18450,54.80216802168022,54.09958258795468,7140,9701,73.60065972580146,1443,7437,8880,8662,1937,921,4163,2207,32543
Britton Johnsen,2.0,2004 - 2005,C,26,377,23,81,28.39506172839506,1,16,6.25,22,65,33.84615384615385,29.01234567901235,7,16,43.75,20,35,55,16,8,1,17,38,54
Linton Johnson,6.0,2004 - 2009,PF,151,2111,239,574,41.63763066202091,32,105,30.476190476190478,207,469,44.136460554371006,44.42508710801394,72,103,69.90291262135922,159,334,493,65,84,63,100,271,582
Dahntay Jones,13.0,2004 - 2017,SF,624,9799,1203,2739,43.921139101861996,107,325,32.92307692307692,1096,2414,45.401822700911346,45.87440671778021,840,1118,75.13416815742397,252,830,1082,529,261,144,507,1206,3353
James Jones,14.0,2004 - 2017,SF,709,11098,1205,3003,40.12654012654013,776,1937,40.06195147134745,429,1066,40.243902439024396,53.04695304695305,531,632,84.01898734177216,226,1050,1276,366,226,218,231,930,3717
Chris Kaman,13.0,2004 - 2016,C,735,19642,3432,7023,48.86800512601452,1,24,4.166666666666666,3431,6999,49.02128875553651,48.87512459063078,1343,1808,74.28097345132744,1487,4095,5582,921,322,931,1544,1968,8208
Jason Kapono,9.0,2004 - 2012,SF,509,9068,1336,3026,44.150693985459355,457,1054,43.35863377609108,879,1972,44.57403651115619,51.70191672174488,269,322,83.54037267080744,165,679,844,417,180,25,327,777,3398
Kyle Korver,16.0,2004 - 2019,SG,1174,30223,3977,8984,44.267586821015136,2351,5478,42.917123037604966,1626,3506,46.377638334284086,57.35195903829029,1262,1438,87.76077885952712,330,3191,3521,2046,778,391,1242,2444,11567
Maciej Lampe,3.0,2004 - 2006,C,64,632,94,231,40.692640692640694,2,8,25.0,92,223,41.25560538116592,41.125541125541126,25,37,67.56756756756756,37,105,142,22,8,10,35,81,215
Raul Lopez,2.0,2004 - 2005,PG,113,2135,280,652,42.944785276073624,45,130,34.61538461538461,235,522,45.01915708812261,46.395705521472394,128,150,85.33333333333334,31,163,194,428,84,5,221,278,733
Keith McLeod,4.0,2004 - 2007,PG,200,3723,363,1018,35.65815324165029,59,209,28.22966507177033,304,809,37.57725587144623,38.555992141453835,320,400,80.0,40,228,268,536,145,27,250,359,1105
Darko Milicic,10.0,2004 - 2013,C,468,8638,1196,2602,45.96464258262875,0,6,0.0,1196,2596,46.070878274268104,45.96464258262875,421,734,57.35694822888283,628,1343,1971,405,206,613,573,1065,2813
Travis Outlaw,11.0,2004 - 2014,SF,622,13026,1994,4713,42.30850838107363,344,1021,33.692458374142994,1650,3692,44.691224268689055,45.95798854232972,941,1265,74.38735177865613,480,1494,1974,514,331,381,512,1035,5273
Zaza Pachulia,16.0,2004 - 2019,C,1098,22240,2608,5559,46.91491275409246,0,31,0.0,2608,5528,47.178002894356005,46.91491275409246,2198,2927,75.09395285275026,2362,3953,6315,1433,768,378,1444,2738,7414
Sasha Pavlovic,10.0,2004 - 2013,SG,567,8888,1070,2651,40.36212749905696,308,890,34.60674157303371,762,1761,43.27086882453152,46.171256129762355,339,504,67.26190476190477,188,812,1000,517,272,98,460,1026,2787
Desmond Penigar,1.0,2004 - 2004,PF,10,89,14,28,50.0,0,0,,14,28,50.0,50.0,4,4,100.0,6,18,24,3,2,2,6,14,32
Kirk Penney,2.0,2004 - 2005,SG,6,30,2,9,22.22222222222222,1,4,25.0,1,5,20.0,27.77777777777778,0,0,,0,2,2,2,1,0,5,1,5
Kendrick Perkins,14.0,2004 - 2018,C,782,17162,1705,3219,52.96675986331159,0,14,0.0,1705,3205,53.198127925117,52.96675986331159,804,1353,59.42350332594235,1305,3227,4532,813,263,903,1233,2142,4214
Mickael Pietrus,10.0,2004 - 2013,SF,557,11950,1625,3821,42.52813399633604,679,1910,35.54973821989529,946,1911,49.50287807430664,51.41324260664747,700,1053,66.47673314339981,440,1283,1723,445,371,230,576,1270,4629
Zoran Planinic,3.0,2004 - 2006,PG,148,1584,197,486,40.534979423868315,37,128,28.90625,160,358,44.6927374301676,44.34156378600823,130,192,67.70833333333334,47,151,198,165,58,7,120,237,561
Luke Ridnour,12.0,2004 - 2015,PG,830,21623,2933,6803,43.113332353373515,584,1674,34.88649940262844,2349,5129,45.798401247806595,47.40555637218874,1290,1496,86.22994652406418,363,1514,1877,3713,814,161,1349,1779,7740
Theron Smith,2.0,2004 - 2005,SF,53,688,60,179,33.5195530726257,9,24,37.5,51,155,32.903225806451616,36.03351955307262,20,24,83.33333333333334,52,105,157,35,11,9,41,76,149
Darius Songaila,8.0,2004 - 2011,C,495,9229,1449,2904,49.89669421487603,3,19,15.789473684210526,1446,2885,50.12131715771231,49.94834710743802,514,609,84.40065681444992,553,1136,1689,589,324,106,486,1197,3415
Mike Sweetney,4.0,2004 - 2007,C,233,3610,564,1164,48.45360824742268,0,2,0.0,564,1162,48.53700516351119,48.45360824742268,388,563,68.9165186500888,400,645,1045,145,73,107,277,569,1516
Ime Udoka,7.0,2004 - 2011,SF,316,5711,614,1471,41.74031271244052,218,612,35.62091503267974,396,859,46.10011641443539,49.150237933378655,189,268,70.52238805970148,219,707,926,308,208,54,221,528,1635
Slavko Vranes,1.0,2004 - 2004,C,1,3,0,1,0.0,0,0,,0,1,0.0,0.0,0,0,,0,0,0,0,0,0,0,1,0
Dwyane Wade,16.0,2004 - 2019,SG,1054,35773,8454,17617,47.98773911562695,549,1874,29.29562433297759,7905,15743,50.21279298735946,49.54589317136857,5708,7463,76.48398767251776,1258,3675,4933,5701,1620,885,3326,2328,23165
Luke Walton,10.0,2004 - 2013,SF,564,9685,1050,2449,42.87464271131074,182,558,32.61648745519714,868,1891,45.90163934426229,46.59044507962434,367,513,71.53996101364523,481,1107,1588,1317,313,102,597,810,2649
David West,15.0,2004 - 2018,PF,1034,29144,5703,11519,49.50950603350985,57,215,26.51162790697674,5646,11304,49.94692144373673,49.75692334404028,2571,3148,81.67090216010166,1784,4806,6590,2273,764,850,1660,2408,14034
Mo Williams,13.0,2004 - 2016,PG,818,23872,4051,9326,43.43770105082565,1094,2891,37.841577308889654,2957,6435,45.95182595182595,49.303023804417755,1563,1795,87.07520891364902,407,1857,2264,3990,721,121,1849,2005,10759
Tony Allen,14.0,2005 - 2018,SG,820,18055,2588,5447,47.512392142463746,125,444,28.153153153153156,2463,5003,49.23046172296622,48.65981274095832,1353,1909,70.87480356207439,1021,1863,2884,1077,1158,337,1118,1947,6654
Rafael Araujo,3.0,2005 - 2007,C,139,1585,156,385,40.519480519480524,1,4,25.0,155,381,40.68241469816273,40.64935064935065,76,112,67.85714285714286,124,271,395,41,51,16,111,300,389
Trevor Ariza,15.0,2005 - 2019,SF,1011,30157,3861,9140,42.24288840262582,1458,4155,35.09025270758123,2403,4985,48.204613841524576,50.21881838074398,1612,2214,72.80939476061428,1010,3874,4884,2206,1515,316,1385,2019,10792
Maurice Baker,1.0,2005 - 2005,PG,5,19,0,1,0.0,0,0,,0,1,0.0,0.0,0,0,,1,1,2,1,1,0,1,3,0
Andre Barrett,4.0,2005 - 2008,PG,67,819,89,241,36.92946058091287,17,69,24.637681159420293,72,172,41.86046511627907,40.45643153526971,24,33,72.72727272727273,21,50,71,135,29,1,47,69,219
Andris Biedrins,10.0,2005 - 2014,C,516,11146,1432,2409,59.44375259443753,0,2,0.0,1432,2407,59.493144993768176,59.44375259443753,383,766,50.0,1190,2441,3631,467,331,580,479,1626,3247
Tony Bobbitt,1.0,2005 - 2005,SG,2,12,2,5,40.0,1,2,50.0,1,3,33.33333333333333,50.0,0,0,,0,3,3,0,0,0,0,1,5
Matt Bonner,12.0,2005 - 2016,PF,792,13356,1749,3768,46.417197452229296,797,1923,41.44565782631305,952,1845,51.59891598915989,56.99309978768577,337,432,78.00925925925925,622,1749,2371,552,285,213,299,1307,4632
Antonio Burks,2.0,2005 - 2006,PG,81,789,79,204,38.72549019607843,4,17,23.52941176470588,75,187,40.106951871657756,39.705882352941174,24,42,57.14285714285714,5,44,49,104,33,1,48,70,186
Jackie Butler,3.0,2005 - 2007,C,69,848,137,254,53.937007874015755,0,0,,137,254,53.937007874015755,53.937007874015755,69,89,77.52808988764045,73,132,205,30,20,31,73,143,343
Geno Carlisle,1.0,2005 - 2005,SG,6,16,2,3,66.66666666666666,0,0,,2,3,66.66666666666666,66.66666666666666,4,6,66.66666666666666,1,0,1,1,0,0,1,1,8
Lionel Chalmers,1.0,2005 - 2005,PG,36,433,42,125,33.6,12,49,24.489795918367346,30,76,39.473684210526315,38.4,15,24,62.5,4,27,31,51,13,0,24,30,111
Josh Childress,8.0,2005 - 2014,SF,391,10432,1343,2571,52.23648385842085,99,301,32.89036544850498,1244,2270,54.801762114537446,54.16180474523532,763,980,77.85714285714286,732,1118,1850,609,339,184,439,725,3548
Nick Collison,14.0,2005 - 2018,PF,910,18603,2212,4146,53.35262904003859,21,101,20.792079207920793,2191,4045,54.165636588380714,53.6058851905451,914,1265,72.25296442687747,1766,2935,4701,939,446,469,878,2507,5359
Erik Daniels,1.0,2005 - 2005,SF,21,72,6,18,33.33333333333333,1,2,50.0,5,16,31.25,36.11111111111111,0,0,,7,11,18,4,2,0,6,7,13
Carlos Delfino,8.0,2005 - 2013,SG,507,11580,1472,3669,40.11992368492777,678,1856,36.5301724137931,794,1813,43.79481522338665,49.35949850095394,493,650,75.84615384615384,287,1528,1815,887,461,88,509,827,4115
Luol Deng,15.0,2005 - 2019,SF,902,30941,5130,11257,45.571644310206985,658,1982,33.19878910191726,4472,9275,48.21563342318059,48.49427023185574,2443,3175,76.94488188976378,1462,4006,5468,2042,880,444,1459,1499,13361
Chris Duhon,9.0,2005 - 2013,PG,606,15526,1353,3440,39.33139534883721,649,1788,36.297539149888145,704,1652,42.615012106537534,48.76453488372093,591,754,78.38196286472149,200,1164,1364,2690,471,36,925,965,3946
Corsley Edwards,1.0,2005 - 2005,C,10,110,10,31,32.25806451612903,0,0,,10,31,32.25806451612903,32.25806451612903,7,12,58.333333333333336,12,13,25,3,3,4,2,19,27
John Edwards,2.0,2005 - 2006,C,65,435,42,94,44.680851063829785,0,0,,42,94,44.680851063829785,44.680851063829785,15,25,60.0,26,41,67,8,6,19,20,88,99
Andre Emmett,2.0,2005 - 2012,SG,14,73,6,13,46.15384615384615,0,1,0.0,6,12,50.0,46.15384615384615,8,13,61.53846153846154,2,6,8,1,2,1,3,6,20
Luis Flores,1.0,2005 - 2005,PG,16,77,14,29,48.275862068965516,5,10,50.0,9,19,47.368421052631575,56.896551724137936,2,2,100.0,1,2,3,11,2,0,11,9,35
Matt Freije,2.0,2005 - 2007,PF,42,588,53,181,29.2817679558011,17,76,22.36842105263158,36,105,34.285714285714285,33.97790055248619,10,14,71.42857142857143,24,61,85,27,16,3,20,53,133
Ben Gordon,11.0,2005 - 2015,SG,744,20366,3931,9092,43.23581170259569,1171,2921,40.08901061280383,2760,6171,44.72532814778804,49.675538935327765,2051,2394,85.67251461988305,333,1518,1851,1868,508,114,1551,1720,11084
Devin Harris,15.0,2005 - 2019,PG,985,23963,3486,8072,43.18632309217046,832,2558,32.52541047693511,2654,5514,48.13202756619514,48.33994053518335,2793,3507,79.64071856287424,290,1861,2151,3869,998,194,1682,2171,10597
David Harrison,4.0,2005 - 2008,C,189,2686,374,706,52.97450424929179,0,0,,374,706,52.97450424929179,52.97450424929179,201,383,52.48041775456919,184,365,549,47,64,185,216,538,949
Dwight Howard,15.0,2005 - 2019,C,1044,35984,6537,11217,58.27761433538379,6,63,9.523809523809524,6531,11154,58.5529854760624,58.30435945439957,5034,8885,56.65728756330894,3671,9513,13184,1535,986,2051,3059,3375,18114
Kris Humphries,13.0,2005 - 2017,PF,800,14232,2078,4486,46.32189032545698,55,188,29.25531914893617,2023,4298,47.068403908794785,46.93490860454748,1139,1626,70.04920049200491,1387,2927,4314,556,326,454,691,1456,5350
Andre Iguodala,15.0,2005 - 2019,SF,1108,37034,4842,10398,46.5666474321985,989,2966,33.34457181389076,3853,7432,51.84337997847147,51.32236968647816,2783,3918,71.03113833588566,1039,4592,5631,4821,1663,552,2110,2010,13456
Didier Ilunga-Mbenga,7.0,2005 - 2011,C,234,1566,180,383,46.99738903394256,0,2,0.0,180,381,47.24409448818898,46.99738903394256,54,89,60.67415730337079,129,222,351,41,37,141,87,286,414
Royal Ivey,10.0,2005 - 2014,SG,492,6162,622,1531,40.62704114957544,162,449,36.080178173719375,460,1082,42.513863216266174,45.917700849118226,235,333,70.57057057057057,147,410,557,501,230,38,255,757,1641
Luke Jackson,4.0,2005 - 2008,SF,73,724,84,235,35.74468085106383,32,89,35.95505617977528,52,146,35.61643835616438,42.5531914893617,52,71,73.23943661971832,27,62,89,58,24,3,49,71,252
Al Jefferson,14.0,2005 - 2018,C,915,26299,6161,12344,49.91088788075178,8,66,12.121212121212121,6153,12278,50.11402508551881,49.943292287751134,2013,2833,71.05541828450406,2054,5636,7690,1347,628,1093,1211,2347,14343
Horace Jenkins,1.0,2005 - 2005,PG,15,104,15,45,33.33333333333333,0,9,0.0,15,36,41.66666666666667,33.33333333333333,12,13,92.3076923076923,3,6,9,9,5,1,7,6,42
Mark Jones,1.0,2005 - 2005,SF,10,116,9,31,29.03225806451613,0,4,0.0,9,27,33.33333333333333,29.03225806451613,5,10,50.0,6,7,13,6,5,2,3,16,23
Mario Kasun,2.0,2005 - 2006,C,73,569,78,167,46.706586826347305,0,1,0.0,78,166,46.98795180722892,46.706586826347305,42,66,63.63636363636363,76,112,188,11,10,16,41,155,198
Viktor Khryapa,4.0,2005 - 2008,PF,143,2351,251,567,44.26807760141093,14,48,29.166666666666668,237,519,45.664739884393065,45.5026455026455,127,193,65.80310880829016,168,324,492,142,86,48,139,353,643
Brandin Knight,1.0,2005 - 2005,PG,1,3,0,1,0.0,0,0,,0,1,0.0,0.0,0,0,,0,0,0,1,0,0,0,0,0
Nenad Krstic,7.0,2005 - 2011,C,419,10547,1724,3493,49.35585456627541,2,14,14.285714285714285,1722,3479,49.49698189134809,49.38448325221872,760,1041,73.00672430355426,772,1489,2261,346,162,286,497,1251,4210
Ibo Kutluay,1.0,2005 - 2005,SG,5,12,0,1,0.0,0,0,,0,1,0.0,0.0,0,0,,0,1,1,0,0,0,2,1,0
Shaun Livingston,14.0,2005 - 2019,PG,833,17188,2149,4419,48.630911971034166,13,73,17.80821917808219,2136,4346,49.148642429820526,48.77800407331975,920,1159,79.37877480586712,491,1498,1989,2483,586,311,1034,1498,5231
Kevin Martin,12.0,2005 - 2016,SG,714,21559,3847,8797,43.73081732408776,1141,2969,38.43044796227686,2706,5828,46.43102264927934,50.21598272138229,3561,4091,87.04473233928135,401,1877,2278,1352,643,78,1200,1361,12396
Jameer Nelson,14.0,2005 - 2018,PG,878,24539,3790,8692,43.60331339162448,1153,3134,36.79004467134652,2637,5558,47.445124145376035,50.235849056603776,1207,1491,80.95238095238095,426,2169,2595,4508,772,68,1831,2195,9940
Andres Nocioni,8.0,2005 - 2012,SF,514,12013,1932,4478,43.144260830728,587,1574,37.29351969504447,1345,2904,46.31542699724518,49.6985261277356,964,1206,79.93366500829188,354,1941,2295,614,215,228,724,1394,5415
Emeka Okafor,10.0,2005 - 2018,C,616,19055,3004,5867,51.20163627066644,0,2,0.0,3004,5865,51.21909633418584,51.20163627066644,1362,2325,58.58064516129032,1954,4013,5967,520,414,1003,984,1696,7370
Pavel Podkolzin,2.0,2005 - 2006,C,6,28,0,2,0.0,0,0,,0,2,0.0,0.0,4,8,50.0,0,9,9,0,0,1,4,4,4
Peter John Ramos,1.0,2005 - 2005,C,6,20,5,10,50.0,0,0,,5,10,50.0,50.0,1,2,50.0,1,3,4,0,0,1,3,4,11
Justin Reed,3.0,2005 - 2007,SF,136,1436,174,431,40.37122969837587,0,4,0.0,174,427,40.749414519906324,40.37122969837587,124,165,75.15151515151514,76,110,186,68,31,19,79,219,472
Jared Reiner,2.0,2005 - 2007,C,46,376,25,73,34.24657534246575,0,0,,25,73,34.24657534246575,34.24657534246575,4,14,28.57142857142857,34,75,109,14,8,13,23,80,54
Bernard Robinson,3.0,2005 - 2007,SG-SF,128,1909,212,508,41.732283464566926,5,31,16.129032258064516,207,477,43.39622641509434,42.2244094488189,147,187,78.6096256684492,86,229,315,126,109,16,110,215,576
Quinton Ross,7.0,2005 - 2011,SG,458,8458,764,1824,41.885964912280706,49,154,31.818181818181817,715,1670,42.81437125748503,43.22916666666667,286,402,71.14427860696517,267,680,947,431,263,129,217,854,1863
Ha Seung-Jin,2.0,2005 - 2006,C,46,316,28,54,51.85185185185185,0,0,,28,54,51.85185185185185,51.85185185185185,14,28,50.0,20,47,67,3,4,13,26,62,70
Donta Smith,2.0,2005 - 2006,SG,61,560,59,140,42.142857142857146,8,26,30.76923076923077,51,114,44.73684210526316,45.0,39,60,65.0,22,44,66,48,31,5,29,70,165
J.R. Smith,15.0,2005 - 2019,SG,971,26196,4373,10443,41.874940151297515,1929,5167,37.333075285465455,2444,5276,46.32297194844579,51.11079191803122,1456,1988,73.23943661971832,494,2574,3068,2074,973,204,1311,2186,12131
Josh Smith,13.0,2005 - 2018,PF,894,29000,5089,11247,45.24762158797901,450,1578,28.517110266159694,4639,9669,47.97807425793774,47.248155063572504,2368,3748,63.180362860192105,1717,4936,6653,2789,1083,1713,2197,2461,12996
Kirk Snyder,4.0,2005 - 2008,SG,211,3540,489,1116,43.81720430107527,92,281,32.74021352313167,397,835,47.54491017964072,47.939068100358426,263,376,69.9468085106383,152,339,491,241,86,69,206,328,1333
Pape Sow,3.0,2005 - 2007,C,76,879,79,190,41.578947368421055,0,0,,79,190,41.578947368421055,41.578947368421055,61,90,67.77777777777779,78,136,214,12,34,24,41,166,219
Awvee Storey,3.0,2005 - 2008,SG,60,407,58,140,41.42857142857143,4,16,25.0,54,124,43.54838709677419,42.857142857142854,23,45,51.11111111111111,43,38,81,21,10,2,15,66,143
Robert Swift,4.0,2005 - 2009,C,97,1500,172,340,50.588235294117645,0,0,,172,340,50.588235294117645,50.588235294117645,72,118,61.016949152542374,122,254,376,20,26,86,71,224,416
Yuta Tabuse,1.0,2005 - 2005,PG,4,17,1,6,16.666666666666664,1,1,100.0,0,5,0.0,25.0,4,4,100.0,2,2,4,3,0,0,1,1,7
Sebastian Telfair,10.0,2005 - 2015,PG,564,12149,1542,3953,39.008348090058185,361,1133,31.862312444836714,1181,2820,41.87943262411348,43.57450037945864,738,950,77.6842105263158,151,747,898,1960,413,75,859,1196,4183
Billy Thomas,3.0,2005 - 2008,SF,53,529,51,151,33.77483443708609,31,102,30.392156862745097,20,49,40.816326530612244,44.03973509933775,11,13,84.61538461538461,12,40,52,26,25,2,19,52,144
James Thomas,2.0,2005 - 2006,PF,33,267,22,39,56.41025641025641,0,0,,22,39,56.41025641025641,56.41025641025641,10,20,50.0,29,47,76,5,4,7,14,48,54
Beno Udrih,13.0,2005 - 2017,PG,831,18185,2740,5922,46.26815265113137,465,1334,34.8575712143928,2275,4588,49.585876198779424,50.19419115163796,1007,1209,83.29197684036393,308,1404,1712,2858,576,71,1179,1275,6952
Anderson Varejao,13.0,2005 - 2017,C,627,15051,1804,3534,51.04697226938314,1,42,2.380952380952381,1803,3492,51.63230240549829,51.06112054329371,952,1509,63.088137839628885,1504,3007,4511,734,537,405,592,1630,4561
Jackson Vroman,2.0,2005 - 2006,PF,87,1111,108,265,40.75471698113208,0,3,0.0,108,262,41.221374045801525,40.75471698113208,69,119,57.98319327731093,97,164,261,51,37,30,85,183,285
Sasha Vujacic,10.0,2005 - 2017,SG,581,8908,1075,2757,38.99165759883932,533,1451,36.733287388008264,542,1306,41.50076569678408,48.65796155241205,411,479,85.80375782881002,205,888,1093,748,336,34,328,880,3094
Delonte West,8.0,2005 - 2012,SG,432,11842,1601,3571,44.833380005600674,376,1012,37.15415019762846,1225,2559,47.87026182102384,50.098011761411364,620,751,82.55659121171772,213,1052,1265,1540,465,179,702,828,4198
Damien Wilkins,10.0,2005 - 2018,SF,582,10991,1344,3157,42.572062084257205,205,627,32.695374800637964,1139,2530,45.019762845849804,45.818815331010455,711,908,78.30396475770925,441,921,1362,796,431,130,524,945,3604
Dorell Wright,11.0,2005 - 2015,SF,549,12280,1657,3908,42.40020470829069,617,1691,36.48728562980485,1040,2217,46.91023906179522,50.2942681678608,666,826,80.62953995157385,375,1718,2093,850,418,271,475,790,4597
Alex Acker,2.0,2006 - 2009,SG,30,234,34,92,36.95652173913043,8,25,32.0,26,67,38.80597014925373,41.30434782608695,5,10,50.0,9,20,29,16,6,4,11,13,81
Alan Anderson,8.0,2006 - 2017,SF,330,6793,843,2084,40.451055662188104,331,963,34.3717549325026,512,1121,45.673505798394295,48.392514395393476,404,495,81.61616161616162,151,563,714,371,182,31,290,602,2421
Martynas Andriuskevicius,1.0,2006 - 2006,C,6,9,0,1,0.0,0,0,,0,1,0.0,0.0,0,0,,1,3,4,0,2,0,0,1,0
Earl Barron,8.0,2006 - 2015,C,140,1985,255,687,37.117903930131,3,18,16.666666666666664,252,669,37.66816143497758,37.33624454148472,127,181,70.1657458563536,188,304,492,63,46,30,107,270,640
Eddie Basden,1.0,2006 - 2006,SF,19,141,15,37,40.54054054054054,1,7,14.285714285714285,14,30,46.666666666666664,41.891891891891895,8,10,80.0,7,21,28,8,9,2,9,17,39
Brandon Bass,12.0,2006 - 2017,PF,758,16410,2558,5125,49.91219512195122,12,58,20.689655172413794,2546,5067,50.24669429642786,50.02926829268293,1447,1740,83.16091954022988,1139,2309,3448,608,295,479,718,1375,6575
Esteban Batista,2.0,2006 - 2007,PF,70,576,42,96,43.75,0,1,0.0,42,95,44.21052631578947,43.75,37,60,61.66666666666667,68,106,174,11,18,11,42,124,121
Andray Blatche,9.0,2006 - 2014,PF,564,12462,2327,4981,46.71752660108412,52,219,23.74429223744292,2275,4762,47.774044519109616,47.239510138526406,1000,1380,72.46376811594203,1043,1981,3024,798,492,458,914,1382,5706
Andrew Bogut,14.0,2006 - 2019,C,706,19862,2986,5585,53.464637421665174,3,25,12.0,2983,5560,53.65107913669065,53.49149507609668,833,1495,55.719063545150505,1754,4358,6112,1546,442,1091,1204,2186,6808
Kevin Burleson,1.0,2006 - 2006,PG,39,340,22,88,25.0,10,54,18.51851851851852,12,34,35.294117647058826,30.681818181818183,16,17,94.11764705882352,4,22,26,48,26,2,25,63,70
Andrew Bynum,8.0,2006 - 2014,C,418,10690,1917,3446,55.62971561230412,1,9,11.11111111111111,1916,3437,55.74629036950829,55.644225188624496,987,1431,68.9727463312369,1007,2214,3221,490,133,657,644,1028,4822
Will Bynum,8.0,2006 - 2015,PG,360,6611,1117,2529,44.16765519968367,84,309,27.184466019417474,1033,2220,46.531531531531535,45.82839066824832,603,755,79.86754966887418,125,436,561,1185,256,29,578,670,2921
Jose Calderon,14.0,2006 - 2019,PG,895,23643,3038,6440,47.17391304347826,920,2260,40.707964601769916,2118,4180,50.66985645933014,54.316770186335404,925,1060,87.26415094339622,303,1845,2148,5148,716,71,1339,1476,7921
Travis Diener,5.0,2006 - 2010,PG,179,2660,298,768,38.80208333333333,164,465,35.26881720430107,134,303,44.224422442244226,49.47916666666667,94,111,84.68468468468468,39,204,243,432,76,9,99,200,854
Ike Diogu,6.0,2006 - 2012,PF,225,2795,488,958,50.939457202505224,1,2,50.0,487,956,50.94142259414226,50.99164926931107,371,472,78.60169491525424,275,414,689,69,36,65,200,425,1348
Monta Ellis,12.0,2006 - 2017,SG,833,29011,5723,12688,45.10561160151324,737,2349,31.375053214133676,4986,10339,48.22516684398878,48.00993064312736,2675,3463,77.24516315333526,520,2354,2874,3856,1409,281,2246,1950,14858
Daniel Ewing,2.0,2006 - 2007,SG,127,1683,162,416,38.94230769230769,36,122,29.508196721311474,126,294,42.857142857142854,43.269230769230774,71,91,78.02197802197803,32,126,158,174,69,10,107,148,431
Noel Felix,1.0,2006 - 2006,SF,12,82,6,25,24.0,1,3,33.33333333333333,5,22,22.727272727272727,26.0,5,8,62.5,3,10,13,2,2,3,8,13,18
Raymond Felton,14.0,2006 - 2019,PG,971,28829,4105,9959,41.218997891354554,925,2813,32.883043014575186,3180,7146,44.500419815281276,45.863038457676474,1718,2175,78.98850574712644,552,2315,2867,5096,1144,207,2008,1870,10853
Gerald Fitch,1.0,2006 - 2006,PG,18,239,30,89,33.70786516853933,7,26,26.923076923076923,23,63,36.507936507936506,37.640449438202246,17,23,73.91304347826086,7,23,30,33,7,5,15,28,84
Sharrod Ford,1.0,2006 - 2006,PF,3,13,2,3,66.66666666666666,0,0,,2,3,66.66666666666666,66.66666666666666,0,0,,1,2,3,0,0,1,2,7,4
Channing Frye,13.0,2006 - 2019,C,890,19772,2931,6655,44.04207362885049,1049,2706,38.76570583887657,1882,3949,47.657634844264365,51.923365890308034,875,1064,82.23684210526315,767,3235,4002,864,457,540,787,2255,7786
Deng Gai,1.0,2006 - 2006,C,2,5,0,0,,0,0,,0,0,,,0,0,,0,0,0,0,0,0,0,0,0
Francisco Garcia,10.0,2006 - 2015,SF,549,11853,1564,3659,42.74391910358021,581,1627,35.709895513214505,983,2032,48.375984251968504,50.683246788740085,614,768,79.94791666666666,278,1122,1400,747,441,388,545,1229,4323
Ryan Gomes,8.0,2006 - 2014,SF,487,13463,1891,4249,44.504589315132975,334,956,34.93723849372385,1557,3293,47.282113574248406,48.43492586490939,810,1014,79.88165680473372,617,1622,2239,712,351,78,550,942,4926
Joey Graham,6.0,2006 - 2011,SF,377,6117,857,1776,48.2545045045045,54,180,30.0,803,1596,50.31328320802005,49.77477477477478,471,578,81.4878892733564,272,786,1058,207,134,43,309,804,2239
Stephen Graham,6.0,2006 - 2011,SG,239,2915,378,848,44.575471698113205,53,172,30.813953488372093,325,676,48.07692307692308,47.700471698113205,157,205,76.58536585365854,77,347,424,117,57,19,155,352,966
Danny Granger,10.0,2006 - 2015,SF,586,18487,3332,7672,43.43065693430657,1006,2644,38.04841149773071,2326,5028,46.260938743038984,49.98696558915537,2185,2577,84.78851377570818,674,2214,2888,1097,561,481,1098,1628,9855
Devin Green,1.0,2006 - 2006,SG,27,135,6,28,21.428571428571427,0,2,0.0,6,26,23.076923076923077,21.428571428571427,13,21,61.904761904761905,10,14,24,7,3,0,5,13,25
Gerald Green,12.0,2006 - 2019,SG,658,13026,2312,5546,41.68770284890011,962,2668,36.05697151424288,1350,2878,46.907574704656014,50.360620266859,826,1010,81.78217821782178,318,1321,1639,596,335,199,721,1228,6412
Orien Greene,4.0,2006 - 2011,SG,131,1555,127,328,38.71951219512195,11,52,21.153846153846153,116,276,42.028985507246375,40.396341463414636,61,95,64.21052631578948,49,146,195,155,98,15,144,228,326
Anthony Grundy,1.0,2006 - 2006,SG,12,108,19,38,50.0,5,15,33.33333333333333,14,23,60.86956521739131,56.57894736842105,9,14,64.28571428571429,1,16,17,9,7,0,9,14,52
Chuck Hayes,11.0,2006 - 2016,C,644,11815,1047,2104,49.76235741444867,0,14,0.0,1047,2090,50.0956937799043,49.76235741444867,316,510,61.96078431372549,1119,2124,3243,781,478,237,461,1485,2410
Luther Head,6.0,2006 - 2011,SG,348,7797,1025,2426,42.250618301731244,451,1162,38.81239242685026,574,1264,45.41139240506329,51.54575432811212,341,441,77.32426303854876,110,735,845,747,254,43,437,510,2842
Julius Hodge,2.0,2006 - 2007,SG,23,98,11,25,44.0,0,0,,11,25,44.0,44.0,6,12,50.0,7,8,15,18,6,0,11,13,28
Randy Holcomb,1.0,2006 - 2006,SF,4,11,1,1,100.0,0,0,,1,1,100.0,100.0,0,0,,1,0,1,0,0,0,0,2,2
Jarrett Jack,13.0,2006 - 2018,PG,867,24140,3374,7673,43.97237065033233,620,1809,34.27307904919845,2754,5864,46.96452933151433,48.012511403623094,1981,2316,85.53540587219344,277,2210,2487,3952,683,107,1723,1583,9349
Sarunas Jasikevicius,2.0,2006 - 2007,SG-PG,138,2530,298,751,39.680426098535285,130,366,35.51912568306011,168,385,43.63636363636363,48.33555259653795,207,228,90.78947368421053,34,188,222,399,66,5,206,183,933
Amir Johnson,14.0,2006 - 2019,PF,870,18323,2558,4490,56.97104677060134,107,322,33.22981366459628,2451,4168,58.80518234165068,58.16258351893096,879,1307,67.25325172149962,1723,2969,4692,1073,524,839,932,2578,6102
Dwayne Jones,5.0,2006 - 2010,PF,82,636,33,65,50.76923076923077,0,1,0.0,33,64,51.5625,50.76923076923077,41,83,49.39759036144578,86,105,191,12,11,29,26,112,107
Linas Kleiza,7.0,2006 - 2013,SF,409,8185,1268,2912,43.543956043956044,387,1154,33.53552859618718,881,1758,50.11376564277589,50.188873626373635,638,836,76.31578947368422,388,1082,1470,321,159,73,409,886,3561
Yaroslav Korolev,2.0,2006 - 2007,SF,34,168,13,46,28.26086956521739,3,12,25.0,10,34,29.411764705882355,31.521739130434785,10,16,62.5,6,10,16,13,6,0,7,11,39
David Lee,12.0,2006 - 2017,PF,829,24293,4587,8566,53.548914312397855,1,29,3.4482758620689653,4586,8537,53.719105072039355,53.55475134251692,2057,2666,77.15678919729932,2150,5170,7320,1825,625,329,1454,2170,11232
John Lucas III,8.0,2006 - 2017,PG,242,2927,454,1185,38.312236286919834,163,474,34.38818565400844,291,711,40.92827004219409,45.18987341772152,76,99,76.76767676767676,57,180,237,362,88,2,128,195,1147
Arvydas Macijauskas,1.0,2006 - 2006,SG,19,135,14,41,34.146341463414636,3,12,25.0,11,29,37.93103448275862,37.80487804878049,13,15,86.66666666666667,3,7,10,5,7,0,8,10,44
Rawle Marshall,2.0,2006 - 2007,SF,63,602,56,149,37.58389261744966,5,21,23.809523809523807,51,128,39.84375,39.261744966442954,53,74,71.62162162162163,16,44,60,23,20,12,34,39,170
Jason Maxiell,10.0,2006 - 2015,PF,618,11379,1398,2823,49.52178533475027,0,5,0.0,1398,2818,49.609652235628104,49.52178533475027,685,1214,56.42504118616145,1048,1528,2576,266,230,490,487,1197,3481
Sean May,4.0,2006 - 2010,PF,119,1868,324,708,45.76271186440678,3,13,23.076923076923077,321,695,46.18705035971223,45.97457627118644,170,228,74.56140350877193,155,326,481,115,53,47,134,236,821
Rashad McCants,4.0,2006 - 2009,SG,249,5037,923,2144,43.05037313432835,292,793,36.82219419924338,631,1351,46.706143597335306,49.86007462686567,341,460,74.1304347826087,114,392,506,331,183,61,362,584,2479
Aaron Miles,1.0,2006 - 2006,PG,19,118,6,18,33.33333333333333,0,0,,6,18,33.33333333333333,33.33333333333333,4,4,100.0,0,14,14,24,4,1,11,13,16
C.J. Miles,14.0,2006 - 2019,SF,838,17121,2864,6957,41.1671697570792,1239,3452,35.89223638470452,1625,3505,46.3623395149786,50.07187005893344,1077,1330,80.97744360902256,359,1640,1999,902,591,250,720,1777,8044
Sergei Monia,1.0,2006 - 2006,SF,26,343,29,87,33.33333333333333,9,34,26.47058823529412,20,53,37.735849056603776,38.50574712643678,10,14,71.42857142857143,11,41,52,19,7,5,12,41,77
Boniface N'Dong,1.0,2006 - 2006,C,23,152,22,53,41.509433962264154,0,1,0.0,22,52,42.30769230769231,41.509433962264154,6,9,66.66666666666666,15,22,37,7,2,5,6,23,50
Fabricio Oberto,6.0,2006 - 2011,C,336,4871,481,835,57.60479041916168,0,4,0.0,481,831,57.88206979542719,57.60479041916168,119,193,61.6580310880829,443,732,1175,300,89,75,225,733,1081
Andre Owens,2.0,2006 - 2008,PG,54,602,67,181,37.01657458563536,21,56,37.5,46,125,36.8,42.81767955801105,37,52,71.15384615384616,24,44,68,55,18,3,37,62,192
Chris Paul,14.0,2006 - 2019,PG,950,33350,6162,13132,46.92354553761803,1268,3426,37.01109165207239,4894,9706,50.422419122192466,51.75144684739568,4005,4613,86.81985692607847,641,3621,4262,9181,2122,122,2304,2342,17597
Johan Petro,8.0,2006 - 2013,C,473,7262,976,2114,46.16840113528855,2,13,15.384615384615385,974,2101,46.35887672536887,46.21570482497635,248,366,67.75956284153006,536,1300,1836,227,193,234,374,1158,2202
Josh Powell,7.0,2006 - 2014,PF,316,3966,498,1136,43.83802816901409,7,20,35.0,491,1116,43.99641577060932,44.146126760563384,223,300,74.33333333333333,331,601,932,161,49,68,254,491,1226
Ronnie Price,12.0,2006 - 2017,PG,544,7293,738,1980,37.27272727272727,244,808,30.198019801980198,494,1172,42.15017064846416,43.43434343434344,295,400,73.75,176,482,658,960,424,56,476,922,2015
Shavlik Randolph,8.0,2006 - 2015,PF,146,1202,129,287,44.94773519163763,1,6,16.666666666666664,128,281,45.55160142348754,45.1219512195122,81,149,54.36241610738255,151,212,363,36,44,38,59,193,340
Anthony Roberson,3.0,2006 - 2009,PG,65,591,102,255,40.0,52,146,35.61643835616438,50,109,45.87155963302752,50.19607843137255,9,10,90.0,8,41,49,35,23,1,24,51,265
Lawrence Roberts,2.0,2006 - 2007,C,87,1150,114,252,45.23809523809524,0,4,0.0,114,248,45.96774193548387,45.23809523809524,106,154,68.83116883116884,127,183,310,35,44,15,41,163,334
Nate Robinson,11.0,2006 - 2016,PG,618,13878,2458,5811,42.29908793667183,811,2255,35.96452328159645,1647,3556,46.316085489313835,49.277232834279815,1080,1357,79.58732498157701,385,1061,1446,1826,543,42,876,1482,6807
Melvin Sanders,1.0,2006 - 2006,SG,16,113,16,33,48.484848484848484,2,3,66.66666666666666,14,30,46.666666666666664,51.515151515151516,7,10,70.0,4,19,23,3,5,0,8,20,41
Alex Scales,1.0,2006 - 2006,SG,1,0,0,0,,0,0,,0,0,,,0,0,,0,0,0,0,0,0,0,0,0
Luke Schenscher,2.0,2006 - 2007,C,31,267,23,49,46.93877551020408,0,0,,23,49,46.93877551020408,46.93877551020408,9,20,45.0,18,36,54,8,3,7,9,46,55
Wayne Simien,2.0,2006 - 2007,PF,51,507,67,143,46.85314685314685,0,0,,67,143,46.85314685314685,46.85314685314685,35,41,85.36585365853658,43,56,99,11,15,1,27,83,169
James Singleton,5.0,2006 - 2012,PF,243,3252,362,783,46.23243933588761,35,120,29.166666666666668,327,663,49.321266968325794,48.46743295019157,195,234,83.33333333333334,321,589,910,109,97,117,140,390,954
Salim Stoudamire,3.0,2006 - 2008,SG,157,2672,446,1097,40.6563354603464,167,456,36.622807017543856,279,641,43.52574102964118,48.26800364630811,201,228,88.1578947368421,22,192,214,164,55,10,158,240,1260
Chris Taft,1.0,2006 - 2006,C,17,144,23,38,60.526315789473685,0,0,,23,38,60.526315789473685,60.526315789473685,1,6,16.666666666666664,19,17,36,2,2,7,2,25,47
Donell Taylor,2.0,2006 - 2007,SG,98,834,109,276,39.492753623188406,7,34,20.588235294117645,102,242,42.14876033057851,40.76086956521739,41,64,64.0625,30,76,106,90,47,7,59,81,266
Dijon Thompson,2.0,2006 - 2007,SG,16,93,17,40,42.5,4,13,30.76923076923077,13,27,48.148148148148145,47.5,7,8,87.5,7,12,19,3,3,1,3,8,45
Ronny Turiaf,10.0,2006 - 2015,C,473,8020,856,1607,53.266957062850025,0,7,0.0,856,1600,53.5,53.266957062850025,497,782,63.55498721227622,520,1237,1757,618,181,593,358,1116,2209
Charlie Villanueva,11.0,2006 - 2016,PF,656,13578,2652,6097,43.49680170575693,716,2101,34.07900999524036,1936,3996,48.44844844844845,49.36854190585534,788,1021,77.179236043095,795,2224,3019,549,329,349,650,1453,6808
Von Wafer,6.0,2006 - 2012,SG,200,2475,390,928,42.025862068965516,102,314,32.48407643312102,288,614,46.90553745928339,47.521551724137936,172,229,75.10917030567686,38,196,234,146,73,19,128,155,1054
Matt Walsh,1.0,2006 - 2006,SG,2,3,1,1,100.0,0,0,,1,1,100.0,100.0,0,2,0.0,0,0,0,0,0,0,1,0,2
Hakim Warrick,8.0,2006 - 2013,PF,526,10624,1776,3627,48.966087675765095,21,110,19.090909090909093,1755,3517,49.90048336650554,49.25558312655087,1374,1892,72.6215644820296,692,1425,2117,400,218,154,624,969,4947
Martell Webster,10.0,2006 - 2015,SF,580,13914,1696,4062,41.75283111767602,790,2067,38.2196419932269,906,1995,45.41353383458647,51.47710487444609,874,1105,79.09502262443439,352,1459,1811,588,299,160,536,1055,5056
Robert Whaley,1.0,2006 - 2006,C,23,212,23,57,40.35087719298245,0,0,,23,57,40.35087719298245,40.35087719298245,3,6,50.0,16,27,43,17,7,8,14,41,49
Deron Williams,12.0,2006 - 2017,PG,845,28865,4874,10964,44.45457862094126,1178,3296,35.74029126213592,3696,7668,48.200312989045386,49.82670558190441,2878,3502,82.18161050828098,353,2266,2619,6819,867,206,2402,2132,13804
Lou Williams,14.0,2006 - 2019,SG,936,23018,4266,10143,42.058562555456966,1240,3556,34.87064116985377,3026,6587,45.93897069986337,48.1711525189786,3533,4213,83.85948255399953,363,1695,2058,3094,834,171,1563,1249,13305
Marvin Williams,14.0,2006 - 2019,PF,1014,29030,3809,8605,44.264962231260895,990,2738,36.157779401022644,2819,5867,48.04840634054883,50.01743172574085,2014,2497,80.65678814577493,1246,4117,5363,1313,788,547,988,2052,10622
Antoine Wright,6.0,2006 - 2011,SG,297,5714,617,1499,41.160773849232825,155,510,30.392156862745097,462,989,46.71385237613751,46.33088725817211,225,334,67.36526946107784,157,524,681,295,139,72,227,598,1614
Bracey Wright,2.0,2006 - 2007,SG,26,325,45,111,40.54054054054054,12,37,32.432432432432435,33,74,44.5945945945946,45.94594594594595,27,34,79.41176470588235,10,29,39,20,10,1,14,14,129
Derrick Zimmerman,1.0,2006 - 2006,PG,2,32,2,3,66.66666666666666,0,0,,2,3,66.66666666666666,66.66666666666666,0,0,,1,3,4,7,0,0,4,4,4
Hassan Adams,2.0,2007 - 2009,SG,73,547,79,148,53.37837837837838,0,1,0.0,79,147,53.74149659863946,53.37837837837838,27,42,64.28571428571429,36,48,84,14,18,5,26,51,185
Maurice Ager,4.0,2007 - 2011,SG,82,505,64,189,33.86243386243386,11,44,25.0,53,145,36.55172413793103,36.77248677248677,30,53,56.60377358490566,8,38,46,19,6,6,29,65,169
LaMarcus Aldridge,13.0,2007 - 2019,PF,950,32764,7528,15325,49.12234910277324,121,427,28.337236533957842,7407,14898,49.71808296415626,49.517128874388256,3421,4223,81.00876154392613,2581,5387,7968,1856,697,1024,1498,2345,18598
Lou Amundson,10.0,2007 - 2016,PF,428,5507,648,1368,47.368421052631575,0,3,0.0,648,1365,47.47252747252747,47.368421052631575,268,603,44.44444444444444,644,897,1541,190,152,306,299,835,1564
Hilton Armstrong,6.0,2007 - 2014,C,292,3378,347,693,50.072150072150066,2,7,28.57142857142857,345,686,50.29154518950437,50.21645021645021,184,316,58.22784810126582,292,474,766,102,90,142,230,544,880
James Augustine,2.0,2007 - 2008,PF,27,156,19,37,51.35135135135135,0,0,,19,37,51.35135135135135,51.35135135135135,4,8,50.0,17,16,33,4,5,2,6,20,42
Kelenna Azubuike,5.0,2007 - 2012,SG,208,5025,802,1748,45.881006864988564,210,514,40.856031128404666,592,1234,47.9740680713128,51.887871853546905,364,473,76.95560253699789,257,572,829,230,130,103,203,408,2178
Renaldo Balkman,6.0,2007 - 2012,SF,221,3064,368,721,51.04022191400832,11,64,17.1875,357,657,54.337899543378995,51.803051317614425,147,271,54.24354243542435,278,491,769,132,164,104,134,421,894
J.J. Barea,13.0,2007 - 2019,PG,802,15837,2747,6478,42.405063291139236,787,2245,35.055679287305125,1960,4233,46.302858492794705,48.47946897190491,912,1152,79.16666666666666,243,1452,1695,3158,326,22,1226,1141,7193
Andrea Bargnani,10.0,2007 - 2016,C,550,15806,2932,6676,43.91851408028759,627,1771,35.40372670807454,2305,4905,46.99286442405708,48.61443978430198,1382,1677,82.40906380441264,530,2011,2541,653,207,470,851,1338,7873
Will Blalock,1.0,2007 - 2007,PG,14,166,9,30,30.0,1,5,20.0,8,25,32.0,31.666666666666664,6,6,100.0,6,9,15,17,5,0,12,9,25
Josh Boone,4.0,2007 - 2010,PF,256,4482,567,1042,54.41458733205374,0,0,,567,1042,54.41458733205374,54.41458733205374,206,463,44.49244060475162,484,774,1258,125,99,178,169,466,1340
Cedric Bozeman,1.0,2007 - 2007,SG,23,199,11,39,28.205128205128204,2,13,15.384615384615385,9,26,34.61538461538461,30.76923076923077,2,6,33.33333333333333,3,20,23,9,5,2,9,32,26
Ronnie Brewer,8.0,2007 - 2014,SG,502,11539,1554,3169,49.03755127800568,90,355,25.352112676056336,1464,2814,52.02558635394456,50.45755758914484,742,1099,67.51592356687898,451,976,1427,828,622,120,390,545,3940
Andre Brown,3.0,2007 - 2009,PF,75,598,82,159,51.57232704402516,0,1,0.0,82,158,51.89873417721519,51.57232704402516,33,66,50.0,70,108,178,11,14,8,48,73,197
Shannon Brown,9.0,2007 - 2015,SG,408,7329,1198,2854,41.97617379117028,276,831,33.2129963898917,922,2023,45.575877409787445,46.81149264190609,446,553,80.6509945750452,177,583,760,458,284,90,378,538,3118
Rodney Carney,5.0,2007 - 2011,SF,299,4600,675,1599,42.21388367729831,200,591,33.840947546531304,475,1008,47.12301587301587,48.46779237023139,228,324,70.37037037037037,164,424,588,132,159,100,157,420,1778
Mardy Collins,4.0,2007 - 2010,SG,189,2771,296,778,38.04627249357326,38,127,29.92125984251969,258,651,39.63133640552996,40.48843187660668,112,187,59.893048128342244,91,245,336,327,110,22,203,256,742
Will Conroy,3.0,2007 - 2013,PG,16,108,3,22,13.636363636363635,0,6,0.0,3,16,18.75,13.636363636363635,1,8,12.5,4,7,11,16,0,0,6,13,7
Paul Davis,4.0,2007 - 2010,PF,82,702,88,219,40.182648401826484,0,1,0.0,88,218,40.36697247706422,40.182648401826484,41,56,73.21428571428571,74,84,158,32,22,15,30,105,217
Yakhouba Diawara,4.0,2007 - 2010,SG,187,2614,233,653,35.68147013782542,122,405,30.12345679012346,111,248,44.75806451612903,45.0229709035222,67,103,65.0485436893204,77,181,258,122,52,16,72,276,655
Quincy Douby,3.0,2007 - 2009,PG,143,1535,222,571,38.879159369527144,68,218,31.19266055045872,154,353,43.626062322946176,44.833625218914186,76,86,88.37209302325581,34,118,152,93,50,21,87,128,588
Jordan Farmar,10.0,2007 - 2017,PG,504,9840,1460,3452,42.294322132097335,583,1559,37.39576651699807,877,1893,46.32857897517169,50.738702201622246,385,521,73.89635316698656,161,797,958,1453,391,56,695,713,3888
Desmon Farmer,2.0,2007 - 2009,SG,11,86,9,29,31.03448275862069,5,20,25.0,4,9,44.44444444444444,39.6551724137931,3,3,100.0,0,7,7,11,1,0,5,8,26
Randy Foye,11.0,2007 - 2017,SG,752,19279,2704,6750,40.059259259259264,1104,3017,36.59264169705005,1600,3733,42.86096972944013,48.23703703703704,1217,1429,85.16445066480057,245,1441,1686,2112,528,220,1106,1584,7729
Jorge Garbajosa,2.0,2007 - 2008,PF,74,1983,230,554,41.51624548736462,72,209,34.44976076555024,158,345,45.79710144927536,48.014440433213,57,78,73.07692307692307,50,295,345,128,81,15,65,92,589
Rudy Gay,13.0,2007 - 2019,SF,879,29888,5874,12881,45.602049530315966,903,2598,34.75750577367205,4971,10283,48.3419235631625,49.107212172967934,2810,3532,79.55832389580974,1256,3957,5213,1965,1107,688,2008,2143,15461
Mickael Gelabale,3.0,2007 - 2013,SF,145,2348,263,560,46.964285714285715,43,136,31.61764705882353,220,424,51.886792452830186,50.80357142857142,101,124,81.45161290322581,107,223,330,115,50,35,92,186,670
Daniel Gibson,7.0,2007 - 2013,PG,397,9316,1065,2646,40.249433106575964,578,1419,40.73291050035236,487,1227,39.69030154849226,51.17157974300831,407,522,77.96934865900383,142,650,792,775,243,86,373,811,3115
Andreas Glyniadakis,1.0,2007 - 2007,C,13,81,8,17,47.05882352941176,0,0,,8,17,47.05882352941176,47.05882352941176,1,2,50.0,2,6,8,1,0,0,9,19,17
Lynn Greer,1.0,2007 - 2007,SG,41,432,61,141,43.262411347517734,18,52,34.61538461538461,43,89,48.31460674157304,49.645390070921984,27,32,84.375,2,25,27,53,17,1,18,32,167
Mike Hall,1.0,2007 - 2007,SF,2,13,1,4,25.0,0,0,,1,4,25.0,25.0,0,0,,1,1,2,1,0,0,0,1,2
Walter Herrmann,3.0,2007 - 2009,PF,152,1939,312,681,45.81497797356828,114,299,38.12709030100335,198,382,51.832460732984295,54.18502202643172,81,103,78.64077669902912,78,241,319,66,31,12,61,143,819
Robert Hite,1.0,2007 - 2007,SG,12,136,19,60,31.666666666666664,5,23,21.73913043478261,14,37,37.83783783783784,35.833333333333336,8,12,66.66666666666666,4,12,16,8,3,2,6,8,51
Ryan Hollins,10.0,2007 - 2016,C,518,6134,687,1177,58.36873406966865,0,1,0.0,687,1176,58.41836734693877,58.36873406966865,539,830,64.93975903614458,457,683,1140,151,94,271,384,1037,1913
Mile Ilic,1.0,2007 - 2007,C,5,6,0,3,0.0,0,0,,0,3,0.0,0.0,0,0,,0,1,1,0,0,0,3,1,0
Ersan Ilyasova,11.0,2007 - 2019,PF,745,17823,2956,6680,44.25149700598802,815,2231,36.5307037203048,2141,4449,48.12317374690942,50.35179640718563,1158,1498,77.3030707610147,1328,3002,4330,855,526,273,749,1870,7885
Alexander Johnson,2.0,2007 - 2008,PF,102,1302,152,294,51.70068027210885,0,0,,152,294,51.70068027210885,51.70068027210885,135,201,67.16417910447761,82,193,275,30,38,45,89,217,439
Bobby Jones,2.0,2007 - 2008,SF,91,867,103,233,44.20600858369099,19,62,30.64516129032258,84,171,49.122807017543856,48.283261802575105,63,92,68.47826086956522,51,98,149,44,26,4,46,144,288
Solomon Jones,8.0,2007 - 2014,PF,281,3092,301,645,46.666666666666664,1,9,11.11111111111111,300,636,47.16981132075472,46.74418604651163,236,329,71.73252279635258,257,397,654,99,58,154,161,554,839
Tarence Kinsey,3.0,2007 - 2009,SG,109,1340,186,411,45.25547445255474,23,71,32.3943661971831,163,340,47.94117647058824,48.05352798053528,116,142,81.69014084507043,42,105,147,53,68,1,71,102,511
James Lang,1.0,2007 - 2007,C,11,55,4,9,44.44444444444444,0,0,,4,9,44.44444444444444,44.44444444444444,3,5,60.0,5,6,11,2,0,3,2,14,11
Kyle Lowry,13.0,2007 - 2019,PG,856,26781,3980,9395,42.36295902075572,1532,4170,36.73860911270983,2448,5225,46.85167464114833,50.51623203831825,2863,3558,80.46655424395728,704,2950,3654,5224,1156,241,1947,2300,12355
Renaldo Major,1.0,2007 - 2007,PF,1,27,2,10,20.0,0,0,,2,10,20.0,20.0,1,2,50.0,0,2,2,0,2,0,1,4,5
Damir Markota,1.0,2007 - 2007,PF,30,170,19,52,36.53846153846153,6,16,37.5,13,36,36.11111111111111,42.30769230769231,7,11,63.63636363636363,11,20,31,6,3,1,15,22,51
Chris McCray,1.0,2007 - 2007,SG,5,12,0,3,0.0,0,0,,0,3,0.0,0.0,0,0,,0,0,0,0,0,0,2,1,0
Ivan McFarlin,1.0,2007 - 2007,PF,11,41,5,13,38.46153846153847,0,1,0.0,5,12,41.66666666666667,38.46153846153847,5,7,71.42857142857143,7,4,11,1,0,0,1,8,15
Pops Mensah-Bonsu,4.0,2007 - 2011,PF,61,509,64,156,41.02564102564102,0,2,0.0,64,154,41.55844155844156,41.02564102564102,53,90,58.88888888888889,83,97,180,11,14,14,40,82,181
Paul Millsap,13.0,2007 - 2019,PF,945,27721,5008,10204,49.07879263034104,430,1286,33.43701399688958,4578,8918,51.33437990580848,51.1858094864759,2882,3927,73.38935574229691,2128,4876,7004,2168,1222,966,1689,2920,13328
Randolph Morris,4.0,2007 - 2010,C,74,438,52,122,42.62295081967213,0,0,,52,122,42.62295081967213,42.62295081967213,36,66,54.54545454545454,27,77,104,7,13,7,30,100,140
Adam Morrison,3.0,2007 - 2010,SF,161,3278,467,1252,37.30031948881789,124,375,33.06666666666666,343,877,39.110604332953244,42.25239616613419,142,200,71.0,82,260,342,222,40,12,172,273,1200
David Noel,1.0,2007 - 2007,PF,68,792,65,177,36.72316384180791,17,53,32.075471698113205,48,124,38.70967741935484,41.52542372881356,37,43,86.04651162790698,42,81,123,65,25,9,40,77,184
Steve Novak,11.0,2007 - 2017,PF,467,5657,751,1717,43.73907979033198,575,1337,43.00673148840688,176,380,46.31578947368421,60.48340128130461,100,114,87.71929824561403,68,523,591,132,91,38,81,371,2177
Patrick O'Bryant,4.0,2007 - 2010,C,90,524,79,160,49.375,0,3,0.0,79,157,50.318471337579616,49.375,28,48,58.333333333333336,32,95,127,25,18,40,42,126,186
Kevinn Pinkney,1.0,2007 - 2007,PF,6,100,12,27,44.44444444444444,1,2,50.0,11,25,44.0,46.2962962962963,6,9,66.66666666666666,7,8,15,5,3,3,4,12,31
Leon Powe,5.0,2007 - 2011,C,239,3320,490,952,51.470588235294116,0,5,0.0,490,947,51.74234424498416,51.470588235294116,504,739,68.20027063599458,380,531,911,78,69,82,189,503,1484
Roger Powell,1.0,2007 - 2007,SF,3,13,0,3,0.0,0,1,0.0,0,2,0.0,0.0,2,2,100.0,3,0,3,0,0,0,3,2,2
Chris Quinn,6.0,2007 - 2013,PG,241,3303,381,956,39.853556485355654,161,427,37.704918032786885,220,529,41.58790170132325,48.27405857740586,169,209,80.86124401913875,30,236,266,455,102,8,137,249,1092
Allan Ray,1.0,2007 - 2007,SG,47,710,100,259,38.61003861003861,48,116,41.37931034482759,52,143,36.36363636363637,47.87644787644788,42,55,76.36363636363637,18,51,69,43,20,3,42,85,290
J.J. Redick,13.0,2007 - 2019,SG,836,21660,3617,8078,44.775934637286454,1704,4129,41.26907241462824,1913,3949,48.44264370726766,55.323099777172565,1846,2073,89.04968644476604,158,1530,1688,1692,389,75,929,1271,10784
Jeremy Richardson,3.0,2007 - 2009,SG-SF,45,245,33,99,33.33333333333333,15,39,38.46153846153847,18,60,30.0,40.909090909090914,5,8,62.5,3,22,25,5,4,0,10,21,86
Sergio Rodriguez,5.0,2007 - 2017,PG,353,5281,676,1651,40.94488188976378,202,600,33.666666666666664,474,1051,45.09990485252141,47.062386432465175,193,261,73.9463601532567,121,404,525,1183,212,13,491,441,1747
Rajon Rondo,13.0,2007 - 2019,PG,825,26119,3586,7797,45.99204822367577,341,1082,31.515711645101664,3245,6715,48.324646314221894,48.178786712838274,1054,1742,60.50516647531573,854,3135,3989,6975,1411,113,2348,1830,8567
Brandon Roy,6.0,2007 - 2013,SG,326,11561,2224,4849,45.865126830274285,322,925,34.81081081081081,1902,3924,48.47094801223242,49.18539905135079,1366,1707,80.02343292325718,347,1041,1388,1517,335,76,595,630,6136
Thabo Sefolosha,13.0,2007 - 2019,SG,828,18626,1879,4174,45.01677048394825,498,1415,35.19434628975265,1381,2759,50.054367524465384,50.98227120268328,646,879,73.49260523321956,605,2554,3159,1171,911,354,740,1375,4902
Mouhamed Sene,3.0,2007 - 2009,C,47,260,35,82,42.68292682926829,0,0,,35,82,42.68292682926829,42.68292682926829,33,56,58.92857142857143,28,47,75,1,4,22,15,44,103
Cedric Simmons,3.0,2007 - 2009,PF,75,705,70,171,40.93567251461988,0,0,,70,171,40.93567251461988,40.93567251461988,23,59,38.983050847457626,55,86,141,14,11,32,30,91,163
Uros Slokar,1.0,2007 - 2007,C,20,72,14,26,53.84615384615385,1,2,50.0,13,24,54.166666666666664,55.769230769230774,9,13,69.23076923076923,7,7,14,1,1,2,9,11,38
Craig Smith,6.0,2007 - 2012,PF,403,6826,1221,2207,55.32396918894427,1,27,3.7037037037037033,1220,2180,55.96330275229357,55.346624376982334,637,963,66.14745586708204,543,1024,1567,322,183,91,413,957,3080
Steven Smith,1.0,2007 - 2007,PF,8,28,2,8,25.0,0,0,,2,8,25.0,25.0,1,2,50.0,1,5,6,0,1,0,2,4,5
Vassilis Spanoulis,1.0,2007 - 2007,SG,31,272,23,72,31.944444444444443,5,29,17.24137931034483,18,43,41.86046511627907,35.41666666666667,34,42,80.95238095238095,5,17,22,28,7,1,29,33,85
Tyrus Thomas,8.0,2007 - 2015,PF,402,7932,1147,2620,43.778625954198475,8,34,23.52941176470588,1139,2586,44.04485692188708,43.93129770992367,791,1080,73.24074074074073,550,1388,1938,347,328,525,527,989,3093
P.J. Tucker,8.0,2007 - 2019,SF,582,16725,1564,3705,42.2132253711201,582,1612,36.10421836228288,982,2093,46.91829909221214,50.067476383265856,594,798,74.43609022556392,914,2409,3323,824,713,169,585,1395,4304
Marcus Vinicius,2.0,2007 - 2008,SF,26,172,16,35,45.714285714285715,8,19,42.10526315789473,8,16,50.0,57.14285714285714,10,18,55.55555555555556,3,16,19,7,3,2,9,14,50
James White,3.0,2007 - 2013,SF,67,583,71,162,43.82716049382716,17,50,34.0,54,112,48.214285714285715,49.074074074074076,23,34,67.64705882352942,8,60,68,35,17,6,25,53,182
Justin Williams,2.0,2007 - 2008,C,49,456,67,117,57.26495726495726,0,1,0.0,67,116,57.758620689655174,57.26495726495726,31,89,34.831460674157306,71,93,164,2,10,21,19,68,165
Marcus Williams,4.0,2007 - 2010,PG,203,3095,427,1107,38.572719060523944,126,392,32.142857142857146,301,715,42.09790209790209,44.26377597109305,148,193,76.68393782383419,56,305,361,574,87,7,295,197,1128
Shawne Williams,7.0,2007 - 2015,SF,314,5368,650,1612,40.32258064516129,275,812,33.86699507389162,375,800,46.875,48.85235732009925,194,257,75.4863813229572,247,698,945,220,127,156,197,656,1769
Shelden Williams,6.0,2007 - 2012,PF,361,5586,590,1276,46.23824451410658,2,9,22.22222222222222,588,1267,46.408839779005525,46.3166144200627,436,589,74.02376910016977,529,1033,1562,163,179,164,304,733,1618
Arron Afflalo,11.0,2008 - 2018,SG,762,20829,2983,6633,44.97210915121363,852,2205,38.63945578231293,2131,4428,48.12556458897922,51.394542439318556,1380,1673,82.48655110579797,334,1842,2176,1386,341,141,852,1481,8198
Blake Ahearn,3.0,2008 - 2012,PG,19,226,21,77,27.27272727272727,14,47,29.78723404255319,7,30,23.333333333333332,36.36363636363637,32,33,96.96969696969697,1,21,22,22,7,0,22,27,88
Lance Allred,1.0,2008 - 2008,C,3,10,1,4,25.0,0,0,,1,4,25.0,25.0,1,2,50.0,0,1,1,0,0,0,0,1,3
Morris Almond,3.0,2008 - 2012,SG,38,361,43,113,38.05309734513274,7,24,29.166666666666668,36,89,40.44943820224719,41.150442477876105,26,35,74.28571428571429,10,36,46,12,12,4,19,42,119
Joel Anthony,10.0,2008 - 2017,C,490,7056,398,776,51.28865979381443,0,0,,398,776,51.28865979381443,51.28865979381443,268,405,66.17283950617285,562,791,1353,99,127,531,227,819,1064
Marco Belinelli,12.0,2008 - 2019,SG,803,18665,2826,6645,42.52821670428894,1149,3052,37.647444298820446,1677,3593,46.67408850542722,51.17381489841987,1208,1427,84.6531184302733,180,1490,1670,1360,476,64,831,1177,8009
Corey Brewer,12.0,2008 - 2019,SF,814,18738,2682,6310,42.50396196513471,503,1773,28.369994359842078,2179,4537,48.02733083535376,46.48969889064976,1225,1717,71.34536983110075,611,1668,2279,1248,1019,222,948,1761,7092
Aaron Brooks,10.0,2008 - 2018,PG,645,13439,2261,5478,41.274187659729826,820,2218,36.9702434625789,1441,3260,44.20245398773006,48.758671047827676,917,1095,83.74429223744292,254,825,1079,1925,359,87,1000,1217,6259
Wilson Chandler,11.0,2008 - 2019,SF,641,19553,3196,7199,44.39505486873177,837,2439,34.31734317343174,2359,4760,49.55882352941177,50.208362272537855,1029,1340,76.7910447761194,755,2674,3429,1166,454,402,897,1728,8258
Mike Conley,12.0,2008 - 2019,PG,788,25700,4182,9484,44.095318431041754,1086,2894,37.52591568762958,3096,6590,46.980273141122915,49.820750738085195,2283,2788,81.88665710186514,340,1987,2327,4509,1161,162,1586,1548,11733
Daequan Cook,6.0,2008 - 2013,SG,328,5993,758,2056,36.86770428015564,442,1232,35.87662337662338,316,824,38.349514563106794,47.61673151750973,156,192,81.25,75,628,703,243,120,48,177,478,2114
Javaris Crittenton,2.0,2008 - 2009,PG-SG,113,1853,229,518,44.20849420849421,12,52,23.076923076923077,217,466,46.56652360515021,45.366795366795365,125,196,63.775510204081634,84,192,276,201,59,8,137,148,595
Jermareo Davidson,2.0,2008 - 2009,SF,52,433,68,160,42.5,0,0,,68,160,42.5,42.5,26,45,57.77777777777777,31,65,96,14,9,18,22,58,162
Glen Davis,8.0,2008 - 2015,PF,514,10865,1614,3611,44.69675990030462,10,55,18.181818181818183,1604,3556,45.10686164229472,44.835225699252284,873,1247,70.00801924619086,731,1505,2236,457,357,173,528,1238,4111
Guillermo Diaz,1.0,2008 - 2008,SG,6,18,1,4,25.0,0,1,0.0,1,3,33.33333333333333,25.0,3,5,60.0,2,0,2,1,0,0,0,0,5
Jared Dudley,12.0,2008 - 2019,PF,847,19672,2382,5128,46.45085803432137,863,2199,39.245111414279215,1519,2929,51.86070331171047,54.86544461778471,932,1274,73.15541601255887,795,1981,2776,1361,694,163,753,1588,6559
Kevin Durant,12.0,2008 - 2019,SF,849,31305,7814,15859,49.271706917207894,1570,4122,38.08830664725861,6244,11737,53.19928431456079,54.221577653067655,5742,6506,88.25699354442054,617,5375,5992,3486,948,941,2653,1618,22940
Nick Fazekas,1.0,2008 - 2008,PF,26,269,46,82,56.09756097560976,0,2,0.0,46,80,57.49999999999999,56.09756097560976,15,22,68.18181818181817,34,55,89,11,8,11,13,25,107
Kyrylo Fesenko,5.0,2008 - 2012,C,135,1107,125,252,49.60317460317461,0,2,0.0,125,250,50.0,49.60317460317461,55,134,41.04477611940299,97,172,269,40,19,53,66,224,305
Thomas Gardner,2.0,2008 - 2009,SG,20,143,18,59,30.508474576271187,7,35,20.0,11,24,45.83333333333333,36.440677966101696,2,6,33.33333333333333,3,8,11,3,4,1,7,8,45
Marcin Gortat,12.0,2008 - 2019,C,806,20691,3401,6168,55.139429312581065,3,20,15.0,3398,6148,55.27000650618087,55.163748378728926,1146,1686,67.97153024911033,1759,4648,6407,915,383,885,958,1775,7951
Aaron Gray,7.0,2008 - 2014,C,318,3851,440,864,50.92592592592593,0,3,0.0,440,861,51.10336817653891,50.92592592592593,186,331,56.19335347432024,431,759,1190,207,94,87,265,678,1066
Jeff Green,11.0,2008 - 2019,PF,860,25819,4118,9338,44.099378881987576,871,2612,33.34609494640122,3247,6726,48.27534939042521,48.763118440779614,2213,2748,80.53129548762736,809,3066,3875,1371,629,466,1314,1909,11320
Taurean Green,1.0,2008 - 2008,SG-PG,17,74,7,25,28.000000000000004,2,11,18.181818181818183,5,14,35.714285714285715,32.0,11,12,91.66666666666666,0,10,10,11,2,0,9,5,27
Mike Harris,4.0,2008 - 2014,PF,54,496,70,151,46.35761589403973,0,5,0.0,70,146,47.94520547945205,46.35761589403973,43,55,78.18181818181819,51,65,116,12,27,12,30,68,183
Spencer Hawes,10.0,2008 - 2017,C,684,15541,2451,5363,45.70203244452732,359,1026,34.99025341130604,2092,4337,48.236107908692645,49.049039716576544,671,937,71.61152614727855,991,2902,3893,1271,264,652,971,1709,5932
Al Horford,12.0,2008 - 2019,C,786,25785,4678,8903,52.5440862630574,365,992,36.79435483870967,4313,7911,54.51902414359753,54.593957093114675,1371,1818,75.41254125412541,1695,4902,6597,2548,636,947,1264,1801,11092
Yi Jianlian,5.0,2008 - 2012,PF,272,6038,813,2012,40.40755467196819,75,225,33.33333333333333,738,1787,41.2982652490207,42.2713717693837,447,573,78.01047120418848,379,960,1339,192,136,184,302,618,2148
Coby Karl,2.0,2008 - 2010,SG,24,184,20,58,34.48275862068966,6,24,25.0,14,34,41.17647058823529,39.6551724137931,12,16,75.0,7,25,32,24,7,3,15,18,58
Carl Landry,9.0,2008 - 2016,PF,513,11524,2086,3898,53.514622883530016,9,30,30.0,2077,3868,53.69700103412617,53.63006670087225,1360,1732,78.52193995381063,994,1539,2533,355,216,203,603,1208,5541
Keith Langford,1.0,2008 - 2008,SG,2,10,1,4,25.0,0,0,,1,4,25.0,25.0,0,0,,0,2,2,0,0,0,0,1,2
Stephane Lasme,1.0,2008 - 2008,PF-SF,16,303,32,71,45.07042253521127,0,0,,32,71,45.07042253521127,45.07042253521127,19,32,59.375,26,27,53,3,13,22,15,35,83
Acie Law,4.0,2008 - 2011,PG,188,2385,263,637,41.287284144427,27,115,23.47826086956522,236,522,45.21072796934866,43.40659340659341,172,221,77.82805429864254,33,162,195,309,83,4,145,193,725
Ian Mahinmi,11.0,2008 - 2019,C,580,9545,1097,2044,53.6692759295499,3,24,12.5,1094,2020,54.15841584158416,53.74266144814091,729,1192,61.15771812080537,859,1628,2487,308,326,399,556,1521,2926
Dominic McGuire,6.0,2008 - 2013,SF,342,5348,388,927,41.855447680690396,3,16,18.75,385,911,42.26125137211855,42.017259978425024,160,243,65.84362139917695,344,825,1169,422,154,184,242,501,939
Josh McRoberts,11.0,2008 - 2018,PF,433,8271,914,1972,46.34888438133874,196,576,34.02777777777778,718,1396,51.43266475644699,51.3184584178499,309,438,70.54794520547945,468,1218,1686,901,222,194,381,817,2333
Jamario Moon,5.0,2008 - 2012,SF,286,6451,723,1568,46.109693877551024,177,538,32.899628252788105,546,1030,53.00970873786408,51.753826530612244,184,229,80.34934497816593,201,1026,1227,291,229,236,147,424,1807
Juan Carlos Navarro,1.0,2008 - 2008,SG,82,2117,308,766,40.2088772845953,156,432,36.11111111111111,152,334,45.50898203592814,50.391644908616186,124,146,84.93150684931507,34,176,210,177,48,1,134,94,896
Demetris Nichols,2.0,2008 - 2009,SF,18,58,9,32,28.125,3,15,20.0,6,17,35.294117647058826,32.8125,1,2,50.0,0,7,7,2,0,4,4,5,22
Joakim Noah,12.0,2008 - 2019,C,667,18596,2244,4566,49.14586070959264,0,16,0.0,2244,4550,49.31868131868132,49.14586070959264,1379,1971,69.96448503297819,2136,3906,6042,1900,533,873,1127,1865,5867
Oleksiy Pecherov,3.0,2008 - 2010,C,111,1044,160,414,38.64734299516908,45,155,29.03225806451613,115,259,44.4015444015444,44.08212560386474,73,92,79.34782608695652,88,178,266,20,21,22,59,119,438
Kosta Perovic,1.0,2008 - 2008,C,7,38,3,10,30.0,0,0,,3,10,30.0,30.0,4,6,66.66666666666666,6,7,13,1,0,2,1,6,10
Kasib Powell,1.0,2008 - 2008,SF,11,304,35,95,36.84210526315789,8,33,24.242424242424242,27,62,43.54838709677419,41.05263157894737,6,9,66.66666666666666,8,36,44,18,9,2,5,18,84
Gabe Pruitt,2.0,2008 - 2009,SG,62,461,45,140,32.142857142857146,17,60,28.333333333333332,28,80,35.0,38.21428571428571,18,23,78.26086956521739,10,41,51,52,20,3,24,44,125
Chris Richard,2.0,2008 - 2010,C,70,780,56,116,48.275862068965516,0,0,,56,116,48.275862068965516,48.275862068965516,23,38,60.526315789473685,71,123,194,25,18,16,38,133,135
Cheikh Samb,2.0,2008 - 2009,C,22,114,9,36,25.0,0,3,0.0,9,33,27.27272727272727,25.0,4,9,44.44444444444444,13,18,31,1,4,12,4,15,22
Luis Scola,10.0,2008 - 2017,PF,743,19001,3669,7442,49.30126310131685,92,271,33.94833948339483,3577,7171,49.88146701994143,49.9193765116904,1452,1961,74.04385517593064,1335,3606,4941,1194,474,224,1121,2037,8882
Ramon Sessions,11.0,2008 - 2018,PG,691,16119,2406,5539,43.437443581873985,208,658,31.61094224924012,2198,4881,45.03175578774841,45.3150388156707,2121,2681,79.11227154046998,339,1501,1840,2807,472,52,1173,942,7141
Courtney Sims,2.0,2008 - 2009,C,5,24,3,7,42.857142857142854,0,0,,3,7,42.857142857142854,42.857142857142854,0,0,,3,3,6,1,0,0,1,3,6
Jason Smith,11.0,2008 - 2019,C,616,10029,1572,3360,46.785714285714285,84,252,33.33333333333333,1488,3108,47.87644787644788,48.035714285714285,549,701,78.3166904422254,656,1419,2075,453,208,408,507,1337,3777
D.J. Strawberry,1.0,2008 - 2008,SG,33,270,29,92,31.521739130434785,6,25,24.0,23,67,34.32835820895522,34.78260869565217,9,19,47.368421052631575,9,19,28,30,12,6,11,36,73
Rodney Stuckey,10.0,2008 - 2017,PG,651,17890,2904,6870,42.2707423580786,276,921,29.967426710097723,2628,5949,44.175491679273826,44.27947598253275,2101,2551,82.35985887887102,419,1493,1912,2333,568,94,1181,1346,8185
Al Thornton,4.0,2008 - 2011,SF,296,8274,1368,3029,45.16342027071641,78,266,29.32330827067669,1290,2763,46.68838219326818,46.450973918785074,713,954,74.73794549266248,392,841,1233,353,185,152,424,771,3527
Alando Tucker,3.0,2008 - 2010,SF,51,426,77,182,42.30769230769231,10,34,29.411764705882355,67,148,45.27027027027027,45.05494505494506,47,60,78.33333333333333,29,20,49,16,5,2,19,22,211
Darius Washington,1.0,2008 - 2008,SG,18,146,21,48,43.75,4,12,33.33333333333333,17,36,47.22222222222222,47.91666666666667,7,13,53.84615384615385,4,16,20,15,5,0,14,16,53
Darryl Watkins,2.0,2008 - 2012,C,14,169,12,29,41.37931034482759,0,0,,12,29,41.37931034482759,41.37931034482759,11,23,47.82608695652174,13,26,39,3,7,6,15,22,35
C.J. Watson,10.0,2008 - 2017,PG,600,12093,1516,3617,41.91318772463368,471,1263,37.29216152019003,1045,2354,44.39252336448598,48.4241083771081,841,1036,81.17760617760618,218,938,1156,1485,559,67,650,894,4344
Mario West,4.0,2008 - 2011,SG,162,796,56,125,44.800000000000004,2,10,20.0,54,115,46.95652173913044,45.6,40,71,56.33802816901409,60,82,142,51,45,8,31,134,154
Sean Williams,4.0,2008 - 2012,C,137,1978,229,448,51.11607142857143,0,1,0.0,229,447,51.23042505592841,51.11607142857143,123,197,62.43654822335025,183,289,472,47,47,162,120,324,581
Brandan Wright,10.0,2008 - 2018,PF,428,6949,1271,2095,60.66825775656325,0,12,0.0,1271,2083,61.01776284205472,60.66825775656325,434,644,67.3913043478261,586,974,1560,199,198,425,202,574,2976
Julian Wright,4.0,2008 - 2011,SF,231,3049,397,795,49.937106918238996,16,61,26.229508196721312,381,734,51.90735694822888,50.943396226415096,97,166,58.43373493975904,184,347,531,182,132,69,164,182,907
Nick Young,12.0,2008 - 2019,SG,720,16419,2894,6920,41.820809248554916,1039,2764,37.5904486251809,1855,4156,44.634263715110684,49.328034682080926,1367,1636,83.55745721271394,260,1167,1427,687,394,135,711,1316,8194
Thaddeus Young,12.0,2008 - 2019,PF,901,27690,5190,10361,50.09168999131358,407,1237,32.90218270008084,4783,9124,52.42218325295923,52.05578612103079,1257,1868,67.29122055674517,1837,3562,5399,1490,1315,367,1293,1982,12044
Alexis Ajinca,7.0,2009 - 2017,C,293,3905,645,1283,50.272798129384256,12,42,28.57142857142857,633,1241,51.00725221595488,50.74045206547155,251,315,79.68253968253968,346,804,1150,143,102,181,249,661,1553
Joe Alexander,2.0,2009 - 2010,SF,67,745,103,251,41.03585657370518,16,47,34.04255319148936,87,204,42.64705882352941,44.223107569721115,60,86,69.76744186046511,46,74,120,44,16,30,52,116,282
Ryan Anderson,11.0,2009 - 2019,PF,647,16755,2753,6526,42.18510573092246,1324,3486,37.98049340218015,1429,3040,47.006578947368425,52.329144958627026,1166,1366,85.35871156661786,1247,2159,3406,584,331,217,605,1262,7996
Darrell Arthur,9.0,2009 - 2018,PF,503,8945,1381,3110,44.40514469453376,161,458,35.1528384279476,1220,2652,46.003016591251885,46.9935691318328,359,469,76.54584221748401,547,1221,1768,409,309,307,422,1234,3282
D.J. Augustin,11.0,2009 - 2019,PG,807,19419,2581,6244,41.335682254964766,1041,2729,38.14584096738732,1540,3515,43.81223328591749,49.671684817424726,1725,1999,86.29314657328663,239,1282,1521,3204,488,29,1221,1183,7928
Nicolas Batum,11.0,2009 - 2019,SF,767,24228,3217,7389,43.53769116253891,1233,3447,35.77023498694517,1984,3942,50.32978183663115,51.88117471917716,1372,1632,84.06862745098039,810,3227,4037,2901,730,492,1427,1357,9039
Jerryd Bayless,11.0,2009 - 2019,PG,586,12486,1719,4180,41.124401913875595,499,1382,36.10709117221418,1220,2798,43.60257326661902,47.0933014354067,972,1188,81.81818181818183,176,1059,1235,1674,370,73,825,1206,4909
Michael Beasley,11.0,2009 - 2019,PF,609,13903,3088,6644,46.47802528597231,291,835,34.8502994011976,2797,5809,48.14942330865898,48.66797110174594,1101,1450,75.93103448275862,664,2197,2861,788,345,314,1025,1294,7568
Bobby Brown,4.0,2009 - 2018,PG,158,1688,271,715,37.9020979020979,96,303,31.683168316831683,175,412,42.4757281553398,44.61538461538462,50,62,80.64516129032258,23,80,103,230,41,4,123,148,688
Mario Chalmers,9.0,2009 - 2018,PG,646,17245,1936,4641,41.71514759750054,755,2153,35.067347886669765,1181,2488,47.467845659163984,49.84917043740573,1116,1407,79.317697228145,211,1374,1585,2412,950,103,1202,1756,5743
Joe Crawford,1.0,2009 - 2009,SF,2,23,3,10,30.0,1,4,25.0,2,6,33.33333333333333,35.0,2,2,100.0,1,3,4,1,1,0,0,2,9
Joey Dorsey,4.0,2009 - 2015,PF,130,1488,142,266,53.383458646616546,0,1,0.0,142,265,53.58490566037736,53.383458646616546,60,160,37.5,198,315,513,55,67,44,86,256,344
Chris Douglas-Roberts,6.0,2009 - 2015,SG,222,4381,574,1309,43.85026737967914,84,255,32.94117647058823,490,1054,46.48956356736243,47.05882352941176,339,408,83.08823529411765,83,389,472,254,128,55,200,287,1571
Goran Dragic,11.0,2009 - 2019,PG,758,21236,3848,8264,46.563407550822845,867,2391,36.26097867001255,2981,5873,50.75770475055338,51.80905130687319,1858,2437,76.24128026261798,560,1755,2315,3648,771,141,1705,1772,10421
Rudy Fernandez,4.0,2009 - 2012,SG,249,5965,740,1853,39.93524015110631,413,1147,36.00697471665214,327,706,46.317280453257794,51.07933081489476,361,430,83.95348837209302,128,480,608,554,249,40,286,369,2254
Danilo Gallinari,10.0,2009 - 2019,SF,549,17052,2631,6187,42.52464845644092,1033,2745,37.63205828779599,1598,3442,46.426496223126094,50.87279780184257,2425,2785,87.07360861759426,415,2254,2669,1118,436,235,728,1032,8720
Marc Gasol,11.0,2009 - 2019,C,795,26565,4428,9165,48.314238952536826,324,927,34.95145631067961,4104,8238,49.817916970138384,50.08183306055647,2741,3526,77.73681225184345,1342,4772,6114,2740,732,1158,1643,2312,11921
J.R. Giddens,2.0,2009 - 2010,SF,38,247,30,63,47.61904761904761,0,10,0.0,30,53,56.60377358490566,47.61904761904761,13,23,56.52173913043478,18,36,54,13,10,2,18,30,73
Eric Gordon,11.0,2009 - 2019,SG,629,20783,3571,8345,42.7920910724985,1457,3898,37.37814263724987,2114,4447,47.53766584214077,51.521869382864,1898,2333,81.3544792113159,266,1303,1569,1842,576,214,1270,1244,10497
Donte Greene,4.0,2009 - 2012,SF,253,4259,585,1441,40.59680777238029,165,542,30.44280442804428,420,899,46.71857619577308,46.32199861207495,206,294,70.06802721088435,140,460,600,183,111,116,222,373,1541
Hamed Haddadi,5.0,2009 - 2013,C,151,1056,130,281,46.263345195729535,0,5,0.0,130,276,47.10144927536232,46.263345195729535,79,125,63.2,137,235,372,43,11,92,92,209,339
Malik Hairston,2.0,2009 - 2010,SG,62,472,64,125,51.2,2,12,16.666666666666664,62,113,54.86725663716814,52.0,19,37,51.35135135135135,24,53,77,29,10,16,23,48,149
Roy Hibbert,9.0,2009 - 2017,C,662,16389,2622,5641,46.48112036872895,6,24,25.0,2616,5617,46.57290368524123,46.5343024286474,1361,1802,75.52719200887901,1527,2646,4173,885,241,1146,1038,2067,6611
J.J. Hickson,8.0,2009 - 2016,C,534,11925,2049,4056,50.51775147928994,0,21,0.0,2049,4035,50.78066914498142,50.51775147928994,983,1593,61.70747018204645,1173,2466,3639,449,274,309,774,1033,5081
George Hill,11.0,2009 - 2019,PG,726,20471,2892,6379,45.33625960181847,879,2323,37.83900129143349,2013,4056,49.6301775147929,52.22605424047656,1501,1873,80.1388147357181,414,1839,2253,2324,668,211,928,1519,8164
Steven Hill,1.0,2009 - 2009,PF,1,2,1,1,100.0,0,0,,1,1,100.0,100.0,0,0,,2,1,3,0,0,0,0,0,2
Othello Hunter,2.0,2009 - 2010,PF,23,125,15,32,46.875,0,0,,15,32,46.875,46.875,3,9,33.33333333333333,15,21,36,1,2,6,5,16,33
Darnell Jackson,3.0,2009 - 2011,PF,138,1039,123,274,44.89051094890511,4,17,23.52941176470588,119,257,46.30350194552529,45.62043795620438,58,90,64.44444444444444,90,113,203,26,24,11,50,159,308
Nathan Jawai,2.0,2009 - 2010,C,45,431,50,115,43.47826086956522,0,1,0.0,50,114,43.859649122807014,43.47826086956522,26,38,68.42105263157895,50,56,106,24,10,9,29,61,126
Dontell Jefferson,1.0,2009 - 2009,SG,6,84,11,22,50.0,1,2,50.0,10,20,50.0,52.27272727272727,6,9,66.66666666666666,1,11,12,9,4,1,6,9,29
Trey Johnson,3.0,2009 - 2012,SG,23,169,20,52,38.46153846153847,1,3,33.33333333333333,19,49,38.775510204081634,39.42307692307692,18,19,94.73684210526315,5,15,20,15,2,1,11,26,59
DeAndre Jordan,11.0,2009 - 2019,C,819,23092,3146,4698,66.96466581524054,1,11,9.090909090909092,3145,4687,67.10049071901003,66.9753086419753,1543,3309,46.63040193411907,2660,6230,8890,713,490,1350,1135,2182,7836
Kosta Koufos,11.0,2009 - 2019,C,686,11271,1750,3277,53.40250228867867,0,4,0.0,1750,3273,53.46776657500764,53.40250228867867,413,710,58.16901408450704,1198,2254,3452,359,291,506,479,1398,3913
Rob Kurz,1.0,2009 - 2009,SF,40,442,51,131,38.93129770992366,15,38,39.473684210526315,36,93,38.70967741935484,44.656488549618324,40,50,80.0,33,48,81,20,14,19,16,78,157
Courtney Lee,11.0,2009 - 2019,SG,787,21593,2921,6485,45.04240555127217,855,2212,38.65280289330922,2066,4273,48.35010531242687,51.63454124903624,961,1127,85.2706299911269,357,1738,2095,1341,791,207,751,1306,7658
Brook Lopez,11.0,2009 - 2019,C,717,22175,4768,9577,49.785945494413696,436,1255,34.7410358565737,4332,8322,52.054794520547944,52.06223243186802,2442,3086,79.13156189241737,1593,3102,4695,1091,409,1249,1335,1957,12414
Robin Lopez,11.0,2009 - 2019,C,766,17649,2903,5471,53.061597514165605,11,51,21.568627450980394,2892,5420,53.35793357933579,53.16212758179491,1126,1487,75.72293207800942,1856,2189,4045,642,189,927,854,1536,6943
Kevin Love,11.0,2009 - 2019,PF,657,21023,3953,8946,44.187346300022355,1077,2912,36.98489010989011,2876,6034,47.66324163075903,50.2067963335569,3023,3656,82.68599562363238,1918,5479,7397,1519,453,303,1271,1409,12006
Cartier Martin,7.0,2009 - 2015,SF,243,3351,430,1098,39.162112932604735,218,586,37.20136518771331,212,512,41.40625,49.08925318761385,151,207,72.94685990338165,88,375,463,121,97,27,128,317,1229
O.J. Mayo,8.0,2009 - 2016,SG,547,16919,2808,6547,42.88987322437758,854,2287,37.34149540883253,1954,4260,45.86854460093897,49.41194440201619,1104,1346,82.02080237741455,285,1421,1706,1607,559,141,1130,1239,7574
Luc Mbah a Moute,11.0,2009 - 2019,PF,686,16013,1683,3703,45.44963543073184,207,617,33.54943273905997,1476,3086,47.82890473104342,48.24466648663246,802,1216,65.95394736842105,961,1837,2798,588,610,263,645,1242,4375
JaVale McGee,11.0,2009 - 2019,C,633,11002,2169,3807,56.973995271867615,2,27,7.4074074074074066,2167,3780,57.32804232804233,57.00026267402154,733,1246,58.82825040128411,1187,2032,3219,240,250,983,613,1362,5073
Anthony Morrow,9.0,2009 - 2017,SG,564,12280,1956,4380,44.657534246575345,807,1937,41.66236448115643,1149,2443,47.032337290216944,53.86986301369863,608,691,87.98842257597684,309,906,1215,494,317,75,380,897,5327
DeMarcus Nelson,1.0,2009 - 2009,PG,13,171,24,54,44.44444444444444,0,3,0.0,24,51,47.05882352941176,44.44444444444444,5,14,35.714285714285715,6,18,24,13,9,2,15,24,53
Greg Oden,3.0,2009 - 2014,C,105,2028,317,552,57.427536231884055,0,0,,317,552,57.427536231884055,57.427536231884055,206,313,65.814696485623,256,400,656,51,40,130,138,374,840
Anthony Randolph,6.0,2009 - 2014,PF,252,3841,677,1494,45.31459170013387,20,83,24.096385542168676,657,1411,46.56272147413183,45.98393574297189,415,561,73.97504456327985,335,743,1078,187,150,224,298,456,1789
Derrick Rose,10.0,2009 - 2019,PG,546,18104,4006,8836,45.33725667722951,424,1394,30.416068866571017,3582,7442,48.13222252082773,47.736532367587145,1845,2239,82.40285841893703,470,1440,1910,3056,410,188,1450,728,10281
Brandon Rush,9.0,2009 - 2017,SG,481,10564,1220,2861,42.64243271583362,522,1300,40.15384615384615,698,1561,44.7149263292761,51.7651170919259,288,408,70.58823529411765,187,1226,1413,468,222,262,400,620,3250
Walter Sharpe,1.0,2009 - 2009,PF,8,20,4,11,36.36363636363637,0,2,0.0,4,9,44.44444444444444,36.36363636363637,0,2,0.0,0,3,3,0,0,2,0,3,8
Sean Singletary,1.0,2009 - 2009,PG,37,303,31,85,36.470588235294116,10,25,40.0,21,60,35.0,42.35294117647059,18,21,85.71428571428571,10,25,35,29,11,0,23,45,90
Marreese Speights,10.0,2009 - 2018,C,705,10640,2181,4750,45.91578947368421,232,651,35.63748079877112,1949,4099,47.54818248353257,48.357894736842105,998,1252,79.71246006389777,947,1928,2875,461,189,356,614,1564,5592
Mike Taylor,1.0,2009 - 2009,PG,51,771,110,267,41.19850187265918,13,40,32.5,97,227,42.731277533039645,43.63295880149813,56,81,69.1358024691358,22,65,87,106,36,0,73,84,289
Jason Thompson,8.0,2009 - 2016,PF,588,14819,2112,4255,49.63572267920094,6,42,14.285714285714285,2106,4213,49.98813197246618,49.70622796709753,980,1492,65.68364611260054,1264,2616,3880,635,283,414,747,1751,5210
Anthony Tolliver,11.0,2009 - 2019,PF,664,13226,1397,3339,41.83887391434561,812,2161,37.57519666820916,585,1178,49.660441426146015,53.99820305480682,628,813,77.24477244772447,508,1744,2252,606,250,202,425,1090,4234
Roko Ukic,2.0,2009 - 2010,PG,85,987,137,354,38.70056497175141,14,74,18.91891891891892,123,280,43.92857142857143,40.67796610169492,53,71,74.64788732394366,27,51,78,165,31,2,66,83,341
Henry Walker,5.0,2009 - 2015,SF,181,3016,386,865,44.6242774566474,190,515,36.89320388349515,196,350,56.00000000000001,55.60693641618497,117,154,75.97402597402598,55,346,401,153,93,27,142,375,1079
Kyle Weaver,3.0,2009 - 2011,SG,73,1379,134,304,44.07894736842105,42,119,35.294117647058826,92,185,49.72972972972973,50.98684210526315,53,72,73.61111111111111,34,124,158,119,55,33,80,97,363
Sonny Weems,4.0,2009 - 2016,SG,183,3335,514,1106,46.473779385171795,34,120,28.333333333333332,480,986,48.6815415821501,48.01084990958409,127,181,70.1657458563536,88,314,402,257,84,28,198,268,1189
Russell Westbrook,11.0,2009 - 2019,PG,821,28330,6626,15253,43.44063462925326,922,2995,30.78464106844741,5704,12258,46.532876488823625,46.462990887038615,4685,5846,80.14026684912761,1371,4389,5760,6897,1442,250,3326,2061,18859
D.J. White,6.0,2009 - 2014,PF,138,2111,348,687,50.65502183406113,1,3,33.33333333333333,347,684,50.73099415204678,50.727802037845706,113,157,71.97452229299363,117,320,437,80,39,57,65,199,810
Jawad Williams,3.0,2009 - 2011,SF,90,1153,127,344,36.91860465116279,45,144,31.25,82,200,41.0,43.4593023255814,41,57,71.9298245614035,24,109,133,56,22,8,35,109,340
Sun Yue,1.0,2009 - 2009,SG,10,28,3,11,27.27272727272727,0,6,0.0,3,5,60.0,27.27272727272727,0,0,,0,0,0,2,1,1,3,10,6
David Andersen,2.0,2010 - 2011,C,103,1264,203,461,44.03470715835141,35,101,34.65346534653465,168,360,46.666666666666664,47.83080260303688,60,89,67.41573033707866,74,218,292,57,20,21,59,159,501
Antonio Anderson,1.0,2010 - 2010,SF,1,15,1,3,33.33333333333333,0,0,,1,3,33.33333333333333,33.33333333333333,0,0,,1,0,1,0,0,0,1,1,2
Jeff Ayres,6.0,2010 - 2016,C,237,2322,287,519,55.29865125240848,2,5,40.0,285,514,55.447470817120625,55.49132947976878,114,147,77.55102040816327,196,436,632,99,37,66,132,360,690
Rodrigue Beaubois,4.0,2010 - 2013,PG,182,2896,502,1143,43.91951006124234,129,397,32.49370277078086,373,746,50.0,49.56255468066492,153,189,80.95238095238095,47,291,338,374,124,52,204,312,1286
DeJuan Blair,7.0,2010 - 2016,PF,424,7054,1242,2371,52.382960776043866,0,9,0.0,1242,2362,52.58255715495343,52.382960776043866,381,627,60.76555023923444,810,1343,2153,349,316,127,471,1003,2865
Jon Brockman,3.0,2010 - 2012,PF,150,1570,118,242,48.760330578512395,0,1,0.0,118,241,48.96265560165975,48.760330578512395,84,136,61.76470588235294,212,260,472,49,33,9,57,267,320
Derrick Brown,3.0,2010 - 2012,SF,171,2554,354,687,51.52838427947598,13,41,31.70731707317073,341,646,52.78637770897833,52.4745269286754,174,273,63.73626373626373,167,246,413,119,89,32,109,208,895
Chase Budinger,7.0,2010 - 2016,SF,407,7998,1188,2766,42.950108459869845,413,1172,35.23890784982935,775,1594,48.6198243412798,50.41576283441793,409,513,79.72709551656921,238,1002,1240,473,213,65,310,485,3198
DeMarre Carroll,10.0,2010 - 2019,SF,554,13385,1781,4138,43.040115998066696,650,1806,35.991140642303435,1131,2332,48.499142367066895,50.89415176413726,851,1146,74.25828970331588,643,1756,2399,701,516,146,481,1095,5063
Omri Casspi,10.0,2010 - 2019,SF,588,11959,1718,3781,45.43771489024068,493,1339,36.8185212845407,1225,2442,50.16380016380017,51.9571541920127,713,1052,67.77566539923954,473,1882,2355,662,362,134,595,917,4642
Earl Clark,6.0,2010 - 2015,PF,261,3630,453,1125,40.266666666666666,82,250,32.800000000000004,371,875,42.4,43.91111111111111,150,226,66.3716814159292,195,583,778,134,83,136,175,323,1138
Darren Collison,10.0,2010 - 2019,PG,708,20796,3270,6937,47.13853250684734,635,1610,39.44099378881988,2635,5327,49.464989675239345,51.71543895055499,1682,1973,85.25088697415104,332,1553,1885,3543,819,106,1382,1207,8857
Dante Cunningham,10.0,2010 - 2019,PF,715,14875,1772,3777,46.91554143500132,216,626,34.504792332268366,1556,3151,49.381148841637575,49.774953666931424,373,575,64.8695652173913,804,1872,2676,506,459,336,352,1227,4133
JamesOn Curry,1.0,2010 - 2010,PG,1,0,0,0,,0,0,,0,0,,,0,0,,0,0,0,0,0,0,0,0,0
Stephen Curry,10.0,2010 - 2019,PG,694,23859,5649,11849,47.67490927504431,2483,5690,43.63796133567663,3166,6159,51.404448774151646,58.152586716178575,2534,2801,90.46769011067475,486,2646,3132,4588,1200,154,2163,1721,16315
Austin Daye,6.0,2010 - 2015,SF,293,4132,567,1410,40.21276595744681,188,535,35.14018691588785,379,875,43.31428571428572,46.87943262411348,200,257,77.82101167315176,143,621,764,212,116,117,204,480,1522
DeMar DeRozan,10.0,2010 - 2019,SG,752,25674,5347,11845,45.14140987758548,332,1173,28.303495311167946,5015,10672,46.992128935532236,46.542845082313214,3905,4718,82.7681220856295,568,2633,3201,2553,741,221,1522,1676,14931
Toney Douglas,8.0,2010 - 2017,PG,394,7511,1093,2705,40.406654343807766,444,1256,35.35031847133758,649,1449,44.78951000690131,48.613678373382626,379,460,82.3913043478261,213,662,875,889,349,30,410,775,3009
Wayne Ellington,10.0,2010 - 2019,SG,645,13720,1925,4692,41.027280477408354,966,2546,37.941869599371564,959,2146,44.68779123951538,51.32139812446718,462,546,84.61538461538461,212,1204,1416,711,358,48,438,742,5278
Tyreke Evans,10.0,2010 - 2019,SG,594,18242,3510,7978,43.995988969666584,500,1548,32.299741602067186,3010,6430,46.81181959564541,47.12960641764853,1827,2415,75.65217391304347,500,2220,2720,2852,734,222,1489,1308,9347
Jonny Flynn,3.0,2010 - 2012,PG,163,3738,551,1379,39.95649021029732,118,349,33.810888252149,433,1030,42.03883495145631,44.23495286439449,284,351,80.91168091168092,44,263,307,634,122,7,382,179,1504
Sundiata Gaines,3.0,2010 - 2012,PG,113,1311,182,458,39.737991266375545,44,146,30.136986301369863,138,312,44.230769230769226,44.54148471615721,100,178,56.17977528089888,46,129,175,207,83,3,93,100,508
Alonzo Gee,8.0,2010 - 2017,SF,417,9071,1001,2309,43.35210047639671,186,572,32.51748251748251,815,1737,46.91997697179045,47.379818103074925,566,751,75.36617842876166,389,971,1360,441,379,101,447,792,2754
Taj Gibson,10.0,2010 - 2019,PF,737,19069,2999,5861,51.16874253540351,22,104,21.153846153846153,2977,5757,51.71096056974118,51.35642381846102,1219,1720,70.87209302325581,1740,2991,4731,760,423,808,893,1898,7239
Trey Gilder,1.0,2010 - 2010,SF,2,5,1,1,100.0,0,0,,1,1,100.0,100.0,0,0,,0,1,1,0,1,0,0,0,2
Danny Green,10.0,2010 - 2019,SG,620,15769,1977,4658,42.44310863031344,1163,2878,40.410006949270326,814,1780,45.73033707865169,54.92700729927007,459,562,81.67259786476868,360,1809,2169,997,609,506,640,1071,5576
Taylor Griffin,1.0,2010 - 2010,SF,8,32,4,10,40.0,0,2,0.0,4,8,50.0,40.0,2,4,50.0,0,2,2,1,0,2,1,4,10
Tyler Hansbrough,7.0,2010 - 2016,PF,428,7233,947,2156,43.9239332096475,3,22,13.636363636363635,944,2134,44.236176194939084,43.993506493506494,984,1333,73.81845461365342,745,1063,1808,181,207,91,319,869,2881
James Harden,10.0,2010 - 2019,SG,765,26106,5499,12411,44.307469180565626,2025,5551,36.47991352909386,3474,6860,50.641399416909614,52.46555474981871,5604,6536,85.7405140758874,582,3418,4000,4743,1189,383,2770,1977,18627
Gerald Henderson,8.0,2010 - 2017,SG,535,13854,2249,5111,44.00313050283702,249,762,32.677165354330704,2000,4349,45.98758335249482,46.439053022891805,1240,1564,79.28388746803068,314,1402,1716,1009,358,183,639,930,5987
Jordan Hill,8.0,2010 - 2017,C,409,7692,1357,2733,49.652396633735826,3,22,13.636363636363635,1354,2711,49.944669863518996,49.707281375777534,515,737,69.87788331071914,879,1510,2389,322,150,272,426,875,3232
Jrue Holiday,10.0,2010 - 2019,PG,652,21586,4009,8860,45.24830699774267,805,2270,35.46255506607929,3204,6590,48.61911987860395,49.79119638826185,1325,1689,78.44878626406158,540,1959,2499,4151,964,316,1781,1495,10148
Lester Hudson,4.0,2010 - 2015,PG,57,594,95,253,37.54940711462451,28,101,27.722772277227726,67,152,44.07894736842105,43.08300395256917,50,62,80.64516129032258,16,61,77,71,32,8,56,52,268
Chris Hunter,1.0,2010 - 2010,C,60,783,109,217,50.23041474654379,0,4,0.0,109,213,51.173708920187785,50.23041474654379,52,69,75.36231884057972,56,111,167,37,13,35,30,132,270
Serge Ibaka,10.0,2010 - 2019,PF,753,21624,3872,7531,51.41415482671624,462,1295,35.67567567567568,3410,6236,54.68248877485568,54.48147656353738,1092,1435,76.09756097560975,1630,3862,5492,545,323,1626,980,2126,9298
Cedric Jackson,1.0,2010 - 2010,PG,12,74,6,20,30.0,1,6,16.666666666666664,5,14,35.714285714285715,32.5,7,12,58.333333333333336,2,6,8,14,3,2,11,7,20
Othyus Jeffers,3.0,2010 - 2014,SG,37,442,46,100,46.0,1,6,16.666666666666664,45,94,47.87234042553192,46.5,46,69,66.66666666666666,34,61,95,22,21,0,21,45,139
Brandon Jennings,9.0,2010 - 2018,PG,555,16844,2750,7099,38.737850401464996,914,2648,34.516616314199396,1836,4451,41.24915749269827,45.17537681363572,1387,1743,79.5754446356856,329,1330,1659,3151,679,98,1203,996,7801
Jonas Jerebko,9.0,2010 - 2019,PF,635,11323,1465,3203,45.738370277864504,400,1101,36.330608537693,1065,2102,50.66603235014272,51.982516390883546,589,765,76.99346405228759,763,1759,2522,525,321,153,438,1225,3919
James Johnson,10.0,2010 - 2019,PF,602,12462,1889,3962,47.677940434124174,291,955,30.471204188481675,1598,3007,53.14266711007649,51.35032811711257,716,1030,69.51456310679612,492,1674,2166,1281,472,538,880,1341,4785
Oliver Lafayette,1.0,2010 - 2010,SG,1,22,3,6,50.0,1,2,50.0,2,4,50.0,58.333333333333336,0,0,,1,3,4,2,0,0,1,0,7
Marcus Landry,1.0,2010 - 2010,SF,18,111,16,43,37.2093023255814,9,28,32.142857142857146,7,15,46.666666666666664,47.674418604651166,3,5,60.0,5,14,19,0,1,2,6,14,44
Ty Lawson,8.0,2010 - 2017,PG,551,16088,2496,5424,46.017699115044245,473,1319,35.860500379075056,2023,4105,49.28136419001218,50.37794985250738,1512,1964,76.9857433808554,351,1155,1506,3316,636,52,1159,898,6977
Wesley Matthews,10.0,2010 - 2019,SG,724,23579,3387,7972,42.4862017059709,1555,4070,38.20638820638821,1832,3902,46.9502819067145,52.23908680381335,1570,1901,82.5881115202525,383,1857,2240,1604,790,146,958,1615,9899
Eric Maynor,5.0,2010 - 2014,PG,267,3896,440,1122,39.21568627450981,111,317,35.01577287066246,329,805,40.869565217391305,44.16221033868093,150,208,72.11538461538461,67,281,348,760,111,20,281,296,1141
Jodie Meeks,10.0,2010 - 2019,SG,539,12110,1665,3969,41.950113378684804,775,2078,37.29547641963427,890,1891,47.06504494976203,51.7132779037541,883,1004,87.94820717131473,148,972,1120,583,413,36,410,632,4988
Patty Mills,10.0,2010 - 2019,PG,605,11497,1853,4303,43.06297931675575,905,2316,39.07599309153713,948,1987,47.710115752390536,53.57889844294677,483,569,84.88576449912127,189,821,1010,1431,387,47,605,778,5094
Byron Mullens,5.0,2010 - 2014,PF,189,3446,557,1366,40.77598828696926,111,348,31.896551724137932,446,1018,43.811394891944985,44.8389458272328,173,245,70.61224489795919,200,590,790,153,74,98,187,335,1398
A.J. Price,6.0,2010 - 2015,PG,261,3929,549,1444,38.01939058171745,218,690,31.594202898550726,331,754,43.89920424403183,45.56786703601108,207,279,74.19354838709677,68,309,377,567,125,9,229,237,1523
DaJuan Summers,4.0,2010 - 2013,SF,83,820,103,268,38.43283582089552,29,79,36.708860759493675,74,189,39.15343915343915,43.843283582089555,43,67,64.17910447761194,24,58,82,29,18,8,37,104,278
Jermaine Taylor,2.0,2010 - 2011,SG,65,786,139,315,44.12698412698413,19,67,28.35820895522388,120,248,48.38709677419355,47.14285714285714,54,74,72.97297297297297,47,61,108,48,24,8,65,54,351
Jeff Teague,10.0,2010 - 2019,PG,712,19750,3212,7211,44.54305921508806,629,1769,35.5568117580554,2583,5442,47.464167585446525,48.90445153238108,1996,2371,84.18388865457614,232,1527,1759,4145,858,246,1623,1380,9049
Garrett Temple,9.0,2010 - 2019,SG,514,10427,1079,2644,40.809379727685325,438,1240,35.32258064516129,641,1404,45.655270655270655,49.09228441754917,422,579,72.88428324697755,199,900,1099,834,437,152,478,983,3018
Hasheem Thabeet,5.0,2010 - 2014,C,224,2357,182,321,56.69781931464174,0,0,,182,321,56.69781931464174,56.69781931464174,119,206,57.76699029126213,203,392,595,27,59,184,123,453,483
Marcus Thornton,8.0,2010 - 2017,SG,483,11299,2124,5003,42.45452728362982,735,2051,35.83617747440273,1389,2952,47.052845528455286,49.80011992804317,767,924,83.008658008658,407,941,1348,677,405,61,491,739,5750
Reggie Williams,7.0,2010 - 2017,SF,206,3736,599,1313,45.62071591774562,199,545,36.51376146788991,400,768,52.083333333333336,53.198781416603204,201,268,75.0,105,388,493,301,88,13,142,241,1598
Terrence Williams,4.0,2010 - 2013,SF,153,2922,437,1061,41.1875589066918,58,183,31.693989071038253,379,878,43.16628701594533,43.92082940622055,153,232,65.94827586206897,67,478,545,364,83,19,222,199,1085
Sam Young,4.0,2010 - 2013,SF,249,3966,560,1266,44.23380726698262,49,175,28.000000000000004,511,1091,46.83776351970669,46.16903633491311,267,360,74.16666666666667,163,410,573,180,134,57,204,311,1436
Jeff Adrien,5.0,2011 - 2015,PF,153,2148,264,557,47.3967684021544,0,2,0.0,264,555,47.56756756756757,47.3967684021544,181,288,62.84722222222222,221,438,659,100,50,79,91,259,709
Solomon Alabi,2.0,2011 - 2012,C,26,181,16,51,31.372549019607842,0,0,,16,51,31.372549019607842,31.372549019607842,7,10,70.0,22,39,61,5,4,11,8,16,39
Cole Aldrich,8.0,2011 - 2018,C,339,3389,435,825,52.72727272727272,0,0,,435,825,52.72727272727272,52.72727272727272,180,244,73.77049180327869,334,797,1131,183,137,233,199,509,1050
Al-Farouq Aminu,9.0,2011 - 2019,SF,670,16884,1885,4456,42.30251346499102,526,1561,33.696348494554776,1359,2895,46.943005181347154,48.204667863554754,874,1170,74.7008547008547,936,3147,4083,827,641,380,818,1246,5170
James Anderson,5.0,2011 - 2016,SG,247,4320,525,1276,41.14420062695925,196,611,32.0785597381342,329,665,49.473684210526315,48.82445141065831,176,233,75.53648068669528,108,452,560,291,121,55,216,292,1422
Omer Asik,8.0,2011 - 2018,C,471,9216,947,1795,52.757660167130915,0,1,0.0,947,1794,52.787068004459314,52.757660167130915,585,1062,55.08474576271186,1036,2326,3362,280,167,339,542,928,2479
Luke Babbitt,8.0,2011 - 2018,SF,381,5332,650,1593,40.80351537978657,394,979,40.24514811031665,256,614,41.69381107491857,53.17011927181419,124,166,74.69879518072288,111,735,846,224,89,58,165,520,1818
Eric Bledsoe,9.0,2011 - 2019,PG,570,15903,2851,6268,45.48500319081047,608,1812,33.554083885209714,2243,4456,50.33662477558348,50.33503509891513,1724,2172,79.37384898710866,470,1759,2229,2724,847,275,1510,1168,8034
Trevor Booker,8.0,2011 - 2018,PF,532,10872,1548,3003,51.548451548451546,75,246,30.48780487804878,1473,2757,53.42763873775843,52.7972027972028,508,799,63.57947434292866,1029,1903,2932,566,355,277,540,1063,3679
Craig Brackins,2.0,2011 - 2012,PF,17,121,13,49,26.53061224489796,3,14,21.428571428571427,10,35,28.57142857142857,29.591836734693878,1,2,50.0,7,12,19,9,1,1,4,9,30
Avery Bradley,9.0,2011 - 2019,SG,522,14957,2532,5811,43.572534847702634,681,1869,36.43659711075441,1851,3942,46.9558599695586,49.432111512648426,544,699,77.82546494992847,340,1215,1555,949,538,111,755,1144,6289
Derrick Caracter,1.0,2011 - 2011,C,41,215,32,66,48.484848484848484,0,0,,32,66,48.484848484848484,48.484848484848484,17,23,73.91304347826086,19,24,43,7,4,10,19,47,81
Sherron Collins,1.0,2011 - 2011,PG,20,66,7,25,28.000000000000004,2,10,20.0,5,15,33.33333333333333,32.0,1,1,100.0,0,5,5,8,2,0,4,2,17
Marcus Cousin,1.0,2011 - 2011,C,4,18,2,3,66.66666666666666,0,0,,2,3,66.66666666666666,66.66666666666666,0,0,,0,3,3,0,0,1,1,1,4
DeMarcus Cousins,9.0,2011 - 2019,C,565,18078,4283,9295,46.078536847767616,342,1031,33.17167798254122,3941,8264,47.688770571151984,47.918235610543306,3098,4205,73.67419738406659,1565,4566,6131,1832,805,697,2000,2175,12006
Jordan Crawford,6.0,2011 - 2018,SG,281,6843,1286,3130,41.08626198083067,330,1041,31.70028818443804,956,2089,45.76352321685017,46.35782747603834,530,642,82.55451713395638,153,550,703,883,196,23,529,437,3432
Ed Davis,9.0,2011 - 2019,PF,640,12953,1721,3022,56.94904037061549,0,4,0.0,1721,3018,57.024519549370446,56.94904037061549,722,1237,58.36701697655619,1495,2837,4332,499,322,535,507,1599,4164
Zabian Dowdell,1.0,2011 - 2011,PG,24,292,51,125,40.8,3,10,30.0,48,115,41.73913043478261,42.0,16,17,94.11764705882352,5,15,20,51,20,2,29,30,121
Devin Ebanks,3.0,2011 - 2013,SG,63,711,82,213,38.497652582159624,8,36,22.22222222222222,74,177,41.80790960451977,40.375586854460096,52,72,72.22222222222221,51,71,122,24,18,12,35,56,224
Semih Erden,2.0,2011 - 2012,C,69,928,101,185,54.59459459459459,0,0,,101,185,54.59459459459459,54.59459459459459,60,101,59.4059405940594,57,133,190,29,25,29,50,164,262
Jeremy Evans,7.0,2011 - 2018,SF,250,2626,364,640,56.875,6,26,23.076923076923077,358,614,58.306188925081436,57.34375000000001,145,211,68.72037914691943,239,402,641,107,90,121,85,291,879
Christian Eyenga,2.0,2011 - 2012,SF,51,1049,136,331,41.08761329305136,26,94,27.659574468085108,110,237,46.41350210970464,45.01510574018127,22,36,61.111111111111114,31,106,137,40,37,33,50,85,320
Derrick Favors,9.0,2011 - 2019,PF,632,16267,2962,5643,52.48981038454723,35,167,20.958083832335326,2927,5476,53.45142439737034,52.79992911571859,1361,2049,66.42264519277697,1574,2973,4547,701,498,813,895,1664,7320
Landry Fields,5.0,2011 - 2015,SF,255,6010,684,1446,47.30290456431535,120,361,33.2409972299169,564,1085,51.98156682027649,51.45228215767634,243,365,66.57534246575342,248,844,1092,419,212,45,270,310,1731
Gary Forbes,2.0,2011 - 2012,SF,111,1504,236,544,43.38235294117647,48,141,34.04255319148936,188,403,46.65012406947891,47.794117647058826,125,178,70.2247191011236,55,163,218,103,47,10,100,133,645
Paul George,9.0,2011 - 2019,SF,604,20424,4058,9372,43.29918907383696,1433,3791,37.800052756528615,2625,5581,47.03458161619781,50.944302176696546,2434,2885,84.36741767764299,563,3328,3891,2000,1071,267,1558,1637,11983
Blake Griffin,9.0,2011 - 2019,PF,604,21159,4961,9884,50.19222986645083,380,1112,34.172661870503596,4581,8772,52.22298221614226,52.11452853095913,2898,4185,69.24731182795699,1328,4089,5417,2690,547,314,1577,1750,13200
Luke Harangody,2.0,2011 - 2012,PF,70,871,102,271,37.63837638376384,21,87,24.137931034482758,81,184,44.02173913043478,41.51291512915129,28,38,73.68421052631578,60,136,196,36,21,20,20,97,253
Manny Harris,4.0,2011 - 2017,SG,93,1594,199,524,37.97709923664122,53,150,35.333333333333336,146,374,39.037433155080215,43.034351145038165,124,168,73.80952380952381,57,196,253,129,48,14,101,104,575
Gordon Hayward,9.0,2011 - 2019,SF,589,18032,3018,6766,44.60537984037836,766,2105,36.3895486935867,2252,4661,48.31581205749839,50.266036062666274,2102,2559,82.14146150840172,428,2044,2472,2006,589,238,1164,1028,8904
Lazar Hayward,3.0,2011 - 2013,SF,72,591,70,202,34.65346534653465,21,78,26.923076923076923,49,124,39.516129032258064,39.851485148514854,46,60,76.66666666666667,25,65,90,35,17,8,28,65,207
Xavier Henry,5.0,2011 - 2015,SF,185,2905,368,907,40.57331863285557,41,126,32.53968253968254,327,781,41.86939820742638,42.8335170893054,273,430,63.48837209302326,81,270,351,120,100,23,139,264,1050
Damion James,4.0,2011 - 2014,SF,39,623,61,147,41.49659863945578,0,6,0.0,61,141,43.262411347517734,41.49659863945578,28,42,66.66666666666666,25,106,131,26,23,20,38,56,150
Eugene Jeter,1.0,2011 - 2011,PG,62,858,106,259,40.92664092664093,6,30,20.0,100,229,43.66812227074236,42.084942084942085,37,41,90.2439024390244,9,61,70,162,29,2,51,54,255
Armon Johnson,2.0,2011 - 2012,PG,47,401,66,144,45.83333333333333,6,15,40.0,60,129,46.51162790697674,47.91666666666667,19,28,67.85714285714286,12,37,49,56,10,1,44,40,157
Chris Johnson,6.0,2011 - 2016,C,210,2769,296,699,42.34620886981402,98,321,30.529595015576323,198,378,52.38095238095239,49.35622317596567,136,174,78.16091954022988,113,303,416,104,101,77,115,310,826
Wesley Johnson,9.0,2011 - 2019,SF,609,13472,1629,4028,40.44190665342602,614,1823,33.68074602303895,1015,2205,46.03174603174603,48.0635551142006,363,490,74.08163265306122,337,1587,1924,645,468,402,525,1168,4235
Dominique Jones,3.0,2011 - 2013,SG,80,741,83,227,36.56387665198238,2,21,9.523809523809524,81,206,39.32038834951456,37.00440528634361,78,107,72.89719626168224,33,81,114,144,29,10,76,64,246
Gani Lawal,1.0,2011 - 2011,PF,1,2,0,0,,0,0,,0,0,,,0,0,,0,0,0,0,0,0,0,1,0
Jeremy Lin,9.0,2011 - 2019,PG,480,12218,1885,4349,43.343297309726374,449,1313,34.1964965727342,1436,3036,47.299077733860344,48.50540354104392,1348,1666,80.91236494597838,197,1141,1338,2042,519,175,1085,1060,5567
Greg Monroe,9.0,2011 - 2019,C,632,17475,3339,6499,51.37713494383751,1,17,5.88235294117647,3338,6482,51.496451712434435,51.38482843514387,1647,2338,70.44482463644141,1769,3460,5229,1354,672,363,1186,1411,8326
Timofey Mozgov,8.0,2011 - 2018,C,454,8181,1230,2301,53.45501955671447,11,58,18.96551724137931,1219,2243,54.3468568880963,53.69404606692743,601,814,73.83292383292384,769,1456,2225,250,139,383,527,998,3072
Hamady N'Diaye,3.0,2011 - 2014,C,33,157,7,15,46.666666666666664,0,0,,7,15,46.666666666666664,46.666666666666664,6,13,46.15384615384615,7,18,25,3,2,9,6,33,20
Gary Neal,7.0,2011 - 2017,SG,352,7507,1275,3021,42.20456802383317,460,1203,38.23773898586866,815,1818,44.82948294829483,49.81794107911288,460,541,85.02772643253235,81,679,760,573,145,10,365,525,3470
Larry Owens,2.0,2011 - 2012,SF,19,218,19,43,44.18604651162791,8,18,44.44444444444444,11,25,44.0,53.48837209302325,7,13,53.84615384615385,3,25,28,12,9,6,7,28,53
Patrick Patterson,9.0,2011 - 2019,PF,622,13565,1704,3787,44.996039081066804,523,1425,36.70175438596491,1181,2362,50.0,51.901241087932405,362,483,74.94824016563147,768,1805,2573,666,347,285,418,1017,4293
Nikola Pekovic,6.0,2011 - 2016,C,271,6744,1314,2537,51.793456838785964,0,0,,1314,2537,51.793456838785964,51.793456838785964,777,1023,75.95307917888563,803,1004,1807,199,140,151,414,632,3405
Dexter Pittman,4.0,2011 - 2014,C,50,347,49,109,44.95412844036697,0,0,,49,109,44.95412844036697,44.95412844036697,18,33,54.54545454545454,38,51,89,9,8,8,22,83,116
Quincy Pondexter,7.0,2011 - 2019,SF,355,5530,571,1351,42.26498889711325,211,593,35.58178752107926,360,758,47.4934036939314,50.0740192450037,256,343,74.63556851311954,200,440,640,263,122,49,178,464,1609
Andy Rautins,1.0,2011 - 2011,SG,5,24,3,7,42.857142857142854,1,4,25.0,2,3,66.66666666666666,50.0,1,2,50.0,0,1,1,3,1,0,7,0,8
Samardo Samuels,3.0,2011 - 2013,C,109,1722,237,532,44.54887218045113,0,4,0.0,237,528,44.88636363636363,44.54887218045113,164,251,65.33864541832669,148,218,366,45,38,41,115,231,638
Larry Sanders,6.0,2011 - 2017,C,238,4635,669,1395,47.956989247311824,0,5,0.0,669,1390,48.1294964028777,47.956989247311824,182,329,55.319148936170215,475,870,1345,174,152,429,224,666,1520
Kevin Seraphin,7.0,2011 - 2017,C,423,6430,1134,2318,48.921484037963765,0,7,0.0,1134,2311,49.06966681090437,48.921484037963765,248,347,71.46974063400576,502,960,1462,246,88,304,449,903,2516
Mustafa Shakur,2.0,2011 - 2014,PG,25,170,21,62,33.87096774193548,1,11,9.090909090909092,20,51,39.21568627450981,34.67741935483871,9,17,52.94117647058824,7,15,22,29,5,3,20,17,52
Garret Siler,1.0,2011 - 2011,C,21,101,17,31,54.83870967741935,0,0,,17,31,54.83870967741935,54.83870967741935,11,22,50.0,16,12,28,3,1,4,10,20,45
Ish Smith,9.0,2011 - 2019,PG,542,10518,1712,4009,42.703916188575704,196,640,30.625000000000004,1516,3369,44.99851588008311,45.148416063856324,400,590,67.79661016949152,186,1095,1281,2049,380,120,683,703,4020
Tiago Splitter,7.0,2011 - 2017,C,355,6812,1073,1932,55.53830227743271,2,14,14.285714285714285,1071,1918,55.839416058394164,55.590062111801245,668,958,69.72860125260961,576,1203,1779,423,198,209,384,685,2816
Lance Stephenson,9.0,2011 - 2019,SG,508,11866,1738,3917,44.37069185601226,346,1099,31.48316651501365,1392,2818,49.396735273243436,48.787337247893795,532,777,68.46846846846847,332,1792,2124,1456,333,72,836,990,4354
Pape Sy,1.0,2011 - 2011,SF,3,21,2,6,33.33333333333333,0,1,0.0,2,5,40.0,33.33333333333333,3,3,100.0,2,1,3,2,1,0,3,1,7
Evan Turner,9.0,2011 - 2019,SF,686,18687,2723,6264,43.470625798212005,270,912,29.605263157894733,2453,5352,45.83333333333333,45.62579821200511,1046,1339,78.11799850634802,380,2860,3240,2424,523,176,1241,1360,6762
Ekpe Udoh,7.0,2011 - 2019,C,384,5694,519,1145,45.327510917030565,0,4,0.0,519,1141,45.48641542506573,45.327510917030565,315,439,71.75398633257403,456,644,1100,260,177,429,222,714,1353
Ben Uzoh,2.0,2011 - 2012,PG,60,808,96,243,39.50617283950617,3,9,33.33333333333333,93,234,39.743589743589745,40.123456790123456,44,75,58.666666666666664,49,79,128,130,30,11,44,60,239
Greivis Vasquez,7.0,2011 - 2017,PG,401,9520,1378,3297,41.79557173187746,412,1180,34.91525423728813,966,2117,45.63060935285782,48.043676069153776,423,518,81.66023166023166,125,896,1021,1935,236,34,753,767,3591
John Wall,9.0,2011 - 2019,PG,573,20545,3942,9107,43.28538486878226,539,1663,32.411304870715576,3403,7444,45.714669532509404,46.24464697485451,2456,3144,78.11704834605598,330,2153,2483,5282,976,396,2191,1289,10879
Willie Warren,1.0,2011 - 2011,PG,19,134,13,35,37.142857142857146,5,15,33.33333333333333,8,20,40.0,44.285714285714285,6,8,75.0,1,11,12,27,6,0,8,16,37
Hassan Whiteside,7.0,2011 - 2019,C,343,8929,1910,3327,57.40907724676886,4,18,22.22222222222222,1906,3309,57.6004835297673,57.469191463781186,759,1280,59.29687500000001,1123,2786,3909,203,214,798,543,893,4583
Lavoy Allen,6.0,2012 - 2017,PF,388,6905,828,1758,47.098976109215016,2,15,13.333333333333334,826,1743,47.389558232931726,47.15585893060295,189,277,68.23104693140795,715,1128,1843,384,120,214,257,706,1847
Gustavo Ayon,3.0,2012 - 2014,C,135,2251,284,530,53.58490566037736,0,1,0.0,284,529,53.68620037807184,53.58490566037736,67,133,50.37593984962406,188,401,589,173,100,73,122,272,635
Keith Benson,1.0,2012 - 2012,C,3,9,0,1,0.0,0,0,,0,1,0.0,0.0,0,0,,2,1,3,0,0,0,0,0,0
Bismack Biyombo,8.0,2012 - 2019,C,583,11835,1081,2089,51.7472474868358,0,2,0.0,1081,2087,51.79683756588405,51.7472474868358,718,1257,57.12012728719172,1135,2525,3660,288,149,803,529,1292,2880
MarShon Brooks,5.0,2012 - 2019,SG,200,3456,613,1371,44.711889132020424,109,316,34.49367088607595,504,1055,47.77251184834123,48.6870897155361,257,342,75.14619883040936,132,292,424,282,120,42,248,269,1592
Alec Burks,8.0,2012 - 2019,SG,429,9052,1415,3346,42.28930065750149,289,813,35.54735547355474,1126,2533,44.45321752862218,46.60789001793186,970,1258,77.10651828298887,254,1050,1304,729,260,75,537,739,4089
Jimmy Butler,8.0,2012 - 2019,SG,523,17229,2862,6308,45.370957514267594,475,1395,34.05017921146953,2387,4913,48.585385711377974,49.13601775523146,2531,3031,83.5037941273507,768,1809,2577,1805,822,246,765,756,8730
Derrick Byars,1.0,2012 - 2012,PF,2,37,3,11,27.27272727272727,0,6,0.0,3,5,60.0,27.27272727272727,4,4,100.0,6,5,11,1,2,0,0,2,10
Norris Cole,6.0,2012 - 2017,PG,360,8018,1005,2469,40.704738760631834,207,639,32.3943661971831,798,1830,43.606557377049185,44.89671931956258,289,389,74.293059125964,79,623,702,981,280,34,517,679,2506
Eric Dawson,1.0,2012 - 2012,C,4,39,7,12,58.333333333333336,0,0,,7,12,58.333333333333336,58.333333333333336,1,2,50.0,5,5,10,0,1,2,3,6,15
Justin Dentmon,2.0,2012 - 2013,PG,8,95,10,30,33.33333333333333,2,14,14.285714285714285,8,16,50.0,36.666666666666664,4,6,66.66666666666666,0,8,8,10,2,0,7,10,26
Jerome Dyson,1.0,2012 - 2012,PG,9,180,19,48,39.58333333333333,1,8,12.5,18,40,45.0,40.625,28,36,77.77777777777779,2,17,19,18,11,2,20,19,67
Kenneth Faried,8.0,2012 - 2019,PF,478,11728,2190,4009,54.627089049638315,10,45,22.22222222222222,2180,3964,54.9949545913219,54.75180843103018,1040,1590,65.40880503144653,1465,2419,3884,470,351,392,626,1180,5430
Jeff Foote,1.0,2012 - 2012,C,4,39,2,6,33.33333333333333,0,0,,2,6,33.33333333333333,33.33333333333333,0,0,,1,5,6,0,0,1,2,5,4
Courtney Fortson,1.0,2012 - 2012,PG,10,95,11,32,34.375,3,13,23.076923076923077,8,19,42.10526315789473,39.0625,10,15,66.66666666666666,6,9,15,10,3,0,10,5,35
Jimmer Fredette,6.0,2012 - 2019,SG,241,3213,524,1282,40.87363494539781,193,519,37.1868978805395,331,763,43.381389252948885,48.4009360374415,197,224,87.94642857142857,53,190,243,331,94,11,223,222,1438
Mickell Gladness,1.0,2012 - 2012,PF,26,252,25,59,42.3728813559322,0,0,,25,59,42.3728813559322,42.3728813559322,6,12,50.0,14,44,58,5,4,20,7,32,56
Andrew Goudelock,3.0,2012 - 2016,SG,49,475,77,196,39.285714285714285,29,84,34.523809523809526,48,112,42.857142857142854,46.683673469387756,14,16,87.5,7,27,34,24,10,2,28,36,197
Jordan Hamilton,5.0,2012 - 2016,SF,151,2100,342,839,40.76281287246722,137,384,35.67708333333333,205,455,45.05494505494506,48.92729439809297,69,103,66.99029126213593,89,340,429,127,73,34,102,144,890
Justin Harper,3.0,2012 - 2017,PF,22,150,18,53,33.9622641509434,8,29,27.586206896551722,10,24,41.66666666666667,41.509433962264154,1,3,33.33333333333333,5,13,18,4,3,3,12,10,45
Josh Harrellson,3.0,2012 - 2014,C,75,888,105,240,43.75,33,95,34.73684210526316,72,145,49.6551724137931,50.625,22,35,62.857142857142854,80,147,227,26,30,36,33,96,265
Terrel Harris,2.0,2012 - 2013,SG,42,455,33,110,30.0,8,47,17.02127659574468,25,63,39.682539682539684,33.63636363636363,21,31,67.74193548387096,22,55,77,35,11,5,42,51,95
Tobias Harris,8.0,2012 - 2019,PF,546,16592,3187,6773,47.054481027609626,687,1887,36.40699523052464,2500,4886,51.1665984445354,52.12608888232688,1374,1672,82.17703349282297,550,2700,3250,1029,402,262,750,1076,8435
Cory Higgins,2.0,2012 - 2013,SG,44,455,58,179,32.402234636871505,5,25,20.0,53,154,34.41558441558442,33.798882681564244,43,62,69.35483870967742,8,30,38,41,8,6,39,45,164
Darington Hobson,1.0,2012 - 2012,SG,5,39,2,13,15.384615384615385,0,6,0.0,2,7,28.57142857142857,15.384615384615385,0,0,,0,3,3,6,0,0,2,1,4
Tyler Honeycutt,2.0,2012 - 2013,SF,24,120,11,35,31.428571428571427,1,5,20.0,10,30,33.33333333333333,32.857142857142854,5,7,71.42857142857143,6,18,24,9,4,4,7,5,28
Dennis Horner,1.0,2012 - 2012,PF,8,22,1,4,25.0,0,1,0.0,1,3,33.33333333333333,25.0,3,4,75.0,2,3,5,0,0,0,1,1,5
Kyrie Irving,8.0,2012 - 2019,PG,508,17169,4147,8916,46.511888739345,1063,2728,38.96627565982405,3084,6188,49.83839689722043,52.47308209959623,1937,2214,87.48870822041553,385,1467,1852,2884,672,177,1343,1118,11294
Reggie Jackson,8.0,2012 - 2019,PG,530,13377,2546,5941,42.85473825955226,602,1810,33.25966850828729,1944,4131,47.05882352941176,47.921225382932164,1141,1329,85.85402558314522,287,1280,1567,2330,377,61,1027,1035,6835
Charles Jenkins,2.0,2012 - 2013,SG-PG,110,1334,179,412,43.44660194174757,4,22,18.181818181818183,175,390,44.871794871794876,43.932038834951456,46,61,75.40983606557377,16,84,100,214,48,8,81,107,408
Carldell Johnson,1.0,2012 - 2012,PG,15,119,11,35,31.428571428571427,4,15,26.666666666666668,7,20,35.0,37.142857142857146,1,3,33.33333333333333,1,8,9,22,8,0,7,11,27
Ivan Johnson,2.0,2012 - 2013,PF,125,1969,326,631,51.66402535657686,3,19,15.789473684210526,323,612,52.77777777777778,51.901743264659274,153,231,66.23376623376623,141,351,492,78,99,32,140,247,808
JaJuan Johnson,1.0,2012 - 2012,PF,36,298,54,121,44.62809917355372,0,0,,54,121,44.62809917355372,44.62809917355372,6,9,66.66666666666666,20,38,58,6,5,14,14,25,114
Jerome Jordan,2.0,2012 - 2015,C,65,491,67,127,52.75590551181102,0,0,,67,127,52.75590551181102,52.75590551181102,46,54,85.18518518518519,66,66,132,17,9,21,24,73,180
Cory Joseph,8.0,2012 - 2019,PG,528,11356,1444,3254,44.37615242778119,237,724,32.73480662983425,1207,2530,47.70750988142293,48.01782421634911,540,710,76.05633802816901,261,1102,1363,1485,406,111,520,773,3665
Enes Kanter,8.0,2012 - 2019,C,583,12949,2837,5248,54.05868902439024,42,143,29.37062937062937,2795,5105,54.750244857982366,54.45884146341463,1230,1577,77.99619530754597,1715,2721,4436,490,236,260,922,1296,6946
D.J. Kennedy,1.0,2012 - 2012,SF,2,59,5,12,41.66666666666667,2,4,50.0,3,8,37.5,50.0,0,2,0.0,1,6,7,3,2,0,3,7,12
Brandon Knight,7.0,2012 - 2019,PG,421,12675,2191,5307,41.28509515733936,666,1881,35.406698564593306,1525,3426,44.512551079976646,47.55982664405502,1038,1279,81.15715402658327,232,1104,1336,1700,375,72,1048,844,6086
Malcolm Lee,3.0,2012 - 2015,SG,36,534,52,136,38.23529411764706,10,34,29.411764705882355,42,102,41.17647058823529,41.911764705882355,26,37,70.27027027027027,24,41,65,51,20,10,27,52,140
Kawhi Leonard,8.0,2012 - 2019,SF,467,14404,2989,6039,49.494949494949495,641,1672,38.33732057416268,2348,4367,53.76688802381497,54.80211955621792,1631,1923,84.81539261570464,587,2363,2950,1123,829,313,679,793,8250
Travis Leslie,1.0,2012 - 2012,SG,10,45,5,14,35.714285714285715,0,0,,5,14,35.714285714285715,35.714285714285715,4,9,44.44444444444444,6,3,9,5,2,2,2,4,14
Jon Leuer,8.0,2012 - 2019,PF,377,5945,979,2023,48.39347503707365,125,381,32.808398950131235,854,1642,52.00974421437271,51.482946119624316,312,407,76.65847665847666,357,1069,1426,301,137,102,259,583,2395
DeAndre Liggins,5.0,2012 - 2018,SG,177,1907,129,321,40.18691588785047,43,122,35.24590163934426,86,199,43.21608040201005,46.88473520249221,45,82,54.87804878048781,47,205,252,122,108,31,86,201,346
Shelvin Mack,8.0,2012 - 2019,PG,456,8392,1165,2752,42.332848837209305,302,916,32.96943231441048,863,1836,47.00435729847495,47.81976744186046,365,499,73.14629258517033,118,776,894,1421,300,24,560,568,2997
Vernon Macklin,1.0,2012 - 2012,C,23,135,19,35,54.285714285714285,0,0,,19,35,54.285714285714285,54.285714285714285,8,14,57.14285714285714,14,20,34,5,4,4,3,9,46
E'Twaun Moore,8.0,2012 - 2019,SG,515,11155,1686,3678,45.840130505709624,482,1230,39.1869918699187,1204,2448,49.18300653594771,52.39260467645459,290,390,74.35897435897436,237,795,1032,937,348,115,471,834,4144
Darius Morris,4.0,2012 - 2015,PG,132,1464,166,432,38.425925925925924,47,146,32.19178082191781,119,286,41.60839160839161,43.86574074074074,51,81,62.96296296296296,40,86,126,189,45,2,112,127,430
Marcus Morris,8.0,2012 - 2019,PF,545,14454,2327,5401,43.08461396037771,757,2101,36.03046168491195,1570,3300,47.57575757575758,50.09257544899093,882,1180,74.7457627118644,529,1985,2514,828,379,141,633,1136,6293
Markieff Morris,8.0,2012 - 2019,PF,579,15039,2608,5812,44.872677219545764,441,1306,33.767228177641655,2167,4506,48.09143364403018,48.66655196145905,1069,1374,77.80203784570597,765,2420,3185,980,519,332,936,1694,6726
Daniel Orton,3.0,2012 - 2014,C,51,542,50,103,48.54368932038835,0,1,0.0,50,102,49.01960784313725,48.54368932038835,43,72,59.72222222222222,48,78,126,24,18,28,29,81,143
Jeremy Pargo,2.0,2012 - 2013,PG-SG,83,1079,149,400,37.25,35,112,31.25,114,288,39.58333333333333,41.625,58,89,65.1685393258427,20,66,86,147,28,2,96,92,391
Chandler Parsons,8.0,2012 - 2019,SF,435,13192,2124,4593,46.24428478118877,683,1830,37.3224043715847,1441,2763,52.15345638798408,53.6795123013281,626,878,71.29840546697038,355,1610,1965,1198,408,151,654,862,5557
Ryan Reid,1.0,2012 - 2012,PF,5,17,4,5,80.0,0,0,,4,5,80.0,80.0,0,0,,1,1,2,0,0,0,1,1,8
Ricky Rubio,8.0,2012 - 2019,PG,498,15370,1778,4585,38.778625954198475,413,1283,32.19017926734217,1365,3302,41.338582677165356,43.282442748091604,1556,1856,83.83620689655173,330,1762,2092,3817,959,66,1363,1306,5525
Walker Russell,1.0,2012 - 2012,PG,28,357,33,95,34.73684210526316,4,13,30.76923076923077,29,82,35.36585365853659,36.84210526315789,14,22,63.63636363636363,7,19,26,58,18,1,33,29,84
Josh Selby,2.0,2012 - 2013,PG,38,296,31,94,32.97872340425532,3,21,14.285714285714285,28,73,38.35616438356164,34.57446808510639,18,25,72.0,2,18,20,34,9,0,36,24,83
Iman Shumpert,8.0,2012 - 2019,SG,446,11218,1203,3062,39.28804702808622,481,1414,34.016973125884014,722,1648,43.810679611650485,47.14239059438275,377,492,76.6260162601626,314,1185,1499,833,501,118,519,1037,3264
Xavier Silas,2.0,2012 - 2018,SG,4,46,4,18,22.22222222222222,1,8,12.5,3,10,30.0,25.0,2,3,66.66666666666666,3,3,6,3,1,0,3,6,11
Chris Singleton,3.0,2012 - 2014,SF,148,2605,233,620,37.58064516129032,58,182,31.868131868131865,175,438,39.95433789954338,42.25806451612903,88,139,63.30935251798561,112,360,472,92,117,57,100,325,612
Donald Sloan,5.0,2012 - 2016,PG,218,3749,449,1098,40.892531876138435,98,316,31.0126582278481,351,782,44.8849104859335,45.3551912568306,193,256,75.390625,54,401,455,651,83,8,230,193,1189
Greg Smith,5.0,2012 - 2016,C,149,1834,243,394,61.6751269035533,0,1,0.0,243,393,61.832061068702295,61.6751269035533,110,191,57.59162303664922,165,324,489,41,32,59,65,290,596
Jerry Smith,1.0,2012 - 2012,PG,5,46,3,14,21.428571428571427,1,6,16.666666666666664,2,8,25.0,25.0,0,0,,2,5,7,4,5,0,0,5,7
Nolan Smith,2.0,2012 - 2013,PG,84,829,109,294,37.07482993197279,19,73,26.027397260273972,90,221,40.723981900452486,40.30612244897959,40,56,71.42857142857143,24,59,83,97,25,4,71,81,277
Greg Stiemsma,4.0,2012 - 2015,C,203,3048,269,529,50.85066162570888,0,1,0.0,269,528,50.9469696969697,50.85066162570888,103,146,70.54794520547945,190,489,679,97,118,232,143,512,641
Julyan Stone,4.0,2012 - 2018,SG,70,502,28,63,44.44444444444444,10,32,31.25,18,31,58.06451612903226,52.38095238095239,14,20,70.0,10,67,77,77,16,8,25,56,80
Isaiah Thomas,8.0,2012 - 2019,PG,485,14257,2917,6671,43.726577724479085,933,2592,35.995370370370374,1984,4079,48.639372395194904,50.7195323040024,2253,2578,87.3933281613654,268,952,1220,2453,451,50,1144,1032,9020
Lance Thomas,8.0,2012 - 2019,PF,392,7225,740,1773,41.73716864072194,161,420,38.333333333333336,579,1353,42.793791574279375,46.277495769881554,385,483,79.71014492753623,291,717,1008,260,148,55,260,672,2026
Malcolm Thomas,4.0,2012 - 2015,PF,40,329,30,69,43.47826086956522,1,11,9.090909090909092,29,58,50.0,44.20289855072464,15,25,60.0,27,69,96,14,6,7,25,30,76
Trey Thompkins,1.0,2012 - 2012,C,24,119,24,61,39.34426229508197,4,13,30.76923076923077,20,48,41.66666666666667,42.62295081967213,5,7,71.42857142857143,4,20,24,3,3,3,6,10,57
Klay Thompson,8.0,2012 - 2019,SG,615,20340,4512,9824,45.928338762214985,1798,4291,41.901654625961314,2714,5533,49.05114765949756,55.079397394136805,1173,1384,84.75433526011561,273,1857,2130,1416,561,332,1053,1313,11995
Mychel Thompson,1.0,2012 - 2012,SG,5,95,7,24,29.166666666666668,4,11,36.36363636363637,3,13,23.076923076923077,37.5,0,0,,0,5,5,7,2,1,5,8,18
Tristan Thompson,8.0,2012 - 2019,PF,562,15651,2056,3962,51.89298334174659,0,9,0.0,2056,3953,52.01113078674424,51.89298334174659,1043,1710,60.994152046783626,1889,2927,4816,504,284,397,615,1314,5155
Jeremy Tyler,3.0,2012 - 2014,C,104,1034,157,349,44.985673352435526,0,1,0.0,157,348,45.11494252873563,44.985673352435526,59,106,55.660377358490564,98,171,269,25,23,42,68,164,373
Edwin Ubiles,1.0,2012 - 2012,SF,4,52,5,18,27.77777777777778,1,5,20.0,4,13,30.76923076923077,30.555555555555557,3,3,100.0,2,8,10,1,1,1,1,1,14
Jan Vesely,3.0,2012 - 2014,PF,162,2455,263,505,52.07920792079208,0,2,0.0,263,503,52.286282306163024,52.07920792079208,64,157,40.76433121019109,225,337,562,96,107,84,123,384,590
Nikola Vucevic,8.0,2012 - 2019,C,536,16105,3692,7353,50.210798313613495,178,536,33.2089552238806,3514,6817,51.5476015842746,51.42118863049095,849,1146,74.08376963350786,1459,3978,5437,1310,461,509,942,1372,8411
Kemba Walker,8.0,2012 - 2019,PG,605,20607,4164,9962,41.798835575185706,1283,3589,35.74811925327389,2881,6373,45.20633924368429,48.23830556113231,2398,2871,83.5249042145594,349,1968,2317,3308,799,233,1317,911,12009
Derrick Williams,7.0,2012 - 2018,PF,428,8864,1329,3064,43.37467362924282,251,838,29.952267303102627,1078,2226,48.42767295597484,47.47062663185378,900,1267,71.03393843725335,351,1342,1693,293,199,108,399,532,3809
Elliot Williams,4.0,2012 - 2016,SG,109,1470,193,458,42.13973799126637,54,174,31.03448275862069,139,284,48.943661971830984,48.03493449781659,97,145,66.89655172413794,38,123,161,94,45,6,78,158,537
Jordan Williams,1.0,2012 - 2012,C,43,635,77,152,50.6578947368421,0,0,,77,152,50.6578947368421,50.6578947368421,43,66,65.15151515151516,66,90,156,11,21,15,23,61,197
Chris Wright,3.0,2012 - 2014,SF,35,316,45,82,54.87804878048781,0,1,0.0,45,81,55.55555555555556,54.87804878048781,30,46,65.21739130434783,29,36,65,9,14,18,14,39,120
Quincy Acy,7.0,2013 - 2019,PF,337,5392,583,1314,44.36834094368341,183,523,34.990439770554495,400,791,50.56890012642224,51.331811263318116,293,386,75.90673575129534,309,870,1179,217,140,135,219,665,1642
Josh Akognon,1.0,2013 - 2013,PG,3,9,2,4,50.0,1,2,50.0,1,2,50.0,62.5,0,0,,0,1,1,1,0,0,0,3,5
Harrison Barnes,7.0,2013 - 2019,SF,540,16592,2725,6111,44.59171984945181,658,1760,37.38636363636363,2067,4351,47.506320386118134,49.97545409916544,1214,1527,79.50229207596594,540,2105,2645,830,383,105,631,924,7322
Will Barton,7.0,2013 - 2019,SG,438,10194,1703,3955,43.05941845764855,464,1361,34.092578986039676,1239,2594,47.764070932922124,48.92541087231353,748,949,78.81981032665965,297,1427,1724,1036,310,176,589,664,4618
Aron Baynes,7.0,2013 - 2019,C,427,6456,926,1858,49.83853606027987,25,89,28.08988764044944,901,1769,50.932730356133405,50.511302475780404,433,536,80.78358208955224,647,1239,1886,307,91,209,349,904,2310
Kent Bazemore,7.0,2013 - 2019,SG,483,9980,1508,3603,41.85401054676659,506,1439,35.163307852675466,1002,2164,46.30314232902033,48.8759367194005,682,948,71.94092827004219,171,1309,1480,919,490,227,711,914,4204
Bradley Beal,7.0,2013 - 2019,SG,488,16779,3569,7901,45.17149727882547,1071,2787,38.428417653390746,2498,5114,48.846304262807976,51.949120364510826,1475,1849,79.77285018929152,398,1529,1927,1824,551,191,1047,1074,9684
Patrick Beverley,7.0,2013 - 2019,PG,380,10761,1210,2935,41.22657580919932,613,1614,37.98017348203222,597,1321,45.19303557910674,51.66950596252129,405,526,76.99619771863118,444,1174,1618,1312,452,166,494,1194,3438
Victor Claver,3.0,2013 - 2015,SF,80,1072,100,251,39.8406374501992,34,116,29.310344827586203,66,135,48.888888888888886,46.613545816733065,24,41,58.536585365853654,43,135,178,56,30,16,58,103,258
Chris Copeland,4.0,2013 - 2016,PF,171,2111,366,858,42.65734265734265,154,422,36.492890995260666,212,436,48.62385321100918,51.63170163170163,112,149,75.16778523489933,65,207,272,107,32,30,129,237,998
Jae Crowder,7.0,2013 - 2019,SF,543,13153,1782,4209,42.33784746970777,736,2171,33.90142791340396,1046,2038,51.32482826300294,51.08101686861487,837,1076,77.78810408921933,390,1731,2121,770,521,173,461,1081,5137
Jared Cunningham,4.0,2013 - 2016,SG,84,605,60,173,34.68208092485549,19,62,30.64516129032258,41,111,36.93693693693694,40.17341040462428,58,86,67.44186046511628,6,50,56,39,21,2,32,72,197
Anthony Davis,7.0,2013 - 2019,PF,466,16108,4153,8030,51.718555417185556,181,576,31.42361111111111,3972,7454,53.28682586530722,52.8455790784558,2572,3234,79.5299938157081,1208,3698,4906,982,639,1121,869,1106,11059
Nando De Colo,2.0,2013 - 2014,SG,119,1414,169,394,42.89340101522843,49,135,36.2962962962963,120,259,46.33204633204633,49.111675126903556,66,79,83.54430379746836,37,174,211,203,63,12,116,135,453
Andre Drummond,7.0,2013 - 2019,C,542,16711,3243,5976,54.26706827309237,10,68,14.705882352941178,3233,5908,54.72241029113067,54.35073627844712,1165,2600,44.80769230769231,2608,4816,7424,626,726,845,969,1706,7661
Kim English,1.0,2013 - 2013,SG,41,407,42,112,37.5,14,50,28.000000000000004,28,62,45.16129032258064,43.75,21,29,72.41379310344827,8,29,37,26,16,3,19,46,119
Festus Ezeli,3.0,2013 - 2016,C,170,2394,275,536,51.30597014925373,0,0,,275,536,51.30597014925373,51.30597014925373,162,291,55.670103092783506,292,433,725,63,48,166,133,328,712
Evan Fournier,7.0,2013 - 2019,SG,457,12782,2229,5001,44.57108578284343,760,2051,37.05509507557289,1469,2950,49.79661016949152,52.16956608678265,939,1167,80.46272493573264,206,1056,1262,1151,373,44,737,1117,6157
Joel Freeland,3.0,2013 - 2015,C,151,1821,209,455,45.934065934065934,0,2,0.0,209,453,46.13686534216336,45.934065934065934,59,81,72.8395061728395,190,328,518,65,32,56,74,255,477
Diante Garrett,2.0,2013 - 2014,PG,90,1197,117,314,37.261146496815286,39,111,35.13513513513514,78,203,38.42364532019704,43.47133757961784,15,22,68.18181818181817,16,96,112,151,51,5,91,80,288
Draymond Green,7.0,2013 - 2019,PF,533,14979,1752,3991,43.89877223753445,485,1503,32.26879574184963,1267,2488,50.924437299035375,49.97494362315209,836,1184,70.6081081081081,625,3075,3700,2589,730,576,1089,1482,4825
Ben Hansbrough,1.0,2013 - 2013,PG,28,200,15,45,33.33333333333333,6,23,26.08695652173913,9,22,40.909090909090914,40.0,21,27,77.77777777777779,2,16,18,21,7,2,18,23,57
Maurice Harkless,7.0,2013 - 2019,SF,475,10957,1392,2925,47.58974358974359,290,899,32.25806451612903,1102,2026,54.3928923988154,52.547008547008545,417,679,61.413843888070694,578,1179,1757,437,466,322,415,954,3491
John Henson,7.0,2013 - 2019,C,405,8152,1343,2490,53.93574297188755,12,44,27.27272727272727,1331,2446,54.41537203597711,54.17670682730924,464,811,57.21331689272503,756,1450,2206,442,187,600,460,920,3162
Justin Holiday,6.0,2013 - 2019,SG,357,8083,1018,2608,39.033742331288344,495,1417,34.93295695130558,523,1191,43.91267842149455,48.52377300613497,366,440,83.18181818181817,128,888,1016,520,341,135,340,529,2897
Bernard James,3.0,2013 - 2015,C,92,761,76,153,49.673202614379086,0,3,0.0,76,150,50.66666666666667,49.673202614379086,51,75,68.0,85,127,212,13,17,61,34,105,203
John Jenkins,6.0,2013 - 2019,SG,171,2183,311,705,44.11347517730497,117,319,36.677115987460816,194,386,50.259067357512954,52.4113475177305,116,137,84.67153284671532,36,214,250,138,31,14,95,95,855
Orlando Johnson,3.0,2013 - 2016,SG,103,1112,117,327,35.77981651376147,47,151,31.125827814569533,70,176,39.77272727272727,42.96636085626911,48,66,72.72727272727273,33,147,180,69,20,14,48,86,329
Darius Johnson-Odom,2.0,2013 - 2014,SG,7,21,0,11,0.0,0,4,0.0,0,7,0.0,0.0,0,2,0.0,1,5,6,2,1,0,2,3,0
DeQuan Jones,1.0,2013 - 2013,SF,63,803,95,218,43.57798165137615,9,35,25.71428571428571,86,183,46.994535519125684,45.642201834862384,34,51,66.66666666666666,17,88,105,16,19,22,30,55,233
Kevin Jones,1.0,2013 - 2013,PF,32,334,43,107,40.18691588785047,0,0,,43,107,40.18691588785047,40.18691588785047,9,15,60.0,38,40,78,10,9,5,8,25,95
Perry Jones,3.0,2013 - 2015,SF,143,1675,195,464,42.025862068965516,36,123,29.268292682926827,159,341,46.62756598240469,45.9051724137931,62,94,65.95744680851064,46,206,252,54,36,33,60,135,488
Terrence Jones,6.0,2013 - 2019,PF,234,5562,985,1968,50.05081300813008,93,313,29.712460063897762,892,1655,53.89728096676737,52.41361788617886,368,593,62.05733558178752,395,939,1334,238,146,270,219,392,2431
Kris Joseph,1.0,2013 - 2013,SF,10,54,2,14,14.285714285714285,0,3,0.0,2,11,18.181818181818183,14.285714285714285,5,8,62.5,1,6,7,1,3,0,2,3,9
Michael Kidd-Gilchrist,7.0,2013 - 2019,SF,421,10697,1440,3019,47.69791321629679,23,83,27.710843373493976,1417,2936,48.26294277929155,48.07883405101027,787,1102,71.41560798548095,689,1664,2353,501,294,298,384,919,3690
Viacheslav Kravtsov,2.0,2013 - 2014,C,45,283,41,61,67.21311475409836,0,0,,41,61,67.21311475409836,67.21311475409836,15,45,33.33333333333333,33,29,62,10,5,10,20,39,97
Doron Lamb,2.0,2013 - 2014,SG,100,1272,123,323,38.080495356037154,50,127,39.37007874015748,73,196,37.244897959183675,45.82043343653251,49,70,70.0,16,79,95,75,24,1,53,106,345
Jeremy Lamb,7.0,2013 - 2019,SG,435,8905,1658,3739,44.34340732816261,441,1299,33.94919168591224,1217,2440,49.87704918032787,50.240706071142014,698,818,85.33007334963325,228,1360,1588,674,297,151,357,689,4455
Meyers Leonard,7.0,2013 - 2019,C,393,6095,836,1746,47.88087056128293,271,703,38.54907539118065,565,1043,54.170661553211886,55.64146620847652,240,290,82.75862068965517,291,1179,1470,338,69,112,268,853,2183
Damian Lillard,7.0,2013 - 2019,PG,549,19907,4277,9862,43.368485094301356,1506,4090,36.821515892420535,2771,5772,48.00762300762301,51.00385317379842,2849,3205,88.89235569422776,347,1942,2289,3479,533,171,1515,1115,12909
Scott Machado,2.0,2013 - 2019,PG,10,40,7,12,58.333333333333336,1,2,50.0,6,10,60.0,62.5,3,3,100.0,0,1,1,9,3,0,8,2,18
Kendall Marshall,4.0,2013 - 2016,PG,160,3083,315,789,39.92395437262358,128,346,36.99421965317919,187,443,42.21218961625282,48.03548795944233,44,72,61.111111111111114,23,230,253,779,107,10,285,180,802
Fab Melo,1.0,2013 - 2013,C,6,36,3,6,50.0,0,0,,3,6,50.0,50.0,1,4,25.0,0,3,3,0,2,2,1,7,7
Khris Middleton,7.0,2013 - 2019,SF,455,14429,2600,5759,45.146726862302486,756,1949,38.789122626988195,1844,3810,48.3989501312336,51.71036638305261,1173,1349,86.95329873980727,262,1760,2022,1468,591,89,857,1204,7129
Darius Miller,5.0,2013 - 2019,SF,253,5161,523,1252,41.77316293929712,327,856,38.20093457943925,196,396,49.494949494949495,54.83226837060703,151,182,82.96703296703298,49,374,423,346,110,61,163,510,1524
Quincy Miller,3.0,2013 - 2015,PF,69,934,107,306,34.967320261437905,33,113,29.20353982300885,74,193,38.34196891191709,40.35947712418301,48,68,70.58823529411765,41,128,169,37,30,37,54,82,295
Donatas Motiejunas,6.0,2013 - 2019,PF,251,4566,731,1558,46.9191270860077,121,404,29.950495049504948,610,1154,52.85961871750433,50.80231065468549,249,417,59.71223021582733,298,654,952,269,118,82,287,538,1832
Arnett Moultrie,2.0,2013 - 2014,PF,59,729,94,172,54.65116279069767,0,0,,94,172,54.65116279069767,54.65116279069767,22,33,66.66666666666666,87,93,180,12,25,14,26,65,210
Kevin Murphy,1.0,2013 - 2013,SG,17,52,7,28,25.0,1,5,20.0,6,23,26.08695652173913,26.785714285714285,0,0,,0,4,4,2,1,0,3,4,15
Andrew Nicholson,5.0,2013 - 2017,PF,285,4080,708,1517,46.671061305207644,87,271,32.10332103321033,621,1246,49.83948635634029,49.5385629531971,197,255,77.25490196078432,188,669,857,126,74,95,212,458,1700
Kyle O'Quinn,7.0,2013 - 2019,C,443,6401,1043,2014,51.78748758689176,24,115,20.869565217391305,1019,1899,53.659820958399166,52.38331678252235,356,476,74.78991596638656,594,1456,2050,592,182,429,438,923,2466
Tim Ohlbrecht,1.0,2013 - 2013,C,3,12,1,3,33.33333333333333,0,0,,1,3,33.33333333333333,33.33333333333333,1,1,100.0,0,1,1,1,1,0,4,1,3
Miles Plumlee,7.0,2013 - 2019,C,346,5658,748,1381,54.16364952932658,0,0,,748,1381,54.16364952932658,54.16364952932658,201,370,54.32432432432432,547,1015,1562,178,153,256,308,540,1697
Pablo Prigioni,4.0,2013 - 2016,PG,270,4566,334,786,42.49363867684479,203,535,37.94392523364486,131,251,52.191235059760956,55.40712468193384,75,86,87.20930232558139,145,360,505,765,268,6,257,429,946
Austin Rivers,7.0,2013 - 2019,SG,484,11923,1662,3984,41.71686746987952,516,1487,34.700739744451916,1146,2497,45.89507408890669,48.19277108433735,617,968,63.7396694214876,163,825,988,1154,336,90,569,1085,4457
Brian Roberts,5.0,2013 - 2017,PG,314,5207,753,1831,41.125068268705625,217,610,35.57377049180328,536,1221,43.8984438984439,47.050791916985254,336,370,90.81081081081082,58,364,422,721,132,19,272,368,2059
Thomas Robinson,5.0,2013 - 2017,PF,313,4204,640,1361,47.02424687729611,0,6,0.0,640,1355,47.23247232472325,47.02424687729611,248,491,50.509164969450104,542,965,1507,190,161,111,319,546,1528
Terrence Ross,7.0,2013 - 2019,SG,492,11942,1925,4551,42.298395956932545,891,2383,37.389844733529166,1034,2168,47.69372693726937,52.0874533069655,422,515,81.94174757281554,186,1180,1366,535,400,164,438,868,5163
Robert Sacre,4.0,2013 - 2016,C,189,2745,318,729,43.62139917695473,0,1,0.0,318,728,43.68131868131868,43.62139917695473,151,225,67.11111111111111,212,381,593,126,56,110,102,336,787
Mike Scott,7.0,2013 - 2019,PF,436,7123,1209,2607,46.37514384349827,361,993,36.35448136958711,848,1614,52.540272614622054,53.29881089374761,336,445,75.50561797752809,302,1057,1359,403,137,55,312,654,3115
Tornike Shengelia,2.0,2013 - 2014,SF,45,247,23,51,45.09803921568628,1,8,12.5,22,43,51.162790697674424,46.07843137254902,12,24,50.0,13,26,39,17,6,2,23,29,59
Alexey Shved,3.0,2013 - 2015,SG,182,3271,445,1207,36.868268434134215,162,529,30.623818525519848,283,678,41.740412979351035,43.579121789560894,297,390,76.15384615384615,85,270,355,460,110,49,243,201,1349
Henry Sims,4.0,2013 - 2016,C,135,2542,403,856,47.07943925233645,4,23,17.391304347826086,399,833,47.89915966386555,47.31308411214953,221,288,76.73611111111111,248,422,670,140,76,64,153,289,1031
Kyle Singler,6.0,2013 - 2018,SF,356,7794,843,2015,41.836228287841195,299,826,36.19854721549637,544,1189,45.75273338940286,49.25558312655087,341,434,78.57142857142857,317,709,1026,272,203,110,278,734,2326
Jared Sullinger,5.0,2013 - 2017,PF,269,6532,1172,2685,43.64990689013035,141,518,27.220077220077222,1031,2167,47.577295800646056,46.2756052141527,408,564,72.3404255319149,684,1322,2006,477,180,161,332,784,2893
Jeffery Taylor,3.0,2013 - 2015,SF,132,2566,299,731,40.902872777017784,82,257,31.906614785992215,217,474,45.78059071729958,46.51162790697674,127,191,66.49214659685863,80,183,263,107,72,21,92,234,807
Tyshawn Taylor,2.0,2013 - 2014,PG,61,491,63,178,35.39325842696629,9,25,36.0,54,153,35.294117647058826,37.92134831460674,39,57,68.42105263157895,5,28,33,57,25,1,56,54,174
Marquis Teague,3.0,2013 - 2018,PG,91,909,85,248,34.274193548387096,10,45,22.22222222222222,75,203,36.94581280788177,36.29032258064516,37,56,66.07142857142857,5,85,90,134,23,12,77,98,217
Mirza Teletovic,6.0,2013 - 2018,PF,324,5765,927,2285,40.56892778993436,541,1460,37.054794520547944,386,825,46.78787878787879,52.4070021881838,241,319,75.54858934169279,189,853,1042,273,104,82,255,552,2636
Jonas Valanciunas,7.0,2013 - 2019,C,489,12301,2321,4157,55.83353379841232,45,126,35.714285714285715,2276,4031,56.462416273877444,56.37478951166707,1216,1547,78.60374919198449,1261,2903,4164,391,184,509,735,1371,5903
Jarvis Varnado,2.0,2013 - 2014,PF,37,397,39,67,58.2089552238806,0,0,,39,67,58.2089552238806,58.2089552238806,29,56,51.78571428571429,21,51,72,16,11,31,16,72,107
Dion Waiters,7.0,2013 - 2019,SG,409,11628,2065,5011,41.20933945320295,560,1613,34.7179169249845,1505,3398,44.29075927015892,46.79704649770505,704,1017,69.22320550639135,164,920,1084,1143,387,107,745,792,5394
Maalik Wayns,2.0,2013 - 2014,PG,29,211,27,90,30.0,7,31,22.58064516129032,20,59,33.89830508474576,33.88888888888889,17,19,89.47368421052632,1,8,9,29,8,0,15,30,78
Tony Wroten,4.0,2013 - 2016,PG,145,3076,575,1393,41.277817659727205,84,363,23.140495867768596,491,1030,47.66990291262136,44.29289303661163,370,572,64.6853146853147,106,257,363,437,137,28,375,268,1604
Luke Zeller,1.0,2013 - 2013,C,16,58,9,26,34.61538461538461,1,5,20.0,8,21,38.095238095238095,36.53846153846153,0,0,,1,9,10,3,0,0,0,5,19
Tyler Zeller,7.0,2013 - 2019,C,412,7250,1160,2280,50.877192982456144,10,35,28.57142857142857,1150,2245,51.224944320712694,51.09649122807017,541,708,76.41242937853107,634,1182,1816,367,104,241,348,897,2871
Steven Adams,6.0,2014 - 2019,C,467,12527,1874,3186,58.819836785938485,0,7,0.0,1874,3179,58.949355143126766,58.819836785938485,759,1372,55.32069970845481,1616,1830,3446,469,418,464,663,1262,4507
Giannis Antetokounmpo,6.0,2014 - 2019,PF,465,15220,3188,6119,52.10001634253963,220,794,27.70780856423174,2968,5325,55.73708920187793,53.89769570191207,2149,2897,74.18018639972385,748,3096,3844,1921,559,626,1228,1394,8745
Pero Antic,2.0,2014 - 2015,C,113,1962,231,590,39.152542372881356,108,344,31.3953488372093,123,246,50.0,48.30508474576271,138,189,73.01587301587301,115,283,398,107,37,26,104,258,708
Chris Babb,1.0,2014 - 2014,SG,14,132,8,30,26.666666666666668,6,27,22.22222222222222,2,3,66.66666666666666,36.666666666666664,0,0,,4,13,17,3,6,0,3,13,22
Anthony Bennett,4.0,2014 - 2017,PF,151,1905,251,641,39.15756630265211,36,138,26.08695652173913,215,503,42.74353876739563,41.96567862714509,120,179,67.0391061452514,132,340,472,77,58,27,99,206,658
Vander Blue,3.0,2014 - 2018,SG,10,134,12,39,30.76923076923077,2,13,15.384615384615385,10,26,38.46153846153847,33.33333333333333,4,12,33.33333333333333,2,11,13,12,4,0,11,7,30
Lorenzo Brown,5.0,2014 - 2019,PG,103,1185,123,338,36.3905325443787,18,106,16.9811320754717,105,232,45.258620689655174,39.053254437869825,29,41,70.73170731707317,28,123,151,183,61,15,74,101,293
Reggie Bullock,6.0,2014 - 2019,SF,272,5240,676,1557,43.41682723185613,360,919,39.17301414581066,316,638,49.52978056426332,54.97752087347463,144,174,82.75862068965517,88,475,563,300,134,35,151,275,1856
Trey Burke,6.0,2014 - 2019,PG,361,8529,1518,3723,40.77356970185335,448,1316,34.04255319148936,1070,2407,44.4536767760698,46.790222938490466,440,550,80.0,134,607,741,1301,210,43,475,505,3924
Dwight Buycks,3.0,2014 - 2018,PG,49,696,115,286,40.20979020979021,27,73,36.986301369863014,88,213,41.31455399061033,44.93006993006993,53,60,88.33333333333333,18,58,76,83,30,2,61,53,310
Nick Calathes,2.0,2014 - 2015,SG,129,2011,246,558,44.086021505376344,30,104,28.846153846153843,216,454,47.57709251101321,46.774193548387096,68,117,58.119658119658126,42,201,243,353,129,13,162,217,590
Kentavious Caldwell-Pope,6.0,2014 - 2019,SG,470,13981,2010,4874,41.23922855970456,789,2285,34.52954048140044,1221,2589,47.161066048667436,49.33319655313911,786,984,79.8780487804878,317,1249,1566,767,546,88,475,873,5595
Isaiah Canaan,6.0,2014 - 2019,PG,235,4799,616,1661,37.086092715231786,366,1042,35.12476007677543,250,619,40.38772213247172,48.10355207706201,315,377,83.55437665782493,63,375,438,454,145,23,259,364,1913
Michael Carter-Williams,6.0,2014 - 2019,PG,315,8265,1276,3186,40.050219711236664,145,577,25.12998266897747,1131,2609,43.34994250670755,42.325800376647834,729,1039,70.16361886429259,293,1134,1427,1463,423,175,791,791,3426
Dionte Christmas,1.0,2014 - 2014,SF,31,198,22,62,35.483870967741936,9,31,29.03225806451613,13,31,41.935483870967744,42.74193548387097,18,24,75.0,13,25,38,8,2,3,6,19,71
Ian Clark,6.0,2014 - 2019,SG,330,4507,718,1635,43.91437308868502,240,705,34.04255319148936,478,930,51.3978494623656,51.25382262996941,164,204,80.3921568627451,65,375,440,385,128,44,236,394,1840
Robert Covington,6.0,2014 - 2019,SF,326,9747,1372,3412,40.211019929660026,766,2126,36.030103480714956,606,1286,47.12286158631415,51.43610785463072,645,793,81.33669609079445,307,1495,1802,506,542,259,576,991,4155
Allen Crabbe,6.0,2014 - 2019,SG,344,8472,1163,2711,42.89929915160457,581,1477,39.33649289099526,582,1234,47.163695299837926,53.61490225009222,374,448,83.48214285714286,98,898,996,401,208,100,268,717,3281
Seth Curry,5.0,2014 - 2019,PG,192,4141,653,1398,46.70958512160229,301,686,43.87755102040816,352,712,49.43820224719101,57.474964234620884,174,206,84.46601941747572,61,301,362,323,139,22,189,266,1781
Troy Daniels,6.0,2014 - 2019,SG,292,4513,695,1728,40.219907407407405,509,1272,40.01572327044025,186,456,40.78947368421053,54.947916666666664,133,163,81.59509202453987,62,332,394,168,89,18,175,392,2032
Luigi Datome,2.0,2014 - 2015,SF,55,447,77,186,41.39784946236559,25,79,31.645569620253166,52,107,48.598130841121495,48.11827956989247,9,11,81.81818181818183,17,58,75,20,8,8,20,35,188
Brandon Davies,2.0,2014 - 2015,PF,78,998,109,265,41.132075471698116,10,44,22.727272727272727,99,221,44.79638009049774,43.0188679245283,58,90,64.44444444444444,76,116,192,58,42,15,64,151,286
Dewayne Dedmon,6.0,2014 - 2019,C,350,6421,898,1684,53.32541567695962,133,359,37.04735376044568,765,1325,57.73584905660377,57.274346793349174,336,464,72.41379310344827,557,1558,2115,251,191,301,332,872,2265
Matthew Dellavedova,6.0,2014 - 2019,PG,377,8028,801,2042,39.22624877571009,375,984,38.109756097560975,426,1058,40.26465028355388,48.40842311459353,273,327,83.4862385321101,143,556,699,1411,182,18,487,746,2250
Gorgui Dieng,6.0,2014 - 2019,C,452,10248,1387,2744,50.546647230320694,62,187,33.155080213903744,1325,2557,51.818537348455216,51.67638483965015,758,960,78.95833333333333,858,1954,2812,629,376,447,543,1050,3594
Shane Edwards,1.0,2014 - 2014,SF,2,12,1,3,33.33333333333333,0,0,,1,3,33.33333333333333,33.33333333333333,0,0,,1,1,2,0,0,0,1,1,2
Vitor Faverani,1.0,2014 - 2014,C,37,488,64,147,43.53741496598639,12,40,30.0,52,107,48.598130841121495,47.61904761904761,24,37,64.86486486486487,42,86,128,16,14,27,41,74,164
Carrick Felix,1.0,2014 - 2014,SG,7,38,7,14,50.0,2,5,40.0,5,9,55.55555555555556,57.14285714285714,3,4,75.0,1,5,6,4,0,0,4,4,19
Jamaal Franklin,2.0,2014 - 2015,SG,24,174,17,41,41.46341463414634,6,13,46.15384615384615,11,28,39.285714285714285,48.78048780487805,2,2,100.0,5,20,25,9,4,3,14,27,42
Rudy Gobert,6.0,2014 - 2019,C,406,11661,1657,2636,62.86039453717754,0,3,0.0,1657,2633,62.93201671097607,62.86039453717754,1210,1918,63.08654848800834,1312,2963,4275,545,276,895,641,1025,4524
Archie Goodwin,4.0,2014 - 2017,SG,165,2396,367,856,42.873831775700936,45,191,23.56020942408377,322,665,48.421052631578945,45.50233644859813,261,373,69.97319034852548,86,245,331,206,69,38,206,192,1040
Jorge Gutierrez,3.0,2014 - 2016,PG,47,482,53,106,50.0,3,17,17.647058823529413,50,89,56.17977528089888,51.41509433962265,28,36,77.77777777777779,8,46,54,69,19,1,32,65,137
Justin Hamilton,3.0,2014 - 2017,C,113,1961,268,577,46.447140381282495,68,220,30.909090909090907,200,357,56.022408963585434,52.33968804159446,83,104,79.8076923076923,132,271,403,91,61,73,73,169,687
Elias Harris,1.0,2014 - 2014,SF,2,11,0,1,0.0,0,0,,0,1,0.0,0.0,0,0,,1,0,1,1,1,0,0,0,0
Solomon Hill,6.0,2014 - 2019,SF,305,6912,623,1579,39.455351488283725,229,697,32.85509325681492,394,882,44.67120181405896,46.706776440785305,330,408,80.88235294117648,212,785,997,471,210,74,283,548,1805
Scotty Hopson,2.0,2014 - 2018,SG,3,15,0,5,0.0,0,2,0.0,0,3,0.0,0.0,2,4,50.0,0,0,0,2,1,0,1,0,2
Robbie Hummel,2.0,2014 - 2015,SF,98,1397,146,349,41.833810888252145,48,140,34.285714285714285,98,209,46.889952153110045,48.71060171919771,39,45,86.66666666666667,66,200,266,50,32,11,28,143,379
Sergey Karasev,3.0,2014 - 2016,SF,95,1110,96,243,39.50617283950617,31,110,28.18181818181818,65,133,48.87218045112782,45.884773662551446,64,76,84.21052631578947,30,110,140,87,32,4,57,94,287
Ryan Kelly,4.0,2014 - 2017,PF,163,3125,324,857,37.80630105017503,102,323,31.57894736842105,222,534,41.57303370786517,43.75729288214703,231,290,79.65517241379311,77,427,504,215,79,84,106,309,981
Ognjen Kuzmic,2.0,2014 - 2015,C,37,164,13,25,52.0,0,0,,13,25,52.0,52.0,9,15,60.0,17,21,38,8,5,5,15,30,35
Shane Larkin,4.0,2014 - 2018,PG,256,4880,545,1290,42.248062015503876,117,348,33.62068965517241,428,942,45.43524416135881,46.78294573643411,192,247,77.7327935222672,83,407,490,737,243,24,301,375,1399
Ricky Ledo,2.0,2014 - 2015,SG,28,277,38,113,33.6283185840708,13,35,37.142857142857146,25,78,32.05128205128205,39.38053097345133,20,26,76.92307692307693,16,22,38,21,7,1,28,23,109
Alex Len,6.0,2014 - 2019,C,412,8200,1240,2544,48.742138364779876,80,229,34.93449781659388,1160,2315,50.10799136069114,50.314465408805034,715,1029,69.48493683187561,848,1751,2599,345,168,413,522,1111,3275
Ray McCallum,3.0,2014 - 2016,PG,154,2808,374,916,40.8296943231441,71,212,33.490566037735846,303,704,43.03977272727273,44.70524017467249,101,142,71.12676056338029,78,228,306,368,79,27,148,190,920
CJ McCollum,6.0,2014 - 2019,SG,411,12323,2804,6163,45.4973227324355,823,2051,40.126767430521696,1981,4112,48.17607003891051,52.174265779652764,897,1069,83.91019644527596,243,1047,1290,1196,358,138,708,863,7328
Ben McLemore,6.0,2014 - 2019,SG,368,8725,1175,2821,41.65189649060616,439,1243,35.31777956556718,736,1578,46.64131812420786,49.43282523927685,450,575,78.26086956521739,174,735,909,407,247,71,461,829,3239
Gal Mekel,2.0,2014 - 2015,PG,35,335,33,106,31.132075471698112,5,23,21.73913043478261,28,83,33.734939759036145,33.490566037735846,8,12,66.66666666666666,5,23,28,76,6,1,33,32,79
Tony Mitchell,1.0,2014 - 2014,PF,21,79,5,12,41.66666666666667,1,1,100.0,4,11,36.36363636363637,45.83333333333333,11,19,57.89473684210527,15,11,26,2,6,3,4,9,22
Shabazz Muhammad,5.0,2014 - 2018,SG,278,4772,940,1988,47.283702213279675,123,386,31.865284974093267,817,1602,50.998751560549316,50.37726358148893,501,667,75.11244377811094,294,476,770,151,81,24,183,283,2504
Erik Murphy,1.0,2014 - 2014,C,24,62,3,13,23.076923076923077,0,3,0.0,3,10,30.0,23.076923076923077,0,0,,2,6,8,2,0,4,2,7,6
Toure' Murry,2.0,2014 - 2015,SG-PG,56,391,58,134,43.28358208955223,5,12,41.66666666666667,53,122,43.44262295081967,45.149253731343286,25,41,60.97560975609756,14,31,45,50,20,1,38,48,146
Mike Muscala,6.0,2014 - 2019,C,307,4885,648,1386,46.75324675324675,218,597,36.515912897822446,430,789,54.49936628643853,54.61760461760462,243,289,84.08304498269896,296,706,1002,288,115,162,205,460,1757
Nemanja Nedovic,1.0,2014 - 2014,SG,24,142,8,39,20.51282051282051,3,18,16.666666666666664,5,21,23.809523809523807,24.358974358974358,7,8,87.5,3,12,15,13,0,1,13,13,26
James Nunnally,2.0,2014 - 2019,SF,28,267,27,80,33.75,16,50,32.0,11,30,36.666666666666664,43.75,10,13,76.92307692307693,1,23,24,15,7,2,8,21,80
Victor Oladipo,6.0,2014 - 2019,SG,402,13360,2591,5854,44.26033481380253,618,1758,35.153583617747444,1973,4096,48.1689453125,49.53877690468056,1228,1548,79.32816537467701,249,1610,1859,1589,680,199,1033,973,7028
Kelly Olynyk,6.0,2014 - 2019,C,433,9347,1575,3294,47.81420765027322,473,1290,36.666666666666664,1102,2004,54.99001996007984,54.993928354584085,664,868,76.49769585253456,538,1578,2116,818,309,200,635,1215,4287
Arinze Onuaku,3.0,2014 - 2017,C,19,126,15,23,65.21739130434783,0,0,,15,23,65.21739130434783,65.21739130434783,4,10,40.0,11,24,35,9,1,4,5,12,34
Mason Plumlee,6.0,2014 - 2019,C,471,10420,1563,2741,57.02298431229478,2,27,7.4074074074074066,1561,2714,57.5165806927045,57.059467347683324,861,1524,56.496062992125985,942,2035,2977,1029,366,452,700,1293,3989
Otto Porter,6.0,2014 - 2019,SF,399,10747,1706,3530,48.328611898017,527,1302,40.476190476190474,1179,2228,52.917414721723524,55.79320113314448,444,560,79.28571428571428,463,1526,1989,593,471,177,320,738,4383
Phil Pressey,3.0,2014 - 2016,PG,148,2015,172,505,34.05940594059406,48,189,25.396825396825395,124,316,39.24050632911392,38.81188118811881,75,119,63.02521008403361,36,180,216,433,116,15,161,179,467
Miroslav Raduljica,2.0,2014 - 2015,C,53,488,71,134,52.98507462686567,0,0,,71,134,52.98507462686567,52.98507462686567,47,57,82.45614035087719,56,57,113,23,8,13,30,92,189
Andre Roberson,5.0,2014 - 2018,SG,295,6651,563,1168,48.20205479452055,108,421,25.653206650831358,455,747,60.91030789825971,52.82534246575342,122,261,46.74329501915709,348,840,1188,257,264,195,181,641,1356
Dennis Schroder,6.0,2014 - 2019,PG,431,10655,2190,5098,42.95802275402119,439,1349,32.542624166048924,1751,3749,46.70578821018939,47.26363279717536,950,1151,82.53692441355344,183,985,1168,1998,347,47,1007,804,5769
Peyton Siva,1.0,2014 - 2014,SG,24,224,18,57,31.57894736842105,7,25,28.000000000000004,11,32,34.375,37.719298245614034,11,15,73.33333333333333,2,12,14,34,9,1,18,27,54
Chris Smith,1.0,2014 - 2014,PG,2,2,0,0,,0,0,,0,0,,,0,0,,0,0,0,0,0,0,0,0,0
Tony Snell,6.0,2014 - 2019,SG,442,9637,1008,2373,42.47787610619469,519,1357,38.24613117170229,489,1016,48.12992125984252,53.413400758533506,227,277,81.94945848375451,129,916,1045,455,205,103,258,600,2762
James Southerland,1.0,2014 - 2014,SF,4,30,5,15,33.33333333333333,3,6,50.0,2,9,22.22222222222222,43.333333333333336,1,2,50.0,0,8,8,0,1,2,1,3,14
D.J. Stephens,2.0,2014 - 2019,SG,4,22,4,9,44.44444444444444,0,0,,4,9,44.44444444444444,44.44444444444444,1,1,100.0,1,4,5,0,1,0,1,0,9
Adonis Thomas,1.0,2014 - 2014,SF,6,37,6,14,42.857142857142854,1,5,20.0,5,9,55.55555555555556,46.42857142857143,1,1,100.0,0,3,3,3,0,0,1,6,14
Hollis Thompson,4.0,2014 - 2017,SG,265,6424,742,1795,41.33704735376045,363,941,38.5759829968119,379,854,44.37939110070258,51.448467966573816,203,287,70.73170731707317,199,630,829,292,166,68,213,541,2050
Casper Ware,1.0,2014 - 2014,PG,9,116,18,42,42.857142857142854,7,21,33.33333333333333,11,21,52.38095238095239,51.19047619047619,5,6,83.33333333333334,0,9,9,10,8,0,5,11,48
Royce White,1.0,2014 - 2014,PF,3,9,0,1,0.0,0,0,,0,1,0.0,0.0,0,0,,0,0,0,0,0,0,0,2,0
Jeff Withey,5.0,2014 - 2018,C,206,2072,249,474,52.53164556962025,2,14,14.285714285714285,247,460,53.69565217391305,52.742616033755276,166,232,71.55172413793103,181,337,518,64,56,156,76,229,666
Nate Wolters,3.0,2014 - 2018,PG,84,1575,191,452,42.256637168141594,18,69,26.08695652173913,173,383,45.16971279373368,44.24778761061947,61,96,63.541666666666664,42,143,185,209,43,17,70,86,461
Cody Zeller,6.0,2014 - 2019,C,361,8272,1103,2158,51.11214087117701,10,38,26.31578947368421,1093,2120,51.55660377358491,51.343836886005555,753,1018,73.96856581532415,665,1420,2085,495,245,273,377,964,2969
Jordan Adams,2.0,2015 - 2016,SG,32,263,37,92,40.21739130434783,10,26,38.46153846153847,27,66,40.909090909090914,45.65217391304348,17,28,60.71428571428571,9,21,30,19,19,7,16,26,101
Furkan Aldemir,1.0,2015 - 2015,PF,41,540,40,78,51.28205128205128,0,5,0.0,40,73,54.794520547945204,51.28205128205128,13,27,48.148148148148145,78,98,176,28,17,16,17,96,93
Kyle Anderson,5.0,2015 - 2019,SF,300,5882,643,1307,49.19663351185922,58,179,32.402234636871505,585,1128,51.86170212765957,51.415455241009944,257,364,70.6043956043956,195,976,1171,572,295,159,260,414,1601
Cameron Bairstow,2.0,2015 - 2016,C,36,167,16,54,29.629629629629626,1,5,20.0,15,49,30.612244897959183,30.555555555555557,11,13,84.61538461538461,10,26,36,7,4,4,7,27,44
Jerrelle Benimon,1.0,2015 - 2015,PF,2,3,0,0,,0,0,,0,0,,,0,0,,1,2,3,0,0,0,1,0,0
Sim Bhullar,1.0,2015 - 2015,C,3,3,1,2,50.0,0,0,,1,2,50.0,50.0,0,0,,0,1,1,1,0,1,0,0,2
Tarik Black,4.0,2015 - 2018,C,220,3319,439,798,55.012531328320804,2,14,14.285714285714285,437,784,55.73979591836735,55.13784461152882,195,335,58.2089552238806,393,638,1031,110,83,116,163,516,1075
Bojan Bogdanovic,5.0,2015 - 2019,SF,399,11089,1887,4073,46.32948686471888,683,1758,38.8509670079636,1204,2315,52.00863930885529,54.71397004664866,838,991,84.56104944500504,186,1162,1348,558,221,30,564,636,5295
Jabari Brown,1.0,2015 - 2015,SG,19,568,70,170,41.17647058823529,23,62,37.096774193548384,47,108,43.51851851851852,47.94117647058824,64,85,75.29411764705883,3,33,36,40,12,2,32,33,227
Markel Brown,3.0,2015 - 2018,SG,113,1794,205,539,38.03339517625232,56,190,29.47368421052631,149,349,42.693409742120345,43.22820037105751,118,151,78.1456953642384,40,194,234,132,69,27,83,157,584
Bruno Caboclo,5.0,2015 - 2019,SF,69,1013,116,296,39.189189189189186,56,163,34.355828220858896,60,133,45.11278195488722,48.64864864864865,47,56,83.92857142857143,56,138,194,59,21,40,52,98,335
Clint Capela,5.0,2015 - 2019,C,295,7395,1522,2397,63.49603671255737,0,2,0.0,1522,2395,63.5490605427975,63.49603671255737,488,929,52.529601722282024,921,1785,2706,276,196,419,349,736,3532
Will Cherry,1.0,2015 - 2015,PG,8,69,5,19,26.31578947368421,2,9,22.22222222222222,3,10,30.0,31.57894736842105,3,6,50.0,1,4,5,8,6,1,4,10,15
Patrick Christopher,1.0,2015 - 2015,SG,4,29,3,12,25.0,0,4,0.0,3,8,37.5,25.0,0,0,,2,4,6,0,1,0,1,6,6
Jordan Clarkson,5.0,2015 - 2019,SG,382,10527,2178,4899,44.45805266380894,522,1560,33.46153846153846,1656,3339,49.59568733153639,49.78567054500919,743,912,81.46929824561403,337,900,1237,1028,342,46,657,646,5621
Jack Cooley,2.0,2015 - 2018,C,23,174,22,49,44.89795918367347,0,0,,22,49,44.89795918367347,44.89795918367347,23,40,57.49999999999999,24,31,55,7,7,3,6,36,67
Bryce Cotton,2.0,2015 - 2016,PG,23,198,33,79,41.77215189873418,7,23,30.434782608695656,26,56,46.42857142857143,46.20253164556962,15,18,83.33333333333334,3,15,18,18,7,0,17,8,88
Andre Dawkins,1.0,2015 - 2015,SG,4,22,1,6,16.666666666666664,1,6,16.666666666666664,0,0,,25.0,0,0,,0,2,2,1,0,0,1,3,3
Spencer Dinwiddie,5.0,2015 - 2019,PG,253,6168,894,2191,40.803286170698314,316,979,32.27783452502553,578,1212,47.68976897689769,48.014605203103606,681,850,80.11764705882352,101,553,654,1146,174,69,386,565,2785
Zoran Dragic,1.0,2015 - 2015,SG,16,75,11,30,36.666666666666664,3,14,21.428571428571427,8,16,50.0,41.66666666666667,3,5,60.0,5,3,8,5,2,0,5,6,28
Larry Drew,2.0,2015 - 2018,PG,22,289,27,82,32.926829268292686,7,35,20.0,20,47,42.5531914893617,37.19512195121951,2,3,66.66666666666666,4,14,18,55,6,0,28,19,63
Cleanthony Early,2.0,2015 - 2016,SF,56,801,88,254,34.645669291338585,26,99,26.262626262626267,62,155,40.0,39.76377952755906,39,52,75.0,26,97,123,42,26,15,49,73,241
James Ennis,5.0,2015 - 2019,SF,278,5715,621,1359,45.6953642384106,214,599,35.72621035058431,407,760,53.55263157894738,53.56880058866814,345,435,79.3103448275862,274,609,883,245,175,82,207,566,1801
Tyler Ennis,4.0,2015 - 2018,PG,186,2336,320,763,41.9397116644823,66,208,31.73076923076923,254,555,45.765765765765764,46.26474442988204,73,95,76.84210526315789,48,202,250,359,98,18,171,233,779
Dante Exum,4.0,2015 - 2019,PG,204,3944,443,1107,40.018066847335135,150,493,30.425963488843816,293,614,47.71986970684039,46.79313459801265,171,222,77.02702702702703,77,280,357,462,84,34,270,382,1207
Tim Frazier,5.0,2015 - 2019,PG,245,4463,464,1127,41.171251109139305,115,350,32.857142857142854,349,777,44.91634491634492,46.273291925465834,225,308,73.05194805194806,125,469,594,999,174,20,324,441,1268
Langston Galloway,5.0,2015 - 2019,PG,339,7593,996,2571,38.739789964994166,469,1306,35.91117917304747,527,1265,41.6600790513834,47.86075457020614,314,393,79.89821882951654,169,728,897,593,247,53,210,576,2775
Aaron Gordon,5.0,2015 - 2019,PF,341,9500,1605,3563,45.04630928992422,368,1146,32.11169284467714,1237,2417,51.179147703765,50.210496772382825,671,949,70.70600632244468,532,1580,2112,736,261,218,462,691,4249
Drew Gordon,1.0,2015 - 2015,PF,9,71,8,19,42.10526315789473,0,3,0.0,8,16,50.0,42.10526315789473,1,2,50.0,7,11,18,2,1,0,8,7,17
Jerami Grant,5.0,2015 - 2019,PF,383,9233,1180,2558,46.129788897576226,274,821,33.37393422655298,906,1737,52.15889464594128,51.48553557466771,735,1123,65.44968833481745,368,1132,1500,396,219,451,360,877,3369
Erick Green,2.0,2015 - 2016,PG,52,452,66,175,37.714285714285715,15,52,28.846153846153843,51,123,41.46341463414634,42.0,12,14,85.71428571428571,10,27,37,42,13,0,14,30,159
JaMychal Green,5.0,2015 - 2019,PF,299,6624,960,2006,47.85643070787637,184,499,36.87374749498998,776,1507,51.49303251493033,52.44267198404786,405,526,76.99619771863118,576,1259,1835,284,175,131,354,808,2509
P.J. Hairston,2.0,2015 - 2016,SG,111,2000,232,677,34.26883308714919,119,404,29.455445544554454,113,273,41.39194139194139,43.057607090103396,81,100,81.0,47,219,266,59,53,24,63,198,664
Gary Harris,5.0,2015 - 2019,SG,312,8883,1455,3164,45.986093552465235,471,1291,36.48334624322231,984,1873,52.53603844100374,53.429203539823014,497,620,80.16129032258064,201,597,798,661,384,67,399,538,3878
Joe Harris,5.0,2015 - 2019,SG,262,5914,882,1855,47.54716981132076,450,1053,42.73504273504273,432,802,53.86533665835411,59.67654986522911,240,301,79.734219269103,126,616,742,391,110,47,295,519,2454
Rodney Hood,5.0,2015 - 2019,SG,320,8707,1449,3434,42.19569015725102,548,1495,36.65551839464883,901,1939,46.46725116039195,50.17472335468841,571,679,84.09425625920471,110,798,908,613,245,63,360,704,4017
Joe Ingles,5.0,2015 - 2019,SF,406,10032,1169,2616,44.686544342507645,669,1638,40.84249084249084,500,978,51.124744376278116,57.473241590214066,246,332,74.09638554216868,123,1138,1261,1364,411,62,622,743,3253
Cory Jefferson,2.0,2015 - 2016,PF,58,581,84,189,44.44444444444444,2,16,12.5,82,173,47.398843930635834,44.97354497354497,35,60,58.333333333333336,53,108,161,16,10,22,20,69,205
Grant Jerrett,1.0,2015 - 2015,PF,8,51,7,26,26.923076923076923,1,15,6.666666666666667,6,11,54.54545454545454,28.846153846153843,1,1,100.0,2,7,9,3,2,2,3,11,16
Nick Johnson,1.0,2015 - 2015,SG,28,262,26,75,34.66666666666667,5,21,23.809523809523807,21,54,38.88888888888889,38.0,17,25,68.0,13,26,39,11,7,3,19,34,74
Tyler Johnson,5.0,2015 - 2019,PG,270,7225,1071,2471,43.342776203966004,347,953,36.41133263378804,724,1518,47.69433465085639,50.36422501011736,479,621,77.13365539452496,160,744,904,685,255,128,325,529,2968
Sean Kilpatrick,4.0,2015 - 2018,SG,157,3082,545,1319,41.31918119787718,194,579,33.506044905008636,351,740,47.43243243243243,48.6732373009856,332,385,86.23376623376623,40,389,429,236,73,13,206,191,1616
Alex Kirk,1.0,2015 - 2015,C,5,14,1,4,25.0,0,0,,1,4,25.0,25.0,2,2,100.0,1,0,1,1,0,0,0,1,4
Joffrey Lauvergne,4.0,2015 - 2018,C,208,2823,477,995,47.93969849246231,49,172,28.488372093023255,428,823,52.0048602673147,50.402010050251256,156,217,71.88940092165899,239,550,789,180,55,34,165,286,1159
Zach LaVine,5.0,2015 - 2019,SG,293,8772,1711,3836,44.60375391032325,462,1237,37.348423605497175,1249,2599,48.05694497883801,50.62565172054223,826,1002,82.43512974051896,122,868,990,1021,248,67,691,650,4710
Kalin Lucas,2.0,2015 - 2019,PG,2,12,0,2,0.0,0,1,0.0,0,1,0.0,0.0,2,2,100.0,0,3,3,1,1,0,0,2,2
Devyn Marble,2.0,2015 - 2016,SG,44,457,35,115,30.434782608695656,12,54,22.22222222222222,23,61,37.704918032786885,35.65217391304348,15,40,37.5,11,58,69,29,22,3,16,39,97
James Michael McAdoo,4.0,2015 - 2018,PF,111,874,133,252,52.77777777777778,5,17,29.411764705882355,128,235,54.46808510638298,53.769841269841265,63,118,53.38983050847458,79,109,188,37,33,47,42,108,334
K.J. McDaniels,3.0,2015 - 2017,SF,148,2092,278,675,41.18518518518518,70,241,29.045643153526974,208,434,47.926267281105986,46.370370370370374,156,201,77.61194029850746,96,228,324,95,70,94,151,205,782
Doug McDermott,5.0,2015 - 2019,SF,341,6798,1000,2178,45.91368227731864,376,930,40.43010752688172,624,1248,50.0,54.54545454545454,283,343,82.5072886297376,120,606,726,269,68,36,206,461,2659
Mitch McGary,2.0,2015 - 2016,PF,52,557,99,188,52.659574468085104,0,6,0.0,99,182,54.395604395604394,52.659574468085104,29,50,57.99999999999999,57,126,183,17,17,18,38,82,227
Jerel McNeal,1.0,2015 - 2015,PG,6,36,3,11,27.27272727272727,1,2,50.0,2,9,22.22222222222222,31.818181818181817,2,2,100.0,0,3,3,2,3,1,5,5,9
Elijah Millsap,3.0,2015 - 2017,SG,69,1120,93,284,32.74647887323944,29,104,27.884615384615387,64,180,35.55555555555556,37.852112676056336,72,106,67.9245283018868,37,154,191,78,63,19,78,159,287
Nikola Mirotic,5.0,2015 - 2019,PF,319,7718,1303,3084,42.25032425421531,614,1712,35.86448598130841,689,1372,50.218658892128275,52.20492866407264,690,854,80.79625292740047,301,1593,1894,407,240,228,381,666,3910
Eric Moreland,4.0,2015 - 2019,PF,83,898,73,136,53.67647058823529,1,1,100.0,72,135,53.333333333333336,54.04411764705882,13,33,39.39393939393939,88,222,310,83,32,56,50,130,160
Shabazz Napier,5.0,2015 - 2019,PG,289,4642,620,1578,39.29024081115336,269,760,35.39473684210526,351,818,42.909535452322736,47.81368821292776,346,426,81.2206572769953,78,421,499,587,217,37,324,303,1855
Nerlens Noel,5.0,2015 - 2019,C,300,6850,1009,1930,52.27979274611398,1,4,25.0,1008,1926,52.336448598130836,52.30569948186529,426,675,63.11111111111111,607,1333,1940,365,413,410,429,751,2445
Lucas Nogueira,4.0,2015 - 2018,C,141,1754,182,288,63.19444444444444,9,34,26.47058823529412,173,254,68.11023622047244,64.75694444444444,73,114,64.03508771929825,120,268,388,72,89,144,75,221,446
Jusuf Nurkic,5.0,2015 - 2019,C,310,7103,1443,2936,49.14850136239782,3,42,7.142857142857142,1440,2894,49.7581202487906,49.199591280653955,719,1079,66.63577386468953,776,1704,2480,589,261,400,635,956,3608
Johnny O'Bryant,4.0,2015 - 2018,PF,147,1684,213,530,40.18867924528302,18,50,36.0,195,480,40.625,41.88679245283019,65,98,66.3265306122449,129,223,352,69,32,19,77,199,509
Kostas Papanikolaou,2.0,2015 - 2016,SF,69,1089,93,263,35.361216730038024,41,138,29.71014492753623,52,125,41.6,43.155893536121674,22,32,68.75,47,111,158,101,42,18,76,95,249
Jabari Parker,5.0,2015 - 2019,PF,247,7341,1500,3057,49.06771344455348,170,505,33.663366336633665,1330,2552,52.11598746081505,51.84821720641152,554,750,73.86666666666667,373,1046,1419,525,221,96,452,502,3724
Adreian Payne,4.0,2015 - 2018,PF,107,1403,174,429,40.55944055944056,15,59,25.423728813559322,159,370,42.972972972972975,42.30769230769231,66,97,68.04123711340206,79,236,315,66,45,27,90,203,429
Elfrid Payton,5.0,2015 - 2019,PG,342,10104,1557,3429,45.40682414698163,144,477,30.18867924528302,1413,2952,47.86585365853659,47.506561679790025,540,857,63.010501750291716,386,1105,1491,2243,446,119,838,757,3798
Dwight Powell,5.0,2015 - 2019,C,331,5895,916,1656,55.31400966183575,93,312,29.807692307692307,823,1344,61.235119047619044,58.1219806763285,566,755,74.96688741721854,470,1014,1484,305,217,151,211,680,2491
Julius Randle,5.0,2015 - 2019,PF,311,8854,1811,3604,50.249722530521645,104,339,30.678466076696164,1707,3265,52.28177641653905,51.692563817980016,1058,1466,72.16916780354707,665,2088,2753,847,197,156,744,1011,4784
Damjan Rudez,3.0,2015 - 2017,SF,146,1638,175,413,42.3728813559322,106,284,37.32394366197183,69,129,53.48837209302325,55.205811138014525,24,31,77.41935483870968,18,74,92,84,31,7,69,143,480
JaKarr Sampson,4.0,2015 - 2019,SF,173,2762,359,798,44.987468671679196,55,214,25.70093457943925,304,584,52.054794520547944,48.43358395989975,170,253,67.19367588932806,107,356,463,136,73,84,158,333,943
Marcus Smart,5.0,2015 - 2019,SG,341,9688,1056,2837,37.22241804723299,447,1440,31.041666666666668,609,1397,43.59341445955619,45.100458230525206,615,805,76.3975155279503,315,890,1205,1337,529,121,581,885,3174
Russ Smith,2.0,2015 - 2016,PG,27,131,15,47,31.914893617021278,3,16,18.75,12,31,38.70967741935484,35.1063829787234,20,26,76.92307692307693,2,13,15,19,8,1,19,18,53
Nik Stauskas,5.0,2015 - 2019,SG,335,6662,765,1967,38.891713268937465,396,1121,35.325602140945584,369,846,43.61702127659575,48.95780376207423,346,425,81.41176470588235,77,611,688,513,139,80,339,425,2272
David Stockton,2.0,2015 - 2018,PG,6,42,4,9,44.44444444444444,3,5,60.0,1,4,25.0,61.111111111111114,7,10,70.0,0,2,2,9,2,0,5,4,18
Jarnell Stokes,3.0,2015 - 2017,C,28,151,25,43,58.139534883720934,0,0,,25,43,58.139534883720934,58.139534883720934,17,32,53.125,18,22,40,7,7,5,7,29,67
Noah Vonleh,5.0,2015 - 2019,PF,299,5295,588,1298,45.300462249614796,89,282,31.560283687943265,499,1016,49.11417322834646,48.728813559322035,263,385,68.31168831168831,433,1184,1617,228,126,130,244,568,1528
T.J. Warren,5.0,2015 - 2019,SF,261,7234,1563,3143,49.72955774737512,156,459,33.98692810457516,1407,2684,52.42175856929955,52.21126312440344,472,616,76.62337662337663,379,699,1078,293,247,134,253,588,3754
David Wear,1.0,2015 - 2015,PF,2,7,0,2,0.0,0,1,0.0,0,1,0.0,0.0,0,0,,2,0,2,1,0,0,0,1,0
Travis Wear,2.0,2015 - 2018,SF,68,900,109,281,38.79003558718861,28,77,36.36363636363637,81,204,39.705882352941174,43.77224199288256,28,34,82.35294117647058,31,113,144,47,19,16,41,85,274
Shayne Whittington,2.0,2015 - 2016,PF,27,149,24,53,45.28301886792453,1,8,12.5,23,45,51.11111111111111,46.22641509433962,19,25,76.0,15,26,41,9,6,3,10,25,68
Andrew Wiggins,5.0,2015 - 2019,SF,400,14384,2867,6510,44.03993855606759,429,1291,33.23005422153369,2438,5219,46.713929871622916,47.334869431643625,1605,2183,73.52267521759047,506,1197,1703,867,407,225,822,854,7768
C.J. Wilcox,3.0,2015 - 2017,SG,66,376,50,135,37.03703703703704,19,57,33.33333333333333,31,78,39.743589743589745,44.074074074074076,13,16,81.25,6,25,31,30,15,4,18,30,132
James Young,4.0,2015 - 2018,SG,95,812,77,210,36.666666666666664,38,137,27.73722627737226,39,73,53.42465753424658,45.714285714285715,27,48,56.25,19,77,96,28,24,5,15,58,219
Cliff Alexander,1.0,2016 - 2016,PF,8,36,5,10,50.0,0,0,,5,10,50.0,50.0,0,0,,2,4,6,0,1,2,1,1,10
Justin Anderson,4.0,2016 - 2019,SF,216,2857,408,973,41.93216855087359,138,457,30.196936542669583,270,516,52.32558139534884,49.023638232271324,200,257,77.82101167315176,136,418,554,143,97,68,129,256,1154
Thanasis Antetokounmpo,1.0,2016 - 2016,SF,2,6,3,4,75.0,0,1,0.0,3,3,100.0,75.0,0,0,,0,1,1,0,0,0,0,2,6
Keith Appling,1.0,2016 - 2016,PG,5,27,2,8,25.0,0,3,0.0,2,5,40.0,25.0,2,2,100.0,0,1,1,1,1,0,3,5,6
Nemanja Bjelica,4.0,2016 - 2019,PF,269,5424,716,1555,46.045016077170416,283,742,38.14016172506739,433,813,53.25953259532595,55.14469453376206,191,253,75.49407114624506,284,888,1172,395,170,113,240,646,1906
Devin Booker,4.0,2016 - 2019,SG,272,8945,2014,4607,43.716084219665724,528,1492,35.388739946380696,1486,3115,47.70465489566613,49.44649446494465,1264,1480,85.4054054054054,138,807,945,1154,219,68,859,835,5820
Anthony Brown,3.0,2016 - 2018,SF,41,762,58,177,32.7683615819209,28,98,28.57142857142857,30,79,37.9746835443038,40.67796610169492,17,20,85.0,17,86,103,28,19,6,21,49,161
Willie Cauley-Stein,4.0,2016 - 2019,C,295,7090,1246,2334,53.384747215081404,4,18,22.22222222222222,1242,2316,53.626943005181346,53.470437017994854,475,777,61.132561132561136,531,1348,1879,483,274,228,308,705,2971
Rakeem Christmas,2.0,2016 - 2017,PF,30,225,21,45,46.666666666666664,0,0,,21,45,46.666666666666664,46.666666666666664,21,29,72.41379310344827,27,30,57,4,3,6,8,38,63
Coty Clarke,1.0,2016 - 2016,SF,3,6,2,4,50.0,2,2,100.0,0,2,0.0,75.0,0,0,,0,1,1,0,0,0,1,0,6
Pat Connaughton,4.0,2016 - 2019,SG,216,3208,378,861,43.90243902439025,162,464,34.91379310344828,216,397,54.40806045340051,53.31010452961672,78,98,79.59183673469387,118,385,503,251,64,49,103,230,996
Branden Dawson,1.0,2016 - 2016,PF,6,29,2,5,40.0,0,0,,2,5,40.0,40.0,1,1,100.0,2,2,4,0,0,1,0,2,5
Bryce Dejean-Jones,1.0,2016 - 2016,SG,14,279,28,69,40.57971014492754,12,32,37.5,16,37,43.24324324324324,49.275362318840585,11,21,52.38095238095239,8,40,48,15,10,2,11,17,79
Sam Dekker,4.0,2016 - 2019,PF,200,3096,451,944,47.77542372881356,89,309,28.802588996763756,362,635,57.00787401574803,52.48940677966102,103,170,60.588235294117645,191,416,607,160,101,37,98,201,1094
Duje Dukan,1.0,2016 - 2016,SF,1,24,2,10,20.0,2,5,40.0,0,5,0.0,30.0,0,0,,2,2,4,1,1,0,0,2,6
Jarell Eddie,3.0,2016 - 2018,SF,34,218,26,86,30.23255813953488,19,65,29.230769230769234,7,21,33.33333333333333,41.27906976744186,16,17,94.11764705882352,3,28,31,5,7,1,2,6,87
Cristiano Felicio,4.0,2016 - 2019,C,212,3084,390,687,56.76855895196506,0,10,0.0,390,677,57.60709010339734,56.76855895196506,189,282,67.02127659574468,316,548,864,158,58,48,133,314,969
Jerian Grant,4.0,2016 - 2019,PG,273,4918,583,1415,41.20141342756184,172,531,32.39171374764595,411,884,46.49321266968326,47.2791519434629,327,424,77.12264150943396,90,434,524,796,204,32,271,400,1665
Montrezl Harrell,4.0,2016 - 2019,C,255,4894,1177,1871,62.907536076964185,5,32,15.625,1172,1839,63.73028820010875,63.04115446285409,505,803,62.889165628891654,393,732,1125,317,138,215,261,572,2864
Aaron Harrison,3.0,2016 - 2018,SG,35,343,24,92,26.08695652173913,12,55,21.818181818181817,12,37,32.432432432432435,32.608695652173914,19,31,61.29032258064516,8,34,42,16,15,2,7,39,79
Mario Hezonja,4.0,2016 - 2019,SF,277,5236,762,1829,41.66211044286495,242,755,32.05298013245033,520,1074,48.4171322160149,48.27774740295243,262,323,81.11455108359134,117,725,842,365,207,71,329,442,2028
Darrun Hilliard,3.0,2016 - 2018,SG,91,859,104,276,37.68115942028986,31,102,30.392156862745097,73,174,41.95402298850575,43.29710144927536,56,75,74.66666666666667,7,78,85,71,22,3,51,74,295
Rondae Hollis-Jefferson,4.0,2016 - 2019,SF,234,5530,840,1891,44.420941300898996,41,184,22.282608695652172,799,1707,46.80726420620972,45.50502379693284,594,804,73.88059701492537,319,1056,1375,460,230,135,331,490,2315
Richaun Holmes,4.0,2016 - 2019,C,226,3825,701,1240,56.53225806451613,39,152,25.657894736842106,662,1088,60.845588235294116,58.10483870967742,288,408,70.58823529411765,328,660,988,212,123,203,164,519,1729
Marcelo Huertas,2.0,2016 - 2017,PG,76,1106,122,298,40.939597315436245,20,80,25.0,102,218,46.788990825688074,44.29530201342282,36,46,78.26086956521739,20,94,114,234,36,9,99,92,300
Josh Huestis,3.0,2016 - 2018,PF,76,1068,71,205,34.63414634146341,39,125,31.2,32,80,40.0,44.146341463414636,6,25,24.0,48,132,180,23,16,48,29,85,187
R.J. Hunter,4.0,2016 - 2019,SG,45,395,49,132,37.121212121212125,26,88,29.545454545454547,23,44,52.27272727272727,46.96969696969697,9,11,81.81818181818183,3,43,46,19,18,4,13,39,133
Damien Inglis,1.0,2016 - 2016,SF,20,156,13,37,35.13513513513514,3,13,23.076923076923077,10,24,41.66666666666667,39.189189189189186,7,8,87.5,2,29,31,10,6,3,11,11,36
Stanley Johnson,4.0,2016 - 2019,SF,285,6160,735,1965,37.404580152671755,237,808,29.33168316831683,498,1157,43.04235090751944,43.4351145038168,278,364,76.37362637362637,161,803,964,423,266,64,343,582,1985
Nikola Jokic,4.0,2016 - 2019,C,308,8718,1921,3670,52.3433242506812,267,773,34.54075032341527,1654,2897,57.093545046599935,55.980926430517705,897,1083,82.82548476454294,816,2130,2946,1586,338,221,733,862,5006
Tyus Jones,4.0,2016 - 2019,PG,247,4374,466,1111,41.94419441944194,127,381,33.33333333333333,339,730,46.438356164383556,47.65976597659766,190,232,81.89655172413794,56,324,380,823,255,19,177,271,1249
Frank Kaminsky,4.0,2016 - 2019,C,282,6252,980,2341,41.862451943613834,338,969,34.88132094943241,642,1372,46.79300291545189,49.08158906450235,460,605,76.03305785123968,211,911,1122,452,132,108,241,428,2758
Sasha Kaun,1.0,2016 - 2016,C,25,95,9,17,52.94117647058824,0,0,,9,17,52.94117647058824,52.94117647058824,5,11,45.45454545454545,12,14,26,3,4,5,7,11,23
Kevon Looney,4.0,2016 - 2019,C,204,2859,389,654,59.48012232415903,5,26,19.230769230769234,384,628,61.146496815286625,59.862385321100916,128,216,59.25925925925925,325,441,766,194,95,126,100,383,911
Trey Lyles,4.0,2016 - 2019,PF,288,5051,827,1920,43.072916666666664,248,750,33.06666666666666,579,1170,49.48717948717949,49.53125,296,420,70.47619047619048,206,921,1127,306,112,95,258,415,2198
Boban Marjanovic,4.0,2016 - 2019,C,186,1819,416,714,58.26330532212886,4,10,40.0,412,704,58.52272727272727,58.543417366946784,309,400,77.25,254,479,733,106,44,73,134,220,1145
Jarell Martin,4.0,2016 - 2019,PF,184,2927,376,867,43.3679354094579,63,182,34.61538461538461,313,685,45.69343065693431,47.00115340253749,183,239,76.56903765690377,189,450,639,114,67,73,144,411,998
T.J. McConnell,4.0,2016 - 2019,PG,314,6915,884,1816,48.6784140969163,83,248,33.46774193548387,801,1568,51.08418367346938,50.9636563876652,159,207,76.81159420289855,147,754,901,1462,400,50,502,480,2010
Chris McCullough,3.0,2016 - 2018,PF,59,532,78,183,42.62295081967213,15,49,30.612244897959183,63,134,47.01492537313433,46.72131147540984,23,42,54.761904761904766,41,71,112,15,30,19,20,54,194
Jordan McRae,3.0,2016 - 2019,SG,86,912,153,358,42.737430167597765,38,108,35.18518518518518,115,250,46.0,48.04469273743017,76,97,78.35051546391753,16,85,101,74,24,14,44,74,420
Salah Mejri,4.0,2016 - 2019,C,204,2430,280,464,60.3448275862069,12,41,29.268292682926827,268,423,63.35697399527187,61.63793103448276,121,205,59.02439024390244,259,549,808,94,72,190,123,382,693
Jordan Mickey,3.0,2016 - 2018,PF,64,482,62,138,44.927536231884055,2,17,11.76470588235294,60,121,49.586776859504134,45.65217391304348,26,43,60.46511627906976,37,91,128,17,9,27,28,53,152
Luis Montero,2.0,2016 - 2018,SG,14,50,5,20,25.0,1,9,11.11111111111111,4,11,36.36363636363637,27.500000000000004,3,4,75.0,0,6,6,1,0,0,6,1,14
Emmanuel Mudiay,4.0,2016 - 2019,PG,246,6326,1071,2722,39.3460690668626,246,768,32.03125,825,1954,42.22108495394063,43.86480529022778,513,691,74.24023154848047,120,638,758,1023,190,78,593,419,2901
Xavier Munford,2.0,2016 - 2018,SG,20,265,33,83,39.75903614457831,9,25,36.0,24,58,41.37931034482759,45.18072289156627,8,16,50.0,4,28,32,26,14,3,17,29,83
Larry Nance,4.0,2016 - 2019,C,259,5924,837,1553,53.89568576947843,46,156,29.48717948717949,791,1397,56.621331424481035,55.37669027688346,278,398,69.84924623115577,550,1135,1685,436,324,140,245,637,1998
Raul Neto,4.0,2016 - 2019,PG,199,2817,364,821,44.33617539585871,113,300,37.666666666666664,251,521,48.17658349328215,51.21802679658952,114,147,77.55102040816327,34,227,261,376,110,15,195,257,955
J.J. O'Brien,1.0,2016 - 2016,SF,2,6,0,1,0.0,0,0,,0,1,0.0,0.0,0,0,,0,1,1,0,1,0,0,1,0
Jahlil Okafor,4.0,2016 - 2019,C,190,4013,928,1752,52.96803652968036,3,15,20.0,925,1737,53.25273459988485,53.05365296803652,319,470,67.87234042553192,306,670,976,175,60,168,288,409,2178
Kelly Oubre,4.0,2016 - 2019,SF,292,6442,969,2285,42.40700218818381,313,974,32.13552361396304,656,1311,50.03813882532418,49.25601750547046,486,625,77.75999999999999,216,866,1082,242,244,118,277,710,2737
Lamar Patterson,2.0,2016 - 2017,SG,40,435,31,95,32.631578947368425,13,55,23.636363636363637,18,40,45.0,39.473684210526315,18,25,72.0,5,52,57,45,10,2,27,51,93
Cameron Payne,4.0,2016 - 2019,PG,153,2454,361,909,39.713971397139716,123,372,33.064516129032256,238,537,44.320297951582866,46.47964796479648,69,89,77.52808988764045,43,231,274,382,104,28,154,240,914
Tibor Pleiss,1.0,2016 - 2016,C,12,82,11,25,44.0,0,2,0.0,11,23,47.82608695652174,44.0,2,2,100.0,6,9,15,2,1,2,8,19,24
Bobby Portis,4.0,2016 - 2019,PF,249,5044,1030,2250,45.77777777777778,203,562,36.120996441281136,827,1688,48.992890995260666,50.28888888888889,284,378,75.13227513227513,466,1068,1534,282,126,76,268,469,2547
Kristaps Porzingis,3.0,2016 - 2018,PF,186,5764,1206,2760,43.69565217391304,283,785,36.05095541401273,923,1975,46.734177215189874,48.822463768115945,617,767,80.4432855280313,305,1012,1317,248,136,378,332,590,3312
Norman Powell,4.0,2016 - 2019,SG,255,4281,667,1509,44.20145791915176,213,618,34.46601941747573,454,891,50.953984287317624,51.25911199469848,263,326,80.67484662576688,72,466,538,309,157,53,233,393,1810
Willie Reed,3.0,2016 - 2018,C,152,1885,319,539,59.183673469387756,2,6,33.33333333333333,317,533,59.47467166979362,59.36920222634509,111,198,56.060606060606055,213,362,575,46,33,99,66,240,751
Josh Richardson,4.0,2016 - 2019,SG,259,7949,1147,2696,42.54451038575668,419,1138,36.81898066783831,728,1558,46.72657252888318,50.315281899109785,421,513,82.06627680311891,179,644,823,742,296,173,353,638,3134
Terry Rozier,4.0,2016 - 2019,PG,272,5433,754,1983,38.02319717599597,335,945,35.44973544973545,419,1038,40.36608863198459,46.469994957135654,247,318,77.67295597484278,159,814,973,631,200,52,214,316,2090
D'Angelo Russell,4.0,2016 - 2019,PG,272,7752,1680,4012,41.874376869391824,589,1667,35.332933413317335,1091,2345,46.524520255863536,49.2148554336989,544,714,76.19047619047619,161,838,999,1381,316,66,772,506,4493
Jonathon Simmons,4.0,2016 - 2019,SG,258,5298,786,1774,44.306651634723785,145,457,31.72866520787746,641,1317,48.6712224753227,48.3934611048478,425,562,75.62277580071174,124,497,621,483,158,61,343,513,2142
Alex Stepheson,1.0,2016 - 2016,PF,8,73,9,27,33.33333333333333,0,0,,9,27,33.33333333333333,33.33333333333333,4,12,33.33333333333333,19,9,28,2,1,5,0,12,22
Edy Tavares,2.0,2016 - 2017,C,13,101,15,24,62.5,0,0,,15,24,62.5,62.5,3,11,27.27272727272727,11,21,32,4,1,12,7,11,33
Axel Toupane,2.0,2016 - 2017,SF,25,352,30,79,37.9746835443038,14,44,31.818181818181817,16,35,45.714285714285715,46.835443037974684,13,17,76.47058823529412,8,24,32,15,8,7,6,46,87
Karl-Anthony Towns,4.0,2016 - 2019,C,323,11120,2747,5119,53.66282477046298,393,1003,39.18245264207378,2354,4116,57.19144800777454,57.50146512990818,1300,1555,83.60128617363344,1026,2805,3831,839,245,481,794,1063,7187
Myles Turner,4.0,2016 - 2019,C,280,7863,1394,2818,49.46770759403832,175,482,36.30705394190871,1219,2336,52.1832191780822,52.57274662881476,641,831,77.13598074608905,401,1468,1869,349,197,575,368,801,3604
Rashad Vaughn,3.0,2016 - 2018,SG,139,1671,161,478,33.68200836820084,83,265,31.32075471698113,78,213,36.61971830985916,42.36401673640167,18,26,69.23076923076923,18,140,158,75,53,29,48,120,423
Briante Weber,3.0,2016 - 2018,PG,45,611,58,142,40.845070422535215,5,26,19.230769230769234,53,116,45.689655172413794,42.6056338028169,22,30,73.33333333333333,24,62,86,64,39,9,32,56,143
Alan Williams,4.0,2016 - 2019,PF,67,872,163,322,50.621118012422365,0,2,0.0,163,320,50.9375,50.621118012422365,87,139,62.589928057553955,115,256,371,39,37,38,51,155,413
Justise Winslow,4.0,2016 - 2019,SF,230,6496,806,1924,41.891891891891895,184,536,34.32835820895522,622,1388,44.81268011527377,46.67359667359668,261,405,64.44444444444444,231,991,1222,613,220,84,347,553,2057
Christian Wood,3.0,2016 - 2019,PF,51,503,95,193,49.22279792746114,13,42,30.952380952380953,82,151,54.3046357615894,52.59067357512953,65,92,70.65217391304348,44,106,150,13,15,23,26,39,268
Delon Wright,4.0,2016 - 2019,PG,198,3807,528,1186,44.51939291736931,121,364,33.24175824175824,407,822,49.51338199513382,49.620573355817875,284,357,79.55182072829132,137,412,549,536,195,77,196,222,1461
Joe Young,3.0,2016 - 2018,PG,127,1077,168,427,39.34426229508197,40,135,29.629629629629626,128,292,43.83561643835616,44.02810304449648,53,69,76.81159420289855,19,111,130,119,33,1,64,74,429
Alex Abrines,3.0,2017 - 2019,SG,174,2777,305,789,38.656527249683144,219,595,36.806722689075634,86,194,44.329896907216494,52.53485424588086,95,108,87.96296296296296,49,199,248,88,92,22,72,291,924
Ron Baker,3.0,2017 - 2019,SG,96,1394,106,296,35.810810810810814,35,132,26.515151515151516,71,164,43.292682926829265,41.72297297297297,53,75,70.66666666666667,18,121,139,169,66,15,79,125,300
Wade Baldwin,3.0,2017 - 2019,PG,56,579,60,169,35.50295857988166,9,36,25.0,51,133,38.34586466165413,38.16568047337278,45,58,77.58620689655173,14,55,69,78,21,10,57,63,174
Malik Beasley,3.0,2017 - 2019,SG,165,2627,455,988,46.05263157894737,200,515,38.83495145631068,255,473,53.911205073995774,56.174089068825914,86,109,78.89908256880734,54,234,288,139,77,17,87,162,1196
DeAndre' Bembry,3.0,2017 - 2019,SF,146,2757,375,842,44.53681710213777,62,221,28.054298642533936,313,621,50.40257648953301,48.218527315914486,112,185,60.54054054054055,76,413,489,279,134,58,205,249,924
Dragan Bender,3.0,2017 - 2019,PF,171,3469,332,842,39.42992874109264,168,524,32.06106870229007,164,318,51.57232704402516,49.4061757719715,75,116,64.65517241379311,97,550,647,209,50,97,181,330,907
Ben Bentil,1.0,2017 - 2017,PF,3,10,0,3,0.0,0,1,0.0,0,2,0.0,0.0,0,0,,0,2,2,0,0,0,1,1,0
Davis Bertans,3.0,2017 - 2019,PF,220,3526,468,1053,44.44444444444444,308,763,40.36697247706422,160,290,55.172413793103445,59.06932573599241,121,143,84.61538461538461,63,452,515,220,81,89,111,301,1365
Joel Bolomboy,2.0,2017 - 2018,PF,18,91,12,22,54.54545454545454,1,5,20.0,11,17,64.70588235294117,56.81818181818182,6,12,50.0,10,17,27,2,3,2,4,4,31
Malcolm Brogdon,3.0,2017 - 2019,SG,187,5250,912,1886,48.35630965005302,244,598,40.802675585284284,668,1288,51.86335403726709,54.82502651113468,325,363,89.53168044077135,135,522,657,674,171,38,270,370,2393
Jaylen Brown,3.0,2017 - 2019,SG,222,5406,933,2018,46.23389494549058,262,717,36.541143654114364,671,1301,51.575710991544966,52.72547076313181,368,559,65.83184257602862,176,703,879,278,174,76,291,509,2496
Nicolas Brussino,2.0,2017 - 2018,SG,58,531,52,143,36.36363636363637,29,97,29.896907216494846,23,46,50.0,46.50349650349651,17,22,77.27272727272727,26,72,98,47,17,8,26,43,150
Marquese Chriss,3.0,2017 - 2019,PF,197,3769,553,1289,42.901474010861136,144,486,29.629629629629626,409,803,50.93399750933998,48.48719937936385,241,384,62.760416666666664,212,673,885,165,135,151,251,549,1491
Semaj Christon,1.0,2017 - 2017,PG,64,973,77,223,34.52914798206278,12,63,19.047619047619047,65,160,40.625,37.219730941704036,17,31,54.83870967741935,19,68,87,130,28,7,43,79,183
Quinn Cook,3.0,2017 - 2019,PG,121,1987,359,757,47.42404227212681,138,330,41.81818181818181,221,427,51.75644028103045,56.53896961690885,44,56,78.57142857142857,33,213,246,231,36,4,95,164,900
Deyonta Davis,3.0,2017 - 2019,C,107,1299,200,334,59.88023952095808,0,1,0.0,200,333,60.06006006006006,59.88023952095808,54,85,63.52941176470588,105,241,346,47,21,61,43,177,454
Malcolm Delaney,2.0,2017 - 2018,PG,127,2262,254,673,37.74145616641902,72,234,30.76923076923077,182,439,41.45785876993166,43.09063893016345,149,185,80.54054054054053,19,204,223,356,74,7,161,194,729
Cheick Diallo,3.0,2017 - 2019,PF,133,1676,306,523,58.508604206500955,1,4,25.0,305,519,58.76685934489403,58.604206500956025,115,154,74.67532467532467,145,471,616,56,44,61,84,212,728
Kris Dunn,3.0,2017 - 2019,PG,176,4247,619,1485,41.68350168350168,98,303,32.34323432343234,521,1182,44.077834179357026,44.98316498316498,175,242,72.31404958677686,67,507,574,775,250,84,343,518,1511
Henry Ellenson,3.0,2017 - 2019,PF,76,734,115,305,37.704918032786885,47,133,35.338345864661655,68,172,39.53488372093023,45.40983606557377,48,62,77.41935483870968,23,165,188,43,13,3,41,55,325
Joel Embiid,3.0,2017 - 2019,C,158,4852,1290,2684,48.06259314456035,181,575,31.478260869565215,1109,2109,52.5841631104789,51.434426229508205,1072,1360,78.82352941176471,364,1440,1804,499,113,309,577,532,3833
Kay Felder,2.0,2017 - 2018,PG,58,526,83,228,36.40350877192983,11,41,26.82926829268293,72,187,38.50267379679144,38.81578947368421,46,61,75.40983606557377,6,53,59,78,21,8,46,49,223
Yogi Ferrell,3.0,2017 - 2019,PG,199,4546,624,1476,42.27642276422765,256,684,37.42690058479532,368,792,46.464646464646464,50.94850948509485,216,259,83.3976833976834,59,410,469,510,142,22,188,307,1720
Dorian Finney-Smith,3.0,2017 - 2019,PF,183,4075,398,982,40.52953156822811,155,512,30.2734375,243,470,51.70212765957447,48.42158859470469,130,179,72.62569832402235,215,471,686,188,131,65,140,354,1081
Bryn Forbes,3.0,2017 - 2019,SG,198,4095,606,1387,43.691420331651045,282,694,40.63400576368876,324,693,46.75324675324675,53.857245854361935,122,156,78.2051282051282,32,340,372,278,74,6,128,287,1616
Patricio Garino,1.0,2017 - 2017,SG,5,43,0,7,0.0,0,5,0.0,0,2,0.0,0.0,0,0,,1,6,7,0,0,0,3,4,0
Michael Gbinije,1.0,2017 - 2017,SG,9,32,1,10,10.0,0,4,0.0,1,6,16.666666666666664,10.0,2,2,100.0,2,1,3,2,0,0,0,2,4
Marcus Georges-Hunt,2.0,2017 - 2018,SG,47,272,23,55,41.81818181818181,5,17,29.411764705882355,18,38,47.368421052631575,46.36363636363636,22,31,70.96774193548387,8,17,25,10,7,0,5,37,73
Jonathan Gibson,2.0,2017 - 2018,PG,21,271,49,118,41.52542372881356,21,57,36.84210526315789,28,61,45.90163934426229,50.42372881355932,21,29,72.41379310344827,1,24,25,30,8,0,24,26,140
Treveon Graham,3.0,2017 - 2019,SG,125,1954,179,452,39.60176991150443,87,240,36.25,92,212,43.39622641509434,49.22566371681416,69,96,71.875,70,180,250,99,52,10,47,195,514
A.J. Hammons,1.0,2017 - 2017,C,22,163,17,42,40.476190476190474,5,10,50.0,12,32,37.5,46.42857142857143,9,20,45.0,8,28,36,4,1,13,10,21,48
Andrew Harrison,3.0,2017 - 2019,PG,145,2987,314,842,37.29216152019003,95,323,29.411764705882355,219,519,42.19653179190752,42.933491686460805,289,371,77.89757412398922,52,235,287,399,95,49,178,366,1012
Juan Hernangomez,3.0,2017 - 2019,PF,157,2477,268,613,43.719412724306686,126,344,36.627906976744185,142,269,52.78810408921933,53.996737357259384,133,174,76.4367816091954,125,381,506,96,63,39,77,181,795
Willy Hernangomez,3.0,2017 - 2019,C,178,2631,490,924,53.03030303030303,24,66,36.36363636363637,466,858,54.312354312354316,54.32900432900433,250,359,69.63788300835655,348,648,996,189,75,72,193,312,1254
Buddy Hield,3.0,2017 - 2019,SG,244,6527,1366,3060,44.640522875817,602,1438,41.863699582753824,764,1622,47.1023427866831,54.47712418300653,306,350,87.42857142857143,196,792,988,481,181,64,371,465,3640
Danuel House,3.0,2017 - 2019,SG,63,1383,174,381,45.66929133858268,89,236,37.71186440677966,85,145,58.620689655172406,57.3490813648294,81,102,79.41176470588235,38,179,217,65,28,17,46,103,518
Brandon Ingram,3.0,2017 - 2019,SF,190,6014,996,2176,45.77205882352941,127,386,32.90155440414508,869,1790,48.547486033519554,48.690257352941174,520,785,66.2420382165605,158,739,897,550,123,110,394,470,2639
Demetrius Jackson,3.0,2017 - 2019,PG,26,136,18,37,48.64864864864865,4,14,28.57142857142857,14,23,60.86956521739131,54.054054054054056,8,12,66.66666666666666,9,10,19,17,7,1,11,11,48
Pierre Jackson,1.0,2017 - 2017,PG,8,84,13,39,33.33333333333333,3,11,27.27272727272727,10,28,35.714285714285715,37.17948717948718,6,7,85.71428571428571,1,8,9,19,2,0,3,5,35
Brice Johnson,2.0,2017 - 2018,PF,21,107,22,49,44.89795918367347,0,1,0.0,22,48,45.83333333333333,44.89795918367347,3,5,60.0,10,24,34,3,11,7,6,13,47
Damian Jones,3.0,2017 - 2019,C,49,584,72,112,64.28571428571429,0,0,,72,112,64.28571428571429,64.28571428571429,30,52,57.692307692307686,45,67,112,30,14,32,26,92,174
Derrick Jones,3.0,2017 - 2019,SF,112,1943,249,498,50.0,34,120,28.333333333333332,215,378,56.87830687830689,53.41365461847389,119,187,63.63636363636363,156,201,357,58,64,68,63,210,651
Mindaugas Kuzminskas,2.0,2017 - 2018,SF,69,1018,158,371,42.58760107816711,54,168,32.142857142857146,104,203,51.231527093596064,49.865229110512125,55,68,80.88235294117648,47,79,126,69,29,11,51,79,425
Skal Labissiere,3.0,2017 - 2019,PF,115,2028,348,725,48.0,27,72,37.5,321,653,49.15773353751914,49.862068965517246,156,209,74.64114832535886,159,334,493,110,46,68,121,225,879
Nicolas Laprovittola,1.0,2017 - 2017,PG,18,174,20,47,42.5531914893617,10,27,37.03703703703704,10,20,50.0,53.191489361702125,9,9,100.0,1,9,10,28,4,1,19,19,59
Jake Layman,3.0,2017 - 2019,SF,141,1736,256,560,45.714285714285715,76,252,30.158730158730158,180,308,58.44155844155844,52.5,65,91,71.42857142857143,66,191,257,75,46,37,62,151,653
Caris LeVert,3.0,2017 - 2019,SF,168,4164,698,1598,43.67959949937422,192,583,32.933104631217844,506,1015,49.85221674876848,49.68710888610764,285,403,70.71960297766749,111,488,599,565,173,44,281,327,1873
Shawn Long,1.0,2017 - 2017,C,18,234,61,109,55.96330275229357,7,19,36.84210526315789,54,90,60.0,59.174311926605505,19,35,54.285714285714285,41,44,85,13,9,9,13,49,148
Timothe Luwawu-Cabarrot,3.0,2017 - 2019,SF,171,2666,327,846,38.652482269503544,139,435,31.95402298850575,188,411,45.742092457420924,46.867612293144205,182,222,81.98198198198197,50,268,318,155,63,23,132,324,975
Sheldon Mac,1.0,2017 - 2017,SG,30,287,30,75,40.0,7,30,23.333333333333332,23,45,51.11111111111111,44.666666666666664,23,27,85.18518518518519,4,30,34,15,8,2,5,17,90
Thon Maker,3.0,2017 - 2019,C,195,2772,322,765,42.091503267973856,108,331,32.62839879154079,214,434,49.30875576036866,49.15032679738562,153,226,67.69911504424779,156,385,541,114,69,130,94,351,905
Patrick McCaw,3.0,2017 - 2019,SG,157,2432,224,533,42.026266416510325,69,231,29.87012987012987,155,302,51.324503311258276,48.49906191369606,68,86,79.06976744186046,44,186,230,187,98,27,94,167,585
Rodney McGruder,3.0,2017 - 2019,SG,162,3815,412,994,41.4486921529175,167,480,34.791666666666664,245,514,47.66536964980545,49.84909456740443,100,151,66.22516556291392,165,361,526,253,90,33,124,276,1091
Dejounte Murray,2.0,2017 - 2018,PG,119,2065,320,725,44.13793103448276,18,57,31.57894736842105,302,668,45.209580838323355,45.37931034482759,126,178,70.78651685393258,116,385,501,279,105,37,172,180,784
Jamal Murray,3.0,2017 - 2019,PG,238,6776,1287,2965,43.40640809443508,432,1194,36.18090452261307,855,1771,48.27780914737436,50.691399662731875,524,596,87.91946308724832,188,640,828,807,197,79,443,450,3530
Maurice Ndour,1.0,2017 - 2017,PF,32,331,39,86,45.348837209302324,1,7,14.285714285714285,38,79,48.10126582278481,45.93023255813954,19,26,73.07692307692307,22,42,64,8,15,8,12,30,98
Georges Niang,3.0,2017 - 2019,PF,91,641,99,228,43.42105263157895,44,121,36.36363636363637,55,107,51.4018691588785,53.07017543859649,23,28,82.14285714285714,16,97,113,43,15,6,31,64,265
David Nwaba,3.0,2017 - 2019,SG,141,3027,375,766,48.9556135770235,43,132,32.57575757575758,332,634,52.36593059936908,51.76240208877284,216,327,66.05504587155964,147,405,552,172,108,53,117,300,1009
Daniel Ochefu,1.0,2017 - 2017,C,19,75,12,27,44.44444444444444,0,0,,12,27,44.44444444444444,44.44444444444444,0,2,0.0,5,17,22,3,2,0,3,17,24
Chinanu Onuaku,2.0,2017 - 2018,C,6,74,7,12,58.333333333333336,0,0,,7,12,58.333333333333336,58.333333333333336,4,4,100.0,3,11,14,4,3,1,7,10,18
Georgios Papagiannis,2.0,2017 - 2018,C,39,477,74,144,51.388888888888886,0,2,0.0,74,142,52.112676056338024,51.388888888888886,12,14,85.71428571428571,37,86,123,29,7,23,32,56,160
Marshall Plumlee,2.0,2017 - 2018,C,29,222,17,33,51.515151515151516,0,0,,17,33,51.515151515151516,51.515151515151516,20,35,57.14285714285714,27,41,68,12,4,5,15,33,54
Jakob Poeltl,3.0,2017 - 2019,C,213,3423,507,789,64.25855513307985,1,2,50.0,506,787,64.29479034307496,64.32192648922687,140,250,56.00000000000001,421,547,968,162,85,188,162,449,1155
Alex Poythress,3.0,2017 - 2019,PF,52,566,76,161,47.20496894409938,19,53,35.84905660377358,57,108,52.77777777777778,53.105590062111794,26,39,66.66666666666666,47,75,122,24,10,13,18,77,197
Tim Quarterman,2.0,2017 - 2018,SG,19,93,14,32,43.75,5,15,33.33333333333333,9,17,52.94117647058824,51.5625,2,5,40.0,4,13,17,12,2,3,13,7,35
Chasson Randle,2.0,2017 - 2019,PG,75,1042,131,315,41.58730158730159,62,162,38.2716049382716,69,153,45.09803921568628,51.42857142857142,84,105,80.0,16,72,88,131,34,5,62,130,408
Malachi Richardson,3.0,2017 - 2019,SG,70,625,67,187,35.82887700534759,28,93,30.107526881720432,39,94,41.48936170212766,43.31550802139038,36,46,78.26086956521739,10,60,70,24,16,2,26,63,198
Domantas Sabonis,3.0,2017 - 2019,C,229,5280,945,1842,51.302931596091206,73,213,34.27230046948357,872,1629,53.529772866789436,53.28447339847992,420,582,72.16494845360825,397,1153,1550,445,127,94,380,659,2383
Dario Saric,3.0,2017 - 2019,PF,240,6462,1088,2513,43.29486669319538,381,1063,35.84195672624647,707,1450,48.758620689655174,50.875447672105054,482,577,83.53552859618716,392,1098,1490,511,153,59,428,504,3039
Tomas Satoransky,3.0,2017 - 2019,SG,210,4526,519,1061,48.91611687087653,120,300,40.0,399,761,52.431011826544015,54.57115928369463,229,289,79.23875432525952,179,416,595,777,160,34,241,363,1387
Wayne Selden,3.0,2017 - 2019,SG,124,2367,337,810,41.604938271604944,111,324,34.25925925925926,226,486,46.50205761316872,48.45679012345679,125,173,72.25433526011561,54,198,252,188,57,19,145,208,910
Pascal Siakam,3.0,2017 - 2019,PF,216,5086,875,1648,53.09466019417476,109,353,30.878186968838527,766,1295,59.150579150579155,56.40169902912622,313,421,74.34679334916865,267,831,1098,424,161,139,254,516,2172
Diamond Stone,1.0,2017 - 2017,C,7,24,3,13,23.076923076923077,0,0,,3,13,23.076923076923077,23.076923076923077,4,4,100.0,1,5,6,0,0,1,2,5,10
Isaiah Taylor,2.0,2017 - 2018,PG,71,1219,164,397,41.30982367758186,20,82,24.390243902439025,144,315,45.714285714285715,43.8287153652393,100,143,69.93006993006993,23,74,97,209,35,11,84,122,448
Mike Tobey,1.0,2017 - 2017,C,2,25,1,4,25.0,0,0,,1,4,25.0,25.0,0,0,,2,1,3,1,0,0,1,2,2
Tyler Ulis,3.0,2017 - 2019,PG,133,2782,398,988,40.2834008097166,63,225,28.000000000000004,335,763,43.90563564875492,43.47165991902834,139,172,80.81395348837209,44,179,223,537,118,12,204,193,998
Jarrod Uthoff,1.0,2017 - 2017,PF,9,115,16,38,42.10526315789473,3,9,33.33333333333333,13,29,44.827586206896555,46.05263157894737,5,7,71.42857142857143,8,14,22,9,2,4,3,8,40
Denzel Valentine,2.0,2017 - 2018,SG,134,3071,403,1009,39.94053518334985,216,578,37.37024221453287,187,431,43.38747099767982,50.64420218037661,52,69,75.36231884057972,59,485,544,307,95,18,148,271,1074
Fred VanVleet,3.0,2017 - 2019,PG,177,3574,517,1256,41.16242038216561,231,586,39.419795221843,286,670,42.68656716417911,50.358280254777064,199,238,83.61344537815127,50,343,393,585,141,42,171,276,1464
Taurean Waller-Prince,3.0,2017 - 2019,SF,196,4997,791,1854,42.66450916936354,332,874,37.986270022883296,459,980,46.83673469387755,51.61812297734628,321,390,82.3076923076923,97,648,745,387,181,88,352,405,2235
Okaro White,3.0,2017 - 2019,PF,44,557,40,105,38.095238095238095,16,47,34.04255319148936,24,58,41.37931034482759,45.714285714285715,22,25,88.0,29,66,95,23,11,11,19,58,118
Isaiah Whitehead,2.0,2017 - 2018,PG,89,1823,244,594,41.07744107744108,51,167,30.538922155688624,193,427,45.19906323185012,45.370370370370374,104,132,78.78787878787878,36,174,210,212,50,38,166,198,643
Troy Williams,3.0,2017 - 2019,SF,72,1176,168,374,44.919786096256686,43,144,29.86111111111111,125,230,54.347826086956516,50.668449197860966,50,77,64.93506493506493,49,142,191,52,57,22,60,131,429
Kyle Wiltjer,1.0,2017 - 2017,PF,14,44,4,14,28.57142857142857,4,13,30.76923076923077,0,1,0.0,42.857142857142854,1,2,50.0,4,6,10,2,3,1,5,4,13
Stephen Zimmerman,1.0,2017 - 2017,C,19,108,10,31,32.25806451612903,0,0,,10,31,32.25806451612903,32.25806451612903,3,5,60.0,11,24,35,4,2,5,3,17,23
Paul Zipser,2.0,2017 - 2018,SF,98,1667,169,455,37.142857142857146,70,209,33.49282296650718,99,246,40.243902439024396,44.83516483516484,50,65,76.92307692307693,28,228,256,82,35,31,83,164,458
Ivica Zubac,3.0,2017 - 2019,C,140,2059,399,739,53.99188092016238,0,4,0.0,399,735,54.285714285714285,53.99188092016238,172,226,76.10619469026548,201,443,644,118,36,99,126,250,970
Bam Adebayo,2.0,2018 - 2019,C,151,3281,454,826,54.9636803874092,3,22,13.636363636363635,451,804,56.09452736318408,55.1452784503632,295,405,72.8395061728395,283,695,978,285,103,106,187,341,1206
Jarrett Allen,2.0,2018 - 2019,C,152,3537,569,965,58.96373056994819,11,60,18.333333333333332,558,905,61.65745856353592,59.53367875647668,311,425,73.1764705882353,335,725,1060,159,71,208,185,331,1460
Kadeem Allen,2.0,2018 - 2019,SG,37,523,71,163,43.558282208588956,17,47,36.17021276595745,54,116,46.55172413793103,48.77300613496933,49,63,77.77777777777779,12,50,62,88,19,6,35,61,208
Ike Anigbogu,2.0,2018 - 2019,C,14,36,4,12,33.33333333333333,0,0,,4,12,33.33333333333333,33.33333333333333,5,6,83.33333333333334,6,6,12,1,1,4,3,1,13
OG Anunoby,2.0,2018 - 2019,SF,141,2833,346,750,46.13333333333333,140,399,35.08771929824561,206,351,58.68945868945868,55.46666666666666,75,124,60.483870967741936,102,279,381,102,98,36,100,270,907
Ryan Arcidiacono,2.0,2018 - 2019,PG,105,2265,204,459,44.44444444444444,90,248,36.29032258064516,114,211,54.02843601895735,54.248366013071895,94,108,87.03703703703704,28,216,244,304,78,4,76,189,592
Jamel Artis,1.0,2018 - 2018,SG,15,279,31,79,39.24050632911392,8,29,27.586206896551722,23,50,46.0,44.303797468354425,7,12,58.333333333333336,4,34,38,18,2,3,8,11,77
Dwayne Bacon,2.0,2018 - 2019,SG,96,1472,194,449,43.207126948775056,49,130,37.69230769230769,145,319,45.45454545454545,48.66369710467706,54,71,76.05633802816901,12,201,213,85,28,7,41,118,491
Lonzo Ball,2.0,2018 - 2019,PG,99,3203,388,1020,38.03921568627451,165,523,31.54875717017208,223,497,44.8692152917505,46.12745098039216,52,119,43.69747899159664,123,488,611,631,157,62,239,231,993
Jordan Bell,2.0,2018 - 2019,C,125,1597,215,377,57.02917771883289,0,6,0.0,215,371,57.95148247978437,57.02917771883289,55,85,64.70588235294117,115,276,391,178,55,107,93,172,485
Khem Birch,2.0,2018 - 2019,C,92,1221,159,277,57.400722021660656,0,1,0.0,159,276,57.608695652173914,57.400722021660656,100,144,69.44444444444444,149,221,370,72,33,50,41,128,418
Jabari Bird,1.0,2018 - 2018,SG,13,115,15,26,57.692307692307686,3,7,42.857142857142854,12,19,63.1578947368421,63.46153846153846,6,13,46.15384615384615,6,13,19,8,3,1,8,7,39
Antonio Blakeney,2.0,2018 - 2019,SG,76,1143,219,539,40.63079777365491,51,143,35.66433566433567,168,396,42.42424242424242,45.36178107606679,80,115,69.56521739130434,11,128,139,62,19,10,46,60,569
Bogdan Bogdanovic,2.0,2018 - 2019,SG,148,4122,705,1635,43.11926605504588,263,701,37.51783166904422,442,934,47.32334047109208,51.162079510703364,234,281,83.27402135231317,71,395,466,525,144,31,242,314,1907
Chris Boucher,2.0,2018 - 2019,PF,29,164,34,77,44.15584415584416,12,38,31.57894736842105,22,39,56.41025641025641,51.94805194805194,13,15,86.66666666666667,16,41,57,2,6,24,7,31,93
Tony Bradley,2.0,2018 - 2019,C,12,65,11,27,40.74074074074074,0,1,0.0,11,26,42.30769230769231,40.74074074074074,3,4,75.0,13,13,26,2,2,2,3,7,25
Dillon Brooks,2.0,2018 - 2019,SF,100,2680,389,894,43.51230425055929,109,304,35.85526315789473,280,590,47.45762711864407,49.608501118568235,146,196,74.48979591836735,58,230,288,151,83,21,143,283,1033
Sterling Brown,2.0,2018 - 2019,SG,112,1810,227,517,43.907156673114116,85,238,35.714285714285715,142,279,50.89605734767025,52.12765957446809,50,66,75.75757575757575,56,271,327,109,56,21,71,168,589
Thomas Bryant,2.0,2018 - 2019,C,87,1568,317,523,60.61185468451242,34,109,31.19266055045872,283,414,68.35748792270532,63.862332695984705,112,146,76.71232876712328,116,355,471,98,26,69,62,132,780
Alex Caruso,2.0,2018 - 2019,PG,62,1093,127,289,43.944636678200695,37,93,39.784946236559136,90,196,45.91836734693878,50.34602076124568,72,94,76.59574468085107,35,97,132,152,47,19,84,106,363
Tyler Cavanaugh,2.0,2018 - 2019,PF,50,557,70,162,43.20987654320987,33,94,35.1063829787234,37,68,54.41176470588235,53.39506172839506,19,23,82.6086956521739,48,87,135,28,9,4,15,64,192
Gian Clavell,1.0,2018 - 2018,SG,7,64,6,18,33.33333333333333,6,15,40.0,0,3,0.0,50.0,2,2,100.0,1,6,7,3,2,0,2,8,20
Antonius Cleveland,1.0,2018 - 2018,SG,17,123,8,21,38.095238095238095,3,4,75.0,5,17,29.411764705882355,45.23809523809524,4,6,66.66666666666666,3,11,14,2,7,5,7,23,23
John Collins,2.0,2018 - 2019,PF,135,3614,779,1376,56.61337209302325,71,205,34.63414634146341,708,1171,60.46114432109309,59.19331395348837,336,452,74.33628318584071,395,741,1136,219,69,119,225,414,1965
Zach Collins,2.0,2018 - 2019,C,143,2401,304,689,44.12191582002903,75,234,32.05128205128205,229,455,50.32967032967033,49.56458635703919,121,168,72.02380952380952,154,391,545,123,42,97,135,307,804
Kyle Collinsworth,1.0,2018 - 2018,SF,32,480,38,99,38.38383838383838,4,17,23.52941176470588,34,82,41.46341463414634,40.4040404040404,21,40,52.5,32,75,107,56,17,9,24,44,101
Charles Cooke,1.0,2018 - 2018,SG,13,38,2,14,14.285714285714285,1,8,12.5,1,6,16.666666666666664,17.857142857142858,1,2,50.0,0,2,2,1,1,0,1,0,6
Matt Costello,1.0,2018 - 2018,C,4,32,2,4,50.0,0,0,,2,4,50.0,50.0,0,0,,1,8,9,2,2,2,1,7,4
Torrey Craig,2.0,2018 - 2019,SF,114,2132,222,499,44.48897795591182,78,246,31.70731707317073,144,253,56.916996047430835,52.30460921843687,71,105,67.61904761904762,129,261,390,97,49,61,64,238,593
Tyler Dorsey,2.0,2018 - 2019,SG,104,1672,251,646,38.85448916408669,116,331,35.04531722054381,135,315,42.857142857142854,47.8328173374613,83,124,66.93548387096774,44,199,243,135,31,7,64,116,701
Damyean Dotson,2.0,2018 - 2019,SG,117,2478,362,859,42.14202561117579,148,410,36.09756097560975,214,449,47.66146993318486,50.756693830034926,89,121,73.55371900826447,43,303,346,166,70,12,88,169,961
Milton Doyle,1.0,2018 - 2018,SG,10,125,13,47,27.659574468085108,4,23,17.391304347826086,9,24,37.5,31.914893617021278,4,8,50.0,3,15,18,10,6,2,2,13,34
PJ Dozier,2.0,2018 - 2019,SG,8,54,9,23,39.130434782608695,2,8,25.0,7,15,46.666666666666664,43.47826086956522,1,2,50.0,6,12,18,5,2,0,1,3,21
Jawun Evans,2.0,2018 - 2019,PG,56,843,92,267,34.45692883895131,15,57,26.31578947368421,77,210,36.666666666666664,37.265917602996254,38,49,77.55102040816327,10,86,96,110,39,6,50,105,237
Terrance Ferguson,2.0,2018 - 2019,SG,135,2694,255,600,42.5,146,410,35.609756097560975,109,190,57.36842105263158,54.666666666666664,46,61,75.40983606557377,52,136,188,91,64,26,58,314,702
De'Aaron Fox,2.0,2018 - 2019,PG,154,4572,833,1899,43.86519220642444,133,385,34.54545454545455,700,1514,46.23513870541612,47.367035281727226,444,612,72.54901960784314,76,432,508,910,203,65,400,367,2243
Markelle Fultz,2.0,2018 - 2019,SG,33,680,110,266,41.35338345864661,4,15,26.666666666666668,106,251,42.23107569721115,42.10526315789473,31,58,53.44827586206896,37,76,113,112,29,9,42,74,255
Josh Gray,1.0,2018 - 2018,PG,5,86,11,41,26.82926829268293,3,13,23.076923076923077,8,28,28.57142857142857,30.48780487804878,7,11,63.63636363636363,2,8,10,12,8,2,7,8,32
Daniel Hamilton,2.0,2018 - 2019,SG,25,232,28,71,39.436619718309856,10,28,35.714285714285715,18,43,41.86046511627907,46.478873239436616,3,6,50.0,10,42,52,30,7,1,18,21,69
Shaquille Harrison,2.0,2018 - 2019,PG,96,1814,243,550,44.18181818181818,30,115,26.08695652173913,213,435,48.96551724137931,46.909090909090914,110,161,68.32298136645963,42,241,283,194,115,37,82,166,626
Josh Hart,2.0,2018 - 2019,SG,130,3176,365,839,43.5041716328963,170,471,36.09341825902335,195,368,52.9891304347826,53.63528009535161,121,174,69.54022988505747,77,434,511,173,111,56,105,254,1021
Nigel Hayes,1.0,2018 - 2018,SF,9,122,11,33,33.33333333333333,4,16,25.0,7,17,41.17647058823529,39.39393939393939,1,3,33.33333333333333,4,18,22,6,2,3,2,8,27
Reggie Hearn,1.0,2018 - 2018,SG,3,7,1,2,50.0,1,2,50.0,0,0,,75.0,0,0,,0,0,0,0,0,0,0,0,3
Myke Henry,1.0,2018 - 2018,SF,20,378,41,109,37.61467889908257,19,58,32.758620689655174,22,51,43.13725490196079,46.330275229357795,6,10,60.0,10,28,38,22,31,6,19,28,107
Isaiah Hicks,2.0,2018 - 2019,PF,21,272,37,80,46.25,2,9,22.22222222222222,35,71,49.29577464788733,47.5,16,23,69.56521739130434,12,36,48,18,3,7,17,50,92
John Holland,2.0,2018 - 2019,SF,25,175,17,59,28.8135593220339,11,36,30.555555555555557,6,23,26.08695652173913,38.13559322033898,9,13,69.23076923076923,6,18,24,5,7,2,8,10,54
Vince Hunter,1.0,2018 - 2018,PF,4,7,3,5,60.0,0,0,,3,5,60.0,60.0,0,0,,2,1,3,0,0,1,1,0,6
Andre Ingram,2.0,2018 - 2019,SG,6,79,8,23,34.78260869565217,5,12,41.66666666666667,3,11,27.27272727272727,45.65217391304348,3,3,100.0,2,6,8,7,4,3,4,3,24
Jonathan Isaac,2.0,2018 - 2019,PF,102,2532,317,756,41.93121693121693,102,312,32.69230769230769,215,444,48.42342342342342,48.67724867724868,129,160,80.625,115,395,510,98,92,128,102,191,865
Wesley Iwundu,2.0,2018 - 2019,SF,130,2253,206,492,41.86991869918699,38,125,30.4,168,367,45.776566757493185,45.73170731707317,118,150,78.66666666666666,73,248,321,130,61,34,74,204,568
Aaron Jackson,1.0,2018 - 2018,PG,1,35,3,9,33.33333333333333,1,4,25.0,2,5,40.0,38.88888888888889,1,2,50.0,2,1,3,1,0,0,1,4,8
Josh Jackson,2.0,2018 - 2019,SF,156,3947,736,1773,41.51156232374507,130,442,29.411764705882355,606,1331,45.52967693463561,45.17766497461929,320,492,65.04065040650406,161,537,698,302,154,91,319,427,1922
Justin Jackson,2.0,2018 - 2019,SF,149,3120,402,904,44.469026548672566,144,430,33.48837209302326,258,474,54.43037974683544,52.43362831858407,88,115,76.52173913043478,71,328,399,170,60,27,69,180,1036
Dakari Johnson,1.0,2018 - 2018,C,31,161,22,39,56.41025641025641,0,0,,22,39,56.41025641025641,56.41025641025641,11,20,55.00000000000001,16,18,34,8,6,8,3,27,55
Omari Johnson,1.0,2018 - 2018,PF,4,75,9,21,42.857142857142854,4,12,33.33333333333333,5,9,55.55555555555556,52.38095238095239,0,0,,4,7,11,7,2,0,3,6,22
Jalen Jones,2.0,2018 - 2019,SF,32,395,52,130,40.0,20,54,37.03703703703704,32,76,42.10526315789473,47.69230769230769,31,46,67.3913043478261,24,48,72,11,14,3,15,49,155
Luke Kennard,2.0,2018 - 2019,SG,136,2900,434,985,44.06091370558375,187,464,40.30172413793103,247,521,47.408829174664106,53.55329949238579,116,137,84.67153284671532,33,326,359,238,70,23,126,178,1171
Maxi Kleber,2.0,2018 - 2019,PF,143,2708,326,695,46.906474820143885,117,346,33.81502890173411,209,349,59.885386819484246,55.32374100719425,102,133,76.69172932330827,161,402,563,121,62,125,84,257,871
Furkan Korkmaz,2.0,2018 - 2019,SG,62,759,106,273,38.82783882783883,52,161,32.298136645962735,54,112,48.214285714285715,48.35164835164835,38,48,79.16666666666666,18,100,118,56,31,3,27,74,302
Luke Kornet,2.0,2018 - 2019,PF,66,1110,156,408,38.23529411764706,98,272,36.029411764705884,58,136,42.64705882352941,50.245098039215684,46,57,80.7017543859649,39,160,199,80,33,58,37,69,456
Kyle Kuzma,2.0,2018 - 2019,PF,147,4715,964,2126,45.34336782690499,287,856,33.52803738317757,677,1270,53.30708661417323,52.09313264346191,335,458,73.14410480349345,148,717,865,319,90,60,273,330,2550
T.J. Leaf,2.0,2018 - 2019,PF,111,981,163,319,51.09717868338558,26,73,35.61643835616438,137,246,55.6910569105691,55.172413793103445,29,47,61.702127659574465,72,135,207,33,14,23,22,80,381
Damion Lee,2.0,2018 - 2019,SG,47,779,118,279,42.29390681003584,42,128,32.8125,76,151,50.331125827814574,49.82078853046595,41,51,80.3921568627451,19,116,135,42,32,1,25,53,319
Walt Lemon,2.0,2018 - 2019,PG,11,202,45,103,43.689320388349515,3,6,50.0,42,97,43.29896907216495,45.14563106796117,10,14,71.42857142857143,4,25,29,35,11,2,14,19,103
Tyler Lydon,2.0,2018 - 2019,PF,26,96,9,18,50.0,4,10,40.0,5,8,62.5,61.111111111111114,1,3,33.33333333333333,7,11,18,6,2,0,4,10,23
Josh Magette,1.0,2018 - 2018,PG,18,216,15,46,32.608695652173914,8,22,36.36363636363637,7,24,29.166666666666668,41.30434782608695,8,8,100.0,2,17,19,57,8,1,9,16,46
Lauri Markkanen,2.0,2018 - 2019,PF,120,3702,716,1657,43.2106216053108,265,733,36.15279672578445,451,924,48.80952380952381,51.2070006035003,310,361,85.87257617728532,153,825,978,154,76,73,168,225,2007
Frank Mason,2.0,2018 - 2019,PG,90,1419,215,549,39.162112932604735,45,150,30.0,170,399,42.606516290726816,43.26047358834244,133,172,77.32558139534885,36,137,173,231,50,14,101,106,608
Mangok Mathiang,1.0,2018 - 2018,C,4,20,4,7,57.14285714285714,0,0,,4,7,57.14285714285714,57.14285714285714,0,1,0.0,3,7,10,0,1,0,0,5,8
Erik McCree,1.0,2018 - 2018,SF,4,8,0,2,0.0,0,1,0.0,0,1,0.0,0.0,0,0,,0,1,1,0,1,0,1,0,0
Trey McKinney-Jones,1.0,2018 - 2018,SG,1,1,0,0,,0,0,,0,0,,,0,0,,0,0,0,0,0,0,0,0,0
Alfonzo McKinnie,2.0,2018 - 2019,SF,86,1056,142,290,48.96551724137931,45,127,35.43307086614173,97,163,59.50920245398773,56.72413793103448,29,51,56.86274509803921,82,172,254,32,19,16,33,142,358
Malcolm Miller,2.0,2018 - 2019,SF,25,193,24,54,44.44444444444444,18,42,42.857142857142854,6,12,50.0,61.111111111111114,7,8,87.5,5,15,20,4,2,3,6,15,73
Donovan Mitchell,2.0,2018 - 2019,SG,156,5236,1256,2892,43.43015214384509,375,1069,35.07951356407858,881,1823,48.326933625891385,49.91355463347165,558,693,80.51948051948052,111,501,612,613,224,58,433,421,3445
Naz Mitrou-Long,2.0,2018 - 2019,SG,15,85,7,21,33.33333333333333,3,12,25.0,4,9,44.44444444444444,40.476190476190474,2,2,100.0,1,5,6,15,1,1,8,10,19
Malik Monk,2.0,2018 - 2019,SG,136,2112,380,1011,37.58654797230465,192,573,33.50785340314136,188,438,42.922374429223744,47.08209693372898,122,140,87.14285714285714,24,179,203,208,57,28,135,166,1074
Ben Moore,1.0,2018 - 2018,PF,2,9,0,0,,0,0,,0,0,,,0,0,,0,1,1,1,0,0,0,4,0
Jaylen Morris,2.0,2018 - 2019,SG,10,127,17,42,40.476190476190474,3,13,23.076923076923077,14,29,48.275862068965516,44.047619047619044,1,2,50.0,2,19,21,11,4,1,7,3,38
Monte Morris,2.0,2018 - 2019,PG,85,1995,350,708,49.43502824858757,94,228,41.228070175438596,256,480,53.333333333333336,56.07344632768362,67,83,80.72289156626506,35,161,196,304,76,4,53,103,861
Johnathan Motley,2.0,2018 - 2019,PF,33,332,79,148,53.37837837837838,1,9,11.11111111111111,78,139,56.11510791366906,53.71621621621622,39,68,57.35294117647059,32,68,100,18,8,5,25,45,198
Abdel Nader,2.0,2018 - 2019,SF,109,1216,141,364,38.73626373626374,55,165,33.33333333333333,86,199,43.21608040201005,46.291208791208796,50,75,66.66666666666666,27,160,187,46,35,22,60,113,387
Frank Ntilikina,2.0,2018 - 2019,PG,121,2610,277,782,35.42199488491048,83,272,30.514705882352942,194,510,38.03921568627451,40.728900255754475,72,98,73.46938775510205,49,215,264,371,95,32,187,285,709
Royce O'Neale,2.0,2018 - 2019,SF,151,2821,283,627,45.13556618819777,110,294,37.41496598639456,173,333,51.95195195195195,53.90749601275917,93,118,78.8135593220339,47,474,521,219,90,40,125,277,769
Semi Ojeleye,2.0,2018 - 2019,PF,129,1744,132,346,38.15028901734104,68,214,31.775700934579437,64,132,48.484848484848484,47.97687861271676,49,80,61.25000000000001,61,186,247,43,31,8,44,134,381
Cedi Osman,2.0,2018 - 2019,SF,137,3116,450,1030,43.689320388349515,162,461,35.140997830802604,288,569,50.61511423550088,51.553398058252434,167,227,73.568281938326,64,413,477,236,82,14,146,273,1229
Marcus Paige,1.0,2018 - 2018,PG,5,28,4,14,28.57142857142857,2,8,25.0,2,6,33.33333333333333,35.714285714285715,2,2,100.0,0,4,4,3,0,0,0,0,12
Justin Patton,2.0,2018 - 2019,C,4,25,3,9,33.33333333333333,0,2,0.0,3,7,42.857142857142854,33.33333333333333,1,2,50.0,2,4,6,3,3,0,0,6,7
Brandon Paul,1.0,2018 - 2018,SG,64,576,55,127,43.30708661417323,15,54,27.77777777777778,40,73,54.794520547945204,49.21259842519685,22,43,51.162790697674424,6,62,68,37,25,7,29,58,147
London Perrantes,1.0,2018 - 2018,PG,14,66,2,13,15.384615384615385,0,3,0.0,2,10,20.0,15.384615384615385,3,5,60.0,1,3,4,5,2,1,1,6,7
Alec Peters,1.0,2018 - 2018,PF,20,225,28,74,37.83783783783784,18,58,31.03448275862069,10,16,62.5,50.0,8,10,80.0,8,29,37,12,2,2,4,13,82
Jacob Pullen,1.0,2018 - 2018,PG,3,6,1,2,50.0,0,1,0.0,1,1,100.0,50.0,0,0,,0,0,0,0,0,0,1,0,2
Rodney Purvis,1.0,2018 - 2018,SG,16,290,35,107,32.71028037383177,13,52,25.0,22,55,40.0,38.78504672897196,13,15,86.66666666666667,1,26,27,17,3,3,10,26,96
Zhou Qi,2.0,2018 - 2019,C,19,125,7,33,21.21212121212121,2,19,10.526315789473683,5,14,35.714285714285715,24.242424242424242,8,12,66.66666666666666,6,16,22,2,2,14,10,14,24
Ivan Rabb,2.0,2018 - 2019,PF,85,1237,202,364,55.494505494505496,3,15,20.0,199,349,57.02005730659025,55.90659340659341,78,105,74.28571428571429,123,241,364,86,29,27,70,145,485
Xavier Rathan-Mayes,1.0,2018 - 2018,SG,5,118,12,42,28.57142857142857,1,14,7.142857142857142,11,28,39.285714285714285,29.761904761904763,4,9,44.44444444444444,0,5,5,18,6,3,11,18,29
Davon Reed,2.0,2018 - 2019,SG,31,289,27,88,30.681818181818183,13,42,30.952380952380953,14,46,30.434782608695656,38.06818181818182,8,12,66.66666666666666,4,41,45,16,11,2,11,20,75
Devin Robinson,2.0,2018 - 2019,SF,8,108,20,35,57.14285714285714,0,2,0.0,20,33,60.60606060606061,57.14285714285714,9,14,64.28571428571429,8,17,25,6,5,6,2,13,49
Ben Simmons,2.0,2018 - 2019,PG,160,5432,1084,1958,55.362614913176714,0,17,0.0,1084,1941,55.84750128799588,55.362614913176714,448,769,58.25747724317295,317,1039,1356,1271,252,131,552,420,2616
Kobi Simmons,2.0,2018 - 2019,PG,33,645,80,189,42.32804232804233,11,39,28.205128205128204,69,150,46.0,45.23809523809524,25,25,100.0,14,36,50,68,18,5,44,61,196
Dennis Smith,2.0,2018 - 2019,PG,122,3557,682,1674,40.74074074074074,173,547,31.62705667276051,509,1127,45.16415261756877,45.908004778972526,233,349,66.7621776504298,82,333,415,610,138,38,348,281,1770
Edmond Sumner,2.0,2018 - 2019,PG,24,212,23,65,35.38461538461539,7,27,25.925925925925924,16,38,42.10526315789473,40.76923076923077,15,24,62.5,9,16,25,10,12,5,10,27,68
Caleb Swanigan,2.0,2018 - 2019,PF,48,367,42,113,37.16814159292036,2,15,13.333333333333334,40,98,40.816326530612244,38.05309734513274,18,27,66.66666666666666,32,86,118,25,11,4,36,65,104
Jayson Tatum,2.0,2018 - 2019,SF,159,4893,863,1871,46.125066809192944,221,553,39.963833634719705,642,1318,48.710166919575116,52.03099946552646,408,486,83.9506172839506,120,759,879,296,167,115,236,338,2355
Milos Teodosic,2.0,2018 - 2019,PG,60,1284,168,400,42.0,98,259,37.83783783783784,70,141,49.645390070921984,54.25,43,53,81.13207547169812,19,123,142,241,26,6,118,130,477
Daniel Theis,2.0,2018 - 2019,C,129,1844,272,499,54.50901803607214,44,125,35.199999999999996,228,374,60.962566844919785,58.91783567134269,117,157,74.52229299363057,177,322,499,124,51,90,89,318,705
Sindarius Thornwell,2.0,2018 - 2019,SG,137,1469,117,282,41.48936170212766,26,76,34.21052631578947,91,206,44.1747572815534,46.09929078014184,84,122,68.85245901639344,38,146,184,86,62,32,73,166,344
Tyrone Wallace,2.0,2018 - 2019,PG,92,1479,202,464,43.53448275862069,14,59,23.728813559322035,188,405,46.41975308641975,45.043103448275865,91,135,67.4074074074074,41,165,206,113,48,20,82,166,509
Derrick Walton,1.0,2018 - 2018,PG,16,147,8,25,32.0,7,17,41.17647058823529,1,8,12.5,46.0,6,6,100.0,2,14,16,16,7,3,2,7,29
Jameel Warney,1.0,2018 - 2018,PF,3,27,7,12,58.333333333333336,0,0,,7,12,58.333333333333336,58.333333333333336,3,5,60.0,4,5,9,0,0,0,1,2,17
James Webb,1.0,2018 - 2018,SF,10,120,6,24,25.0,4,19,21.052631578947366,2,5,40.0,33.33333333333333,0,0,,8,16,24,4,1,0,4,10,16
Andrew White,1.0,2018 - 2018,SF,15,209,25,73,34.24657534246575,18,49,36.734693877551024,7,24,29.166666666666668,46.57534246575342,1,4,25.0,4,30,34,6,3,1,8,12,69
Derrick White,2.0,2018 - 2019,PG,84,1867,276,576,47.91666666666667,56,155,36.12903225806451,220,421,52.25653206650831,52.77777777777778,109,143,76.22377622377621,40,233,273,272,71,50,103,153,717
Jacob Wiley,1.0,2018 - 2018,PF,5,33,1,4,25.0,1,2,50.0,0,2,0.0,37.5,1,2,50.0,2,9,11,2,1,0,0,4,4
C.J. Williams,2.0,2018 - 2019,SG,53,835,104,232,44.827586206896555,27,94,28.723404255319153,77,138,55.79710144927537,50.646551724137936,13,17,76.47058823529412,13,51,64,55,37,13,25,79,248
Matt Williams,1.0,2018 - 2018,SG,3,11,2,6,33.33333333333333,1,5,20.0,1,1,100.0,41.66666666666667,0,0,,0,1,1,0,0,0,1,1,5
D.J. Wilson,2.0,2018 - 2019,PF,70,953,113,267,42.32209737827715,48,132,36.36363636363637,65,135,48.148148148148145,51.31086142322098,27,49,55.10204081632652,47,185,232,55,21,21,36,92,301
Jamil Wilson,1.0,2018 - 2018,SF,15,274,38,81,46.913580246913575,27,63,42.857142857142854,11,18,61.111111111111114,63.580246913580254,2,4,50.0,3,29,32,10,5,8,8,34,105
Guerschon Yabusele,2.0,2018 - 2019,PF,74,486,61,138,44.20289855072464,21,65,32.30769230769231,40,73,54.794520547945204,51.81159420289855,30,44,68.18181818181817,40,65,105,31,12,12,27,55,173
Ante Zizic,2.0,2018 - 2019,C,91,1296,232,398,58.291457286432156,0,0,,232,398,58.291457286432156,58.291457286432156,114,161,70.80745341614907,132,248,380,58,15,35,72,143,578
Jaylen Adams,1.0,2019 - 2019,PG,34,428,38,110,34.54545454545455,25,74,33.78378378378378,13,36,36.11111111111111,45.909090909090914,7,9,77.77777777777779,11,49,60,65,14,5,28,45,108
Deng Adel,1.0,2019 - 2019,SF,19,194,11,36,30.555555555555557,6,23,26.08695652173913,5,13,38.46153846153847,38.88888888888889,4,4,100.0,3,16,19,5,1,4,6,13,32
DeVaughn Akoon-Purcell,1.0,2019 - 2019,SG,7,22,3,10,30.0,0,4,0.0,3,6,50.0,30.0,1,2,50.0,1,3,4,6,2,0,2,4,7
Rawle Alkins,1.0,2019 - 2019,SG,10,120,13,39,33.33333333333333,3,12,25.0,10,27,37.03703703703704,37.17948717948718,8,12,66.66666666666666,11,15,26,13,1,0,8,7,37
Grayson Allen,1.0,2019 - 2019,SG,38,416,67,178,37.640449438202246,32,99,32.323232323232325,35,79,44.303797468354425,46.62921348314607,45,60,75.0,3,20,23,25,6,6,33,47,211
Kostas Antetokounmpo,1.0,2019 - 2019,PF,2,11,0,3,0.0,0,0,,0,3,0.0,0.0,2,4,50.0,0,1,1,0,2,0,1,0,2
Deandre Ayton,1.0,2019 - 2019,C,71,2183,509,870,58.50574712643678,0,4,0.0,509,866,58.775981524249424,58.50574712643678,141,189,74.60317460317461,223,506,729,125,61,67,126,209,1159
Marvin Bagley,1.0,2019 - 2019,PF,62,1567,356,706,50.42492917847026,30,96,31.25,326,610,53.442622950819676,52.54957507082153,181,262,69.08396946564885,162,309,471,62,33,59,98,120,923
Mohamed Bamba,1.0,2019 - 2019,C,47,766,117,243,48.148148148148145,21,70,30.0,96,173,55.49132947976878,52.46913580246913,37,63,58.730158730158735,64,169,233,39,13,64,43,102,292
Keita Bates-Diop,1.0,2019 - 2019,SF,30,503,60,142,42.25352112676056,13,52,25.0,47,90,52.22222222222223,46.83098591549296,18,28,64.28571428571429,16,67,83,17,18,14,14,29,151
Dairis Bertans,1.0,2019 - 2019,SG,12,167,12,47,25.53191489361702,10,34,29.411764705882355,2,13,15.384615384615385,36.17021276595745,0,0,,2,7,9,10,1,0,2,7,34
Jaron Blossomgame,1.0,2019 - 2019,SF,27,439,47,106,44.339622641509436,10,39,25.64102564102564,37,67,55.223880597014926,49.056603773584904,10,13,76.92307692307693,26,72,98,13,7,8,11,20,114
Jonah Bolden,1.0,2019 - 2019,PF,44,639,80,162,49.382716049382715,34,96,35.41666666666667,46,66,69.6969696969697,59.876543209876544,13,27,48.148148148148145,47,118,165,40,17,39,36,99,207
Isaac Bonga,1.0,2019 - 2019,PG,22,120,5,33,15.151515151515152,0,8,0.0,5,25,20.0,15.151515151515152,9,15,60.0,9,16,25,15,9,4,6,9,19
Mikal Bridges,1.0,2019 - 2019,SF,82,2417,242,563,42.98401420959148,105,313,33.54632587859425,137,250,54.800000000000004,52.30905861456483,95,118,80.50847457627118,56,208,264,173,129,38,70,201,684
Miles Bridges,1.0,2019 - 2019,SF,80,1696,237,511,46.37964774951076,65,200,32.5,172,311,55.30546623794213,52.73972602739726,58,77,75.32467532467533,67,256,323,95,55,49,50,111,597
Isaiah Briscoe,1.0,2019 - 2019,PG,39,559,55,138,39.85507246376812,11,34,32.35294117647059,44,104,42.30769230769231,43.84057971014493,15,26,57.692307692307686,5,69,74,87,11,2,31,66,136
Ryan Broekhoff,1.0,2019 - 2019,SG,42,453,57,126,45.23809523809524,38,93,40.86021505376344,19,33,57.57575757575758,60.317460317460316,15,19,78.94736842105263,8,55,63,22,6,4,16,35,167
Bruce Brown,1.0,2019 - 2019,SG,74,1449,125,314,39.80891719745223,24,93,25.806451612903224,101,221,45.70135746606335,43.63057324840764,45,60,75.0,48,137,185,91,40,36,46,178,319
Troy Brown,1.0,2019 - 2019,SF,52,730,97,234,41.452991452991455,22,69,31.88405797101449,75,165,45.45454545454545,46.15384615384615,32,47,68.08510638297872,35,110,145,80,21,5,30,56,248
Jalen Brunson,1.0,2019 - 2019,PG,73,1591,264,565,46.72566371681416,63,181,34.806629834254146,201,384,52.34375,52.30088495575222,87,120,72.5,25,144,169,230,37,4,88,127,678
Deonte Burton,1.0,2019 - 2019,SG,32,240,33,82,40.243902439024396,8,27,29.629629629629626,25,55,45.45454545454545,45.1219512195122,8,12,66.66666666666666,4,24,28,9,6,8,9,31,82
Jevon Carter,1.0,2019 - 2019,PG,39,577,56,185,30.270270270270274,34,102,33.33333333333333,22,83,26.506024096385545,39.45945945945946,26,32,81.25,14,52,66,69,26,11,33,55,172
Wendell Carter,1.0,2019 - 2019,C,44,1110,180,371,48.517520215633425,6,32,18.75,174,339,51.32743362831859,49.32614555256065,89,112,79.46428571428571,87,220,307,78,26,58,65,152,455
Troy Caupain,1.0,2019 - 2019,PG,4,16,4,8,50.0,2,3,66.66666666666666,2,5,40.0,62.5,0,0,,1,2,3,4,1,0,0,0,10
Joe Chealey,1.0,2019 - 2019,PG,1,8,1,3,33.33333333333333,0,0,,1,3,33.33333333333333,33.33333333333333,0,0,,0,0,0,1,0,0,0,1,2
Chris Chiozza,1.0,2019 - 2019,PG,7,33,2,8,25.0,2,5,40.0,0,3,0.0,37.5,0,0,,1,3,4,4,1,1,1,2,6
Gary Clark,1.0,2019 - 2019,PF,51,641,50,151,33.11258278145696,41,138,29.71014492753623,9,13,69.23076923076923,46.688741721854306,7,7,100.0,24,92,116,18,20,26,7,47,148
Bonzie Colson,1.0,2019 - 2019,SF,8,98,13,39,33.33333333333333,5,21,23.809523809523807,8,18,44.44444444444444,39.743589743589745,8,9,88.88888888888889,8,22,30,3,5,1,3,3,39
Mitch Creek,1.0,2019 - 2019,SF,5,48,8,16,50.0,0,2,0.0,8,14,57.14285714285714,50.0,5,7,71.42857142857143,6,6,12,6,2,0,1,3,21
Tyler Davis,1.0,2019 - 2019,C,1,1,0,1,0.0,0,0,,0,1,0.0,0.0,0,0,,1,0,1,0,0,0,0,0,0
Angel Delgado,1.0,2019 - 2019,C,2,15,1,5,20.0,0,0,,1,5,20.0,20.0,1,2,50.0,2,2,4,0,1,0,0,2,3
Marcus Derrickson,1.0,2019 - 2019,PF,11,67,16,33,48.484848484848484,10,20,50.0,6,13,46.15384615384615,63.63636363636363,4,5,80.0,8,5,13,1,0,1,3,9,46
Hamidou Diallo,1.0,2019 - 2019,SG,51,526,75,165,45.45454545454545,4,24,16.666666666666664,71,141,50.35460992907801,46.666666666666664,36,59,61.016949152542374,38,59,97,17,21,10,23,77,190
Donte DiVincenzo,1.0,2019 - 2019,SG,27,411,50,124,40.32258064516129,22,83,26.506024096385545,28,41,68.29268292682927,49.193548387096776,9,12,75.0,16,49,65,31,13,6,19,38,131
Luka Doncic,1.0,2019 - 2019,SG,72,2318,506,1186,42.66441821247892,168,514,32.68482490272373,338,672,50.297619047619044,49.747048903878586,346,485,71.34020618556701,86,477,563,429,77,25,247,137,1526
Trevon Duval,1.0,2019 - 2019,PG,3,6,2,3,66.66666666666666,1,1,100.0,1,2,50.0,83.33333333333334,0,0,,0,1,1,2,0,0,0,0,5
Vince Edwards,1.0,2019 - 2019,SF,2,16,1,4,25.0,1,4,25.0,0,0,,37.5,0,0,,1,1,2,0,0,0,0,0,3
Drew Eubanks,1.0,2019 - 2019,PF,23,113,15,26,57.692307692307686,0,0,,15,26,57.692307692307686,57.692307692307686,11,13,84.61538461538461,6,28,34,7,2,5,8,11,41
Jacob Evans,1.0,2019 - 2019,SG,30,204,18,53,33.9622641509434,4,15,26.666666666666668,14,38,36.84210526315789,37.735849056603776,0,1,0.0,6,19,25,23,5,3,11,28,40
Melvin Frazier,1.0,2019 - 2019,SG,10,44,7,21,33.33333333333333,0,6,0.0,7,15,46.666666666666664,33.33333333333333,1,4,25.0,3,2,5,1,1,0,1,6,15
Billy Garrett,1.0,2019 - 2019,SG,4,63,11,27,40.74074074074074,0,8,0.0,11,19,57.89473684210527,40.74074074074074,4,4,100.0,0,3,3,7,1,1,2,3,26
Harry Giles,1.0,2019 - 2019,PF,58,820,175,348,50.287356321839084,0,6,0.0,175,342,51.16959064327485,50.287356321839084,58,91,63.73626373626373,66,156,222,85,31,22,73,150,408
Shai Gilgeous-Alexander,1.0,2019 - 2019,PG,82,2174,341,716,47.625698324022345,51,139,36.69064748201439,290,577,50.25996533795494,51.187150837988824,156,195,80.0,57,175,232,270,96,45,141,175,889
Brandon Goodwin,1.0,2019 - 2019,PG,16,57,6,23,26.08695652173913,2,6,33.33333333333333,4,17,23.52941176470588,30.434782608695656,9,11,81.81818181818183,1,2,3,14,0,0,3,7,23
Devonte' Graham,1.0,2019 - 2019,PG,46,676,74,216,34.25925925925926,34,121,28.09917355371901,40,95,42.10526315789473,42.129629629629626,35,46,76.08695652173914,10,53,63,121,23,2,30,48,217
Donte Grantham,1.0,2019 - 2019,SF,3,2,0,2,0.0,0,2,0.0,0,0,,0.0,0,0,,0,0,0,0,0,0,0,0,0
Dusty Hannahs,1.0,2019 - 2019,SG,2,26,3,12,25.0,0,5,0.0,3,7,42.857142857142854,25.0,2,2,100.0,0,1,1,5,1,0,1,1,8
Isaiah Hartenstein,1.0,2019 - 2019,PF,28,221,20,41,48.78048780487805,2,6,33.33333333333333,18,35,51.42857142857142,51.21951219512195,11,14,78.57142857142857,21,26,47,15,7,12,13,56,53
Haywood Highsmith,1.0,2019 - 2019,SF,5,40,4,10,40.0,1,5,20.0,3,5,60.0,45.0,0,2,0.0,0,5,5,2,1,0,1,1,9
Aaron Holiday,1.0,2019 - 2019,PG,50,646,105,262,40.0763358778626,43,127,33.85826771653544,62,135,45.925925925925924,48.282442748091604,41,50,82.0,5,62,67,87,21,13,40,71,294
Kevin Huerter,1.0,2019 - 2019,SG,75,2048,275,657,41.856925418569254,136,353,38.52691218130311,139,304,45.723684210526315,52.207001522070016,41,56,73.21428571428571,60,185,245,214,65,25,109,155,727
Isaac Humphries,1.0,2019 - 2019,C,5,56,6,21,28.57142857142857,3,11,27.27272727272727,3,10,30.0,35.714285714285715,0,0,,4,7,11,0,1,0,0,7,15
Chandler Hutchison,1.0,2019 - 2019,SF,44,895,96,209,45.933014354066984,14,50,28.000000000000004,82,159,51.57232704402516,49.282296650717704,23,38,60.526315789473685,31,154,185,34,23,6,25,59,229
Frank Jackson,1.0,2019 - 2019,PG,61,1169,194,447,43.40044742729307,53,169,31.360946745562128,141,278,50.719424460431654,49.328859060402685,54,73,73.97260273972603,25,109,134,69,25,2,48,92,495
Amile Jefferson,1.0,2019 - 2019,PF,12,68,10,16,62.5,0,0,,10,16,62.5,62.5,7,8,87.5,6,15,21,3,3,3,1,8,27
Alize Johnson,1.0,2019 - 2019,PF,14,64,4,16,25.0,1,2,50.0,3,14,21.428571428571427,28.125,4,8,50.0,4,15,19,1,1,3,0,7,13
B.J. Johnson,1.0,2019 - 2019,SF,7,49,9,18,50.0,3,7,42.857142857142854,6,11,54.54545454545454,58.333333333333336,2,2,100.0,2,6,8,0,2,0,2,4,23
Jemerrio Jones,1.0,2019 - 2019,SF,6,143,12,33,36.36363636363637,2,10,20.0,10,23,43.47826086956522,39.39393939393939,1,2,50.0,16,33,49,13,7,5,5,10,27
George King,1.0,2019 - 2019,SF,1,6,0,0,,0,0,,0,0,,,0,0,,0,1,1,0,0,0,0,0,0
Kevin Knox,1.0,2019 - 2019,PF,75,2158,338,914,36.98030634573304,125,364,34.34065934065934,213,550,38.72727272727273,43.818380743982495,162,226,71.68141592920354,61,274,335,82,43,24,114,175,963
Rodions Kurucs,1.0,2019 - 2019,SF,63,1294,202,449,44.98886414253897,58,184,31.521739130434785,144,265,54.339622641509436,51.44766146993318,72,92,78.26086956521739,56,190,246,52,41,25,77,146,534
Zach Lofton,1.0,2019 - 2019,SG,1,4,0,1,0.0,0,1,0.0,0,0,,0.0,0,0,,0,0,0,0,1,0,1,0,0
Jordan Loyd,1.0,2019 - 2019,PG,12,55,8,18,44.44444444444444,4,8,50.0,4,10,40.0,55.55555555555556,9,11,81.81818181818183,1,8,9,6,0,0,2,5,29
Daryl Macon,1.0,2019 - 2019,SG,8,90,10,27,37.03703703703704,5,11,45.45454545454545,5,16,31.25,46.2962962962963,4,7,57.14285714285714,2,10,12,7,1,0,6,8,29
J.P. Macura,1.0,2019 - 2019,SG,2,17,3,9,33.33333333333333,0,4,0.0,3,5,60.0,33.33333333333333,0,0,,0,3,3,2,0,0,0,0,6
Yante Maten,1.0,2019 - 2019,PF,2,13,1,4,25.0,0,1,0.0,1,3,33.33333333333333,25.0,0,0,,1,2,3,0,1,0,0,0,2
Tahjere McCall,1.0,2019 - 2019,SG,1,8,2,3,66.66666666666666,0,1,0.0,2,2,100.0,66.66666666666666,0,1,0.0,0,1,1,0,0,0,0,2,4
De'Anthony Melton,1.0,2019 - 2019,PG,50,984,100,256,39.0625,29,95,30.526315789473685,71,161,44.099378881987576,44.7265625,21,28,75.0,25,109,134,159,68,23,75,113,250
Chimezie Metu,1.0,2019 - 2019,PF,29,145,19,58,32.758620689655174,0,2,0.0,19,56,33.92857142857143,32.758620689655174,13,17,76.47058823529412,9,27,36,13,6,2,15,14,51
Shake Milton,1.0,2019 - 2019,SG,20,268,34,87,39.08045977011494,14,44,31.818181818181817,20,43,46.51162790697674,47.12643678160919,5,7,71.42857142857143,9,26,35,18,8,8,6,29,87
Dzanan Musa,1.0,2019 - 2019,SG,9,39,9,22,40.909090909090914,1,10,10.0,8,12,66.66666666666666,43.18181818181818,0,2,0.0,1,4,5,2,2,0,4,1,19
Sviatoslav Mykhailiuk,1.0,2019 - 2019,SF,42,440,46,140,32.857142857142854,29,89,32.58426966292135,17,51,33.33333333333333,43.214285714285715,12,20,60.0,9,27,36,37,14,1,21,25,133
Elie Okobo,1.0,2019 - 2019,PG,53,958,114,290,39.310344827586206,39,132,29.545454545454547,75,158,47.46835443037975,46.03448275862069,37,47,78.72340425531915,12,86,98,127,32,7,69,109,304
Josh Okogie,1.0,2019 - 2019,SG,74,1757,196,508,38.582677165354326,60,215,27.906976744186046,136,293,46.41638225255973,44.48818897637795,118,162,72.8395061728395,41,177,218,91,88,33,63,166,570
Theo Pinson,1.0,2019 - 2019,SG,18,211,25,73,34.24657534246575,12,46,26.08695652173913,13,27,48.148148148148145,42.465753424657535,19,22,86.36363636363636,4,32,36,21,6,0,18,15,81
Cameron Reynolds,1.0,2019 - 2019,SG,19,259,33,78,42.30769230769231,21,51,41.17647058823529,12,27,44.44444444444444,55.769230769230774,8,9,88.88888888888889,4,27,31,13,6,2,5,26,95
Duncan Robinson,1.0,2019 - 2019,PF,15,161,18,46,39.130434782608695,10,35,28.57142857142857,8,11,72.72727272727273,50.0,4,6,66.66666666666666,2,17,19,5,5,0,4,11,50
Jerome Robinson,1.0,2019 - 2019,SG,33,320,44,110,40.0,18,57,31.57894736842105,26,53,49.056603773584904,48.18181818181818,6,9,66.66666666666666,3,38,41,19,11,3,13,46,112
Mitchell Robinson,1.0,2019 - 2019,C,66,1360,202,291,69.41580756013745,0,0,,202,291,69.41580756013745,69.41580756013745,81,135,60.0,177,246,423,37,52,161,35,217,485
Brandon Sampson,1.0,2019 - 2019,SG,14,214,28,60,46.666666666666664,11,29,37.93103448275862,17,31,54.83870967741935,55.833333333333336,4,6,66.66666666666666,3,13,16,10,8,3,12,19,71
Collin Sexton,1.0,2019 - 2019,PG,82,2605,519,1206,43.03482587064676,119,296,40.2027027027027,400,910,43.956043956043956,47.96849087893864,214,255,83.92156862745098,57,179,236,243,44,6,185,186,1371
Landry Shamet,1.0,2019 - 2019,SG,79,1802,240,557,43.08797127468581,167,396,42.17171717171717,73,161,45.3416149068323,58.07899461400359,75,93,80.64516129032258,21,113,134,117,37,10,45,155,722
Jordan Sibert,1.0,2019 - 2019,SG,1,4,1,1,100.0,1,1,100.0,0,0,,150.0,0,0,,0,0,0,0,0,0,0,0,3
Anfernee Simons,1.0,2019 - 2019,SG,20,141,28,63,44.44444444444444,10,29,34.48275862068966,18,34,52.94117647058824,52.38095238095239,9,16,56.25,3,10,13,13,1,0,11,9,75
Zhaire Smith,1.0,2019 - 2019,SG,6,111,14,34,41.17647058823529,6,16,37.5,8,18,44.44444444444444,50.0,6,8,75.0,3,10,13,10,2,2,6,8,40
Ray Spalding,1.0,2019 - 2019,PF,14,148,25,47,53.191489361702125,0,3,0.0,25,44,56.81818181818182,53.191489361702125,4,12,33.33333333333333,15,33,48,5,9,8,9,23,54
Omari Spellman,1.0,2019 - 2019,PF,46,805,98,244,40.16393442622951,44,128,34.375,54,116,46.55172413793103,49.18032786885246,32,45,71.11111111111111,72,122,194,47,26,25,31,67,272
Jared Terrell,1.0,2019 - 2019,SG,14,111,12,39,30.76923076923077,4,17,23.52941176470588,8,22,36.36363636363637,35.8974358974359,3,6,50.0,1,5,6,12,3,2,10,16,31
Emanuel Terry,1.0,2019 - 2019,PF,3,23,4,7,57.14285714285714,0,0,,4,7,57.14285714285714,57.14285714285714,2,4,50.0,3,4,7,2,3,0,2,4,10
Khyri Thomas,1.0,2019 - 2019,SG,26,195,22,69,31.88405797101449,10,35,28.57142857142857,12,34,35.294117647058826,39.130434782608695,7,11,63.63636363636363,4,16,20,8,7,5,4,22,61
Allonzo Trier,1.0,2019 - 2019,SG,64,1459,232,518,44.78764478764479,52,132,39.39393939393939,180,386,46.63212435233161,49.80694980694981,179,223,80.26905829596413,31,166,197,119,28,14,116,117,695
Jarred Vanderbilt,1.0,2019 - 2019,PF,17,69,9,19,47.368421052631575,0,1,0.0,9,18,50.0,47.368421052631575,6,10,60.0,7,16,23,3,6,1,8,8,24
Moritz Wagner,1.0,2019 - 2019,C,43,446,71,171,41.52046783625731,22,77,28.57142857142857,49,94,52.12765957446809,47.953216374269005,43,53,81.13207547169812,17,68,85,24,11,13,39,57,207
Lonnie Walker,1.0,2019 - 2019,SG,17,118,16,46,34.78260869565217,5,13,38.46153846153847,11,33,33.33333333333333,40.21739130434783,8,10,80.0,0,17,17,9,7,3,4,7,45
Brad Wanamaker,1.0,2019 - 2019,PG,36,343,50,105,47.61904761904761,16,39,41.02564102564102,34,66,51.515151515151516,55.23809523809524,24,28,85.71428571428571,3,38,41,56,12,2,19,34,140
Julian Washburn,1.0,2019 - 2019,SF,18,254,16,48,33.33333333333333,5,24,20.833333333333336,11,24,45.83333333333333,38.54166666666667,3,4,75.0,8,33,41,14,13,2,7,16,40
Yuta Watanabe,1.0,2019 - 2019,SF,15,174,15,51,29.411764705882355,2,16,12.5,13,35,37.142857142857146,31.372549019607842,7,10,70.0,4,27,31,8,4,1,6,11,39
Thomas Welsh,1.0,2019 - 2019,C,11,36,7,13,53.84615384615385,3,7,42.857142857142854,4,6,66.66666666666666,65.38461538461539,1,2,50.0,0,4,4,5,0,0,1,3,18
Johnathan Williams,1.0,2019 - 2019,C,24,372,65,110,59.09090909090909,0,2,0.0,65,108,60.18518518518518,59.09090909090909,27,48,56.25,48,51,99,13,8,7,16,62,157
Kenrich Williams,1.0,2019 - 2019,SF,46,1079,107,279,38.35125448028674,52,156,33.33333333333333,55,123,44.71544715447154,47.67025089605735,13,19,68.42105263157895,55,164,219,83,45,19,36,95,279
Robert Williams,1.0,2019 - 2019,C,32,283,36,51,70.58823529411765,0,0,,36,51,70.58823529411765,70.58823529411765,9,15,60.0,27,54,81,7,9,40,10,36,81
Trae Young,1.0,2019 - 2019,PG,81,2503,525,1256,41.79936305732484,156,482,32.365145228215766,369,774,47.674418604651166,48.009554140127385,343,414,82.85024154589372,64,237,301,653,72,15,308,140,1549
